綺麗	きれい|ぎれい	kirei|girei
同梱	どうこん	doukonn
彷彿	ほうふつ	houfutsu
勿論	もちろん	mochironn
贅沢	ぜいたく	zeitaku
麻痺	まひ	mahi
愕然	がくぜん	gakuzenn
梱包	こんぽう	konnpou
鍼灸	しんきゅう	shinnkyuu
些細	ささい	sasai
喧嘩	けんか|げんか	kennka|gennka
唖然	あぜん	azenn
呆然	ぼうぜん	bouzenn
蕎麦	そば|そばむぎ	soba|sobamugi
躊躇	ちゅうちょ	tyuutyo
漏洩	ろうえい|ろうせつ	rouei|rousetsu
抜擢	ばってき	batteki
流暢	りゅうちょう	ryuutyou
割烹	かっぽう	kappou
毅然	きぜん	kizenn
秘訣	ひけつ	hiketsu
蔓延	まんえん|はびこ	mannenn|habiko
混沌	こんとん	konntonn
餃子	ぎょうざ|ぎょーざ	gyouza|gyo-za
微塵	みじん	mijinn
醤油	しょうゆ|じょうゆ	shouyu|jouyu
対峙	たいじ	taiji
標榜	ひょうぼう	hyoubou
溜息	ためいき	tameiki
揶揄	やゆ	yayu
牽引	けんいん	kenninn
瑕疵	かし	kashi
惣菜	そうざい	souzai
驚愕	きょうがく	kyougaku
喧騒	けんそう	kennsou
震撼	しんかん	shinnkann
痔疾	じしつ	jishitsu
呆気	あっけ	akke
衣裳	いしょう	ishou
邁進	まいしん	maishinn
怪訝	けげん	kegenn
炸裂	さくれつ	sakuretsu
誹謗	ひぼう	hibou
洒落	しゃらく|しゃれ|じゃれ	sharaku|share|jare
渾身	こんしん	konnshinn
朦朧	もうろう	mourou
謳歌	おうか	ouka
薔薇	ばら|いばら|しょうび|そうび	bara|ibara|shoubi|soubi
編纂	へんさん	hennsann
淘汰	とうた	touta
按摩	あんま	annma
安堵	あんど	anndo
鞭撻	べんたつ	benntatsu
徘徊	はいかい	haikai
吾輩	わがはい	wagahai
鬱蒼	うっそう	ussou
髣髴	ほうふつ	houfutsu
灼眼	しゃくがん	shakugann
刺繍	ししゅう	shishuu
片鱗	へんりん	hennrinn
投函	とうかん	toukann
合祀	ごうし	goushi
烙印	らくいん	rakuinn
捏造	ねつぞう|でつぞう	netsuzou|detsuzou
壬申	じんしん	jinnshinn
範疇	はんちゅう	hanntyuu
凌駕	りょうが	ryouga
教鞭	きょうべん	kyoubenn
風靡	ふうび	fuubi
復讐	ふくしゅう	fukushuu
蜘蛛	くも|ぐも	kumo|gumo
熨斗	のし	noshi
夕凪	ゆうなぎ	yuunagi
只今	ただいま	tadaima
菖蒲	あやめ|しょうぶ	ayame|shoubu
菩提	ぼだい	bodai
可憐	かれん	karenn
湿疹	しっしん	shisshinn
庇護	ひご	higo
逆鱗	げきりん	gekirinn
辟易	へきえき	hekieki
味噌	みそ	miso
人狼	じんろう	jinnrou
佃煮	つくだに	tsukudani
莫大	ばくだい	bakudai
黎明	れいめい	reimei
麻雀	まーじゃん	ma-jann
動悸	どうき	douki
棲息	せいそく	seisoku
恍惚	こうこつ	koukotsu
蹂躙	じゅうりん	juurinn
撥水	はっすい	hassui
憮然	ぶぜん	buzenn
竣工	しゅんこう	shunnkou
乖離	かいり	kairi
贔屓	ひいき|びいき	hiiki|biiki
発疹	はっしん|ほっしん	hasshinn|hosshinn
嘔吐	おうと	outo
焙煎	ばいせん	baisenn
闊歩	かっぽ	kappo
罹患	りかん	rikann
緋色	ひいろ	hiiro
不憫	ふびん	fubinn
成蹊	せいけい	seikei
彷徨	ほうこう	houkou
芳醇	ほうじゅん	houjunn
天狗	てんぐ	tenngu
廃墟	はいきょ	haikyo
愛嬌	あいきょう	aikyou
剪定	せんてい	senntei
怒涛	どとう	dotou
寵愛	ちょうあい	tyouai
瀕死	ひんし	hinnshi
億劫	おっくう	okkuu
蒼穹	そうきゅう	soukyuu
聯合	れんごう	renngou
末裔	まつえい|ばつえい	matsuei|batsuei
拮抗	きっこう	kikkou
雀荘	じゃんそう	jannsou
暖簾	のれん	norenn
喘息	ぜんそく|ずだ	zennsoku|zuda
黄昏	たそがれ	tasogare
閃光	せんこう	sennkou
同棲	どうせい	dousei
痙攣	けいれん	keirenn
錯綜	さくそう	sakusou
排泄	はいせつ	haisetsu
招聘	しょうへい	shouhei
憑依	ひょうい	hyoui
光芒	こうぼう	koubou
桶屋	おけや	okeya
褒貶	ほうへん	houhenn
改竄	かいざん	kaizann
牽制	けんせい	kennsei
厨房	ちゅうぼう	tyuubou
絨毯	じゅうたん	juutann
嗚呼	ああ	aa
天秤	てんびん	tennbinn
躁鬱	そううつ	souutsu
蒼天	そうてん	soutenn
終焉	しゅうえん	shuuenn
脱糞	だっぷん	dappunn
噂話	うわさばなし	uwasabanashi
翡翠	かわせみ|ひすい	kawasemi|hisui
此処	ここ|ここら	koko|kokora
転訛	てんか	tennka
咆哮	ほうこう	houkou
任侠	にんきょう	ninnkyou
逼迫	ひっぱく	hippaku
只者	ただもの	tadamono
迂回	うかい	ukai
稀少	きしょう	kishou
嗜好	しこう	shikou
頬杖	ほおづえ|つらづえ	hoodue|tsuradue
麻疹	はしか|ましん|ばしか	hashika|mashinn|bashika
喧伝	けんでん	kenndenn
魍魎	もうりょう	mouryou
颯爽	さっそう	sassou
納竿	のうかん	noukann
高嶺	たかね	takane
反芻	はんすう	hannsuu
上梓	じょうし	joushi
後塵	こうじん	koujinn
忌憚	きたん	kitann
溌剌	はつらつ	hatsuratsu
跋扈	ばっこ	bakko
杣人	そまびと	somabito
弥陀	みだ	mida
嬉しい	うれしい	ureshii
揃う	そろう	sorou
貰う	もらう|もろう	morau|morou
云う	いう|ゆう	iu|yuu
叩く	たたく|はたく|ぱたく	tataku|hataku|pataku
萌える	もえる	moeru
溢れる	あふれる|こぼれる	afureru|koboreru
殆ど	ほとんど	hotonndo
繋がる	つながる	tsunagaru
覗く	のぞく	nozoku
叩き	たたき|はたき|だたき|ぱたき|ばたき	tataki|hataki|dataki|pataki|bataki
炒める	いためる	itameru
喋る	しゃべる	shaberu
掴む	つかむ|づかむ	tsukamu|dukamu
騙す	だます	damasu
噛む	かむ|がむ	kamu|gamu
濡れ	ぬれ	nure
呟く	つぶやく	tsubuyaku
辿る	たどる	tadoru
惹く	ひく	hiku
綴る	つづる	tsuduru
叶う	かなう|かのう	kanau|kanou
喰う	くう|くらう	kuu|kurau
呑む	のむ	nomu
溜まる	たまる|だまる	tamaru|damaru
其の	その	sono
舐める	なめる	nameru
馴染み	なじみ	najimi
逢う	あう|おう	au|ou
曰く	いわく	iwaku
煽る	あおる|あふる|あうる	aoru|afuru|auru
晒し	さらし|ざらし	sarashi|zarashi
頷く	うなずく	unazuku
惚れる	ほれる|ぼれる|とれる	horeru|boreru|toreru
儲かる	もうかる	moukaru
お詫び	おわび	owabi
遥か	はるか	haruka
お洒落	おしゃれ	oshare
繋がり	つながり	tsunagari
茹でる	ゆでる|うでる	yuderu|uderu
煽り	あおり|あふり|あうり	aori|afuri|auri
覗き	のぞき	nozoki
繋ぐ	つなぐ	tsunagu
或いは	あるいは|あるいわ	aruiha|aruiwa
於く	おく	oku
貰い	もらい	morai
呆れる	あきれる	akireru
吊る	つる|づる	tsuru|duru
撫でる	なでる	naderu
撒く	まく	maku
儲け	もうけ	mouke
揃い	そろい|ぞろい	soroi|zoroi
訊く	きく	kiku
祀る	まつる	matsuru
取り揃う	とりそろう	torisorou
晒す	さらす|ざらす	sarasu|zarasu
賑やか	にぎやか	nigiyaka
捧ぐ	ささぐ	sasagu
廻り	まわり|めぐり	mawari|meguri
賑わう	にぎわう	nigiwau
出逢う	であう|でおう	deau|deou
這う	はう|ばう|ほう	hau|bau|hou
蘇る	よみがえる	yomigaeru
揉む	もむ	momu
歪む	いがむ|ひずむ|ゆがむ	igamu|hizumu|yugamu
喰らう	くらう	kurau
歪み	ゆがみ|ひずみ|いがみ	yugami|hizumi|igami
吠える	ほえる|ぼえる	hoeru|boeru
淋しい	さびしい|さみしい	sabishii|samishii
廻る	まわる|めぐる	mawaru|meguru
貰える	もらえる	moraeru
賑わい	にぎわい	nigiwai
漕ぐ	こぐ	kogu
溜める	ためる	tameru
焚く	たく	taku
ご馳走	ごちそう	gochisou
佇む	たたずむ	tatazumu
掻く	かく|がく	kaku|gaku
繋げる	つなげる	tsunageru
汲む	くむ	kumu
睨む	にらむ	niramu
爺さん	じいさん	jiisann
怯える	おびえる	obieru
剃る	する|そる|ぞる	suru|soru|zoru
囁く	ささやく	sasayaku
偲ぶ	しのぶ	shinobu
馴染む	なじむ	najimu
挽く	ひく|びく	hiku|biku
謳う	うたう|うとう	utau|utou
馳せる	はせる|ばせる	haseru|baseru
蒔く	まく	maku
棲む	すむ	sumu
甦る	よみがえる	yomigaeru
綴り	つづり	tsuduri
捧げる	ささげる	sasageru
纏う	まとう	matou
眩しい	まぶしい	mabushii
姐さん	ねえさん	neesann
蒼い	あおい	aoi
冴え	さえ	sae
繋ぎ	つなぎ	tsunagi
金儲け	かねもうけ	kanemouke
痒い	かゆい	kayui
尖る	とがる|とんがる	togaru|tonngaru
錆びる	さびる	sabiru
唸る	うなる	unaru
纏める	まとめる	matomeru
炙る	あぶる	aburu
嘘つき	うそつき	usotsuki
濡らす	ぬらす	nurasu
儲ける	もうける	moukeru
喘ぐ	あえぐ	aegu
窺う	うかがう|うかごう	ukagau|ukagou
痺れ	しびれ|しびれれ	shibire|shibirere
掴める	つかめる	tsukameru
揃える	そろえる|ぞろえる	soroeru|zoroeru
叩きつける	たたきつける	tatakitsukeru
叶える	かなえる	kanaeru
凛と	りんと	rinnto
俯く	うつむく	utsumuku
馴れ合う	なれあう|なれおう	nareau|nareou
佇まい	たたずまい	tatazumai
叩き込む	たたきこむ|はたきこむ	tatakikomu|hatakikomu
或は	あるいは|あるいわ	aruiha|aruiwa
霞む	かすむ	kasumu
噛み合う	かみあう|かみおう	kamiau|kamiou
穿く	はく|ばく	haku|baku
鵜呑み	うのみ	unomi
逞しい	たくましい	takumashii
捲る	めくる|まくる	mekuru|makuru
噛み付く	かみつく	kamitsuku
釘付け	くぎづけ	kugiduke
鯉のぼり	こいのぼり	koinobori
勢揃い	せいぞろい	seizoroi
勿体ない	もったいない	mottainai
亘る	わたる	wataru
禿げる	はげる	hageru
祟る	たたる	tataru
滲む	にじむ	nijimu
曳く	ひく	hiku
凌ぐ	しのぐ	shinogu
胡散臭い	うさんくさい	usannkusai
媚びる	こびる	kobiru
貶める	おとしめる	otoshimeru
庇う	かばう|かぼう	kabau|kabou
訊ねる	たずねる	tazuneru
嵌る	はまる	hamaru
歪める	ゆがめる	yugameru
吊り上げる	つりあげる	tsuriageru
揉める	もめる	momeru
儚い	はかない	hakanai
滲みる	しみる	shimiru
お喋り	おしゃべり	oshaberi
吊るす	つるす	tsurusu
焚き火	たきび	takibi
尤も	もっとも	mottomo
孕む	はらむ|ばらむ	haramu|baramu
廻し	まわし	mawashi
轢く	ひく|びく	hiku|biku
讃える	たたえる	tataeru
囁き	ささやき	sasayaki
濡れる	ぬれる	nureru
お雛様	おひなさま	ohinasama
悶える	もだえる	modaeru
叩ける	はたける|たたける	hatakeru|tatakeru
お釈迦様	おしゃかさま	oshakasama
躊躇う	ためらう|ためろう	tamerau|tamerou
咬む	かむ	kamu
茶碗蒸し	ちゃわんむし	tyawannmushi
睨みつける	にらみつける	niramitsukeru
篭る	こもる|こめる|ごもる	komoru|komeru|gomoru
沁みる	しみる	shimiru
祀り	まつり	matsuri
瞑る	つぶる|つむる	tsuburu|tsumuru
憑かれる	つかれる	tsukareru
溜め息	ためいき	tameiki
葺く	ふく|ぶく	fuku|buku
炒る	いる	iru
咎め	とがめ	togame
呆然と	ぼうぜんと	bouzennto
奢る	おごる	ogoru
呻く	うめく	umeku
睨み	にらみ	nirami
眩い	まばゆい|まぶしい|くるめい	mabayui|mabushii|kurumei
馴れる	なれる	nareru
閃く	ひらめく	hirameku
摺り	すり|ずり	suri|zuri
脆い	もろい	moroi
噛み締める	かみしめる	kamishimeru
篭もる	こもる|ごもる	komoru|gomoru
穢れ	けがれ|けがれれ	kegare|kegarere
溜め込む	ためこむ	tamekomu
遠吠え	とおぼえ	tooboe
溜り	たまり|だまり	tamari|damari
唸り	うなり	unari
吼える	ほえる	hoeru
聳える	そびえる	sobieru
綴じ	とじ|ていじ	toji|teiji
煤ける	すすける	susukeru
汲み取る	くみとる	kumitoru
謂う	いう|ゆう	iu|yuu
逢える	あえる	aeru
罹る	かかる	kakaru
吊り橋	つりばし	tsuribashi
お祓い	おはらい	oharai
掬う	すくう	sukuu
蠢く	うごめく	ugomeku
捌き	さばき	sabaki
ご馳走様	ごちそうさま	gochisousama
詫び	わび	wabi
貶す	けなす|へんす	kenasu|hennsu
噛みつく	かみつく	kamitsuku
頷ける	うなづける|うなずける	unadukeru|unazukeru
色褪せる	いろあせる	iroaseru
跨ぐ	またぐ	matagu
縋る	すがる	sugaru
啜る	すする	susuru
抉る	えぐる|くじる|こじる	eguru|kujiru|kojiru
騙る	かたる	kataru
訛り	なまり	namari
蝕む	むしばむ	mushibamu
捌く	さばく	sabaku
跨る	またがる	matagaru
坐る	すわる	suwaru
お爺さん	おじいさん	ojiisann
洩れる	もれる	moreru
祓い	はらい|ばらい	harai|barai
馴染める	なじめる	najimeru
拗ねる	すねる	suneru
噛める	かめる	kameru
穿つ	うがつ	ugatsu
嵌める	はめる|ぱめる	hameru|pameru
憐れむ	あわれむ	awaremu
お蔭	おかげ	okage
生き甲斐	いきがい	ikigai
齧る	かじる|かぶる	kajiru|kaburu
疼く	うずく	uzuku
湛える	たたえる	tataeru
丑の日	うしのひ	ushinohi
五月蝿い	うるさい	urusai
耽る	ふける	fukeru
出揃う	でそろう	desorou
怯む	ひるむ	hirumu
紐解く	ひもとく	himotoku
顰める	しかめる|ひそめる	shikameru|hisomeru
窪む	くぼむ	kubomu
曝す	さらす|ざらす	sarasu|zarasu
噛みしめる	かみしめる	kamishimeru
厭う	いとう	itou
騙り	かたり|がたり	katari|gatari
掠める	かすめる	kasumeru
啼く	なく	naku
悉く	ことごとく	kotogotoku
煌めく	きらめく	kirameku
呑み込む	のみこむ	nomikomu
呆け	ぼけ|ほけ|ほうけ	boke|hoke|houke
僻む	ひがむ	higamu
躓く	つまずく	tsumazuku
咳き込む	せきこむ	sekikomu
吾が	わが	waga
お蔭様	おかげさま	okagesama
不甲斐ない	ふがいない	fugainai
茅葺き	かやぶき	kayabuki
駈ける	かける|がける	kakeru|gakeru
軋む	きしむ	kishimu
引き摺る	ひきずる	hikizuru
鞭打つ	むちうつ	muchiutsu
播く	まく	maku
大儲け	おおもうけ	oomouke
見惚れる	みほれる|みとれる	mihoreru|mitoreru
ずぶ濡れ	ずぶぬれ	zubunure
纏まる	まとまる	matomaru
捲く	まく	maku
汲み上げる	くみあげる	kumiageru
蒲焼き	かばやき	kabayaki
些か	いささか	isasaka
轟く	とどろく	todoroku
幼馴染み	おさななじみ	osananajimi
惚れ込む	ほれこむ	horekomu
生け贄	いけにえ	ikenie
睨み付ける	にらみつける	niramitsukeru
引っ掻く	ひっかく	hikkaku
嘗て	かつて	katsute
晒せる	さらせる	saraseru
惚れ惚れ	ほれぼれ	horebore
噛み砕く	かみくだく	kamikudaku
呑める	のめる	nomeru
叩き付ける	たたきつける	tatakitsukeru
纏わる	まつわる|まとわる	matsuwaru|matowaru
首吊り	くびつり	kubitsuri
捏ねる	こねる|つくねる	koneru|tsukuneru
覗ける	のぞける	nozokeru
凌ぎ	しのぎ	shinogi
ぐい呑	ぐいのみ	guinomi
洩らす	もらす	morasu
蒙る	こうむる	koumuru
竦める	すくめる	sukumeru
溜まり場	たまりば	tamariba
攫う	さらう|さろう	sarau|sarou
お釈迦さま	おしゃかさま	oshakasama
跪く	ひざまずく	hizamazuku
囀る	さえずる	saezuru
忽然と	こつぜんと|こつねんと	kotsuzennto|kotsunennto
舵取り	かじとり	kajitori
誂える	あつらえる	atsuraeru
痺れる	しびれる	shibireru
湯呑み	ゆのみ	yunomi
廻す	まわす	mawasu
掠る	かする|かすめる	kasuru|kasumeru
侘び	わび	wabi
不揃い	ふぞろい	fuzoroi
掻き分ける	かきわける	kakiwakeru
眩む	くらむ	kuramu
苔むす	こけむす	kokemusu
撞く	つく|づく	tsuku|duku
びしょ濡れ	びしょぬれ	bishonure
三つ巴	みつどもえ	mitsudomoe
囃す	はやす	hayasu
茅の輪	ちのわ	chinowa
宥める	なだめる	nadameru
掻き立てる	かきたてる	kakitateru
揉め事	もめごと	momegoto
掴まる	つかまる|づかまる	tsukamaru|dukamaru
窺える	うかがえる	ukagaeru
撚る	よる|ひねる|ねじる	yoru|hineru|nejiru
自惚れる	うぬぼれる	unuboreru
祓う	はらう|はろう	harau|harou
濡れ場	ぬれば	nureba
垢抜け	あかぬけ	akanuke
搗く	つく|づく	tsuku|duku
拵え	こしらえ|こさえ|ごしらえ	koshirae|kosae|goshirae
訛る	なまる	namaru
喋れる	しゃべれる	shabereru
濡れ衣	ぬれぎぬ|ぬれごろも	nureginu|nuregoromo
嘗める	なめる	nameru
四つん這い	よつんばい	yotsunnbai
涌く	わく	waku
捩る	すじる|ねじる|もじる|よじる	sujiru|nejiru|mojiru|yojiru
卯の花	うのはな	unohana
鷲掴み	わしづかみ	washidukami
斯く	かく	kaku
漉く	すく|ずく	suku|zuku
贖う	あがなう|あがのう	aganau|aganou
諌める	いさめる	isameru
翔ぶ	とぶ	tobu
漲る	みなぎる	minagiru
嬲る	なぶる	naburu
葺き替え	ふきかえ	fukikae
火の見櫓	ひのみやぐら	hinomiyagura
咳払い	せきばらい	sekibarai
馴れ馴れしい	なれなれしい	narenareshii
迸る	ほとばしる|とばしる	hotobashiru|tobashiru
足掻く	あがく	agaku
嗜む	たしなむ	tashinamu
乃ち	すなわち	sunawachi
彷徨く	うろつく	urotsuku
齎す	もたらす	motarasu
冴える	さえる	saeru
袋叩き	ふくろだたき	fukurodataki
お神輿	おみこし	omikoshi
仄か	ほのか|ほのめか	honoka|honomeka
坐す	ざす|まします|います	zasu|mashimasu|imasu
夥しい	おびただしい	obitadashii
涸れる	かれる|がれる	kareru|gareru
弛む	たるむ|たゆむ|だるむ|ゆるむ	tarumu|tayumu|darumu|yurumu
梳く	すく	suku
詫びる	わびる	wabiru
隠れ蓑	かくれみの	kakuremino
娶る	めとる	metoru
忽ち	たちまち	tachimachi
撥ね	はね|ぱね	hane|pane
燻る	いぶる|くすぶる|ふすぶる|くゆる	iburu|kusuburu|fusuburu|kuyuru
玉の輿	たまのこし	tamanokoshi
憐れ	あわれ	aware
撒き餌	まきえ|まきえさ	makie|makiesa
訝しい	いぶかしい	ibukashii
奢り	おごり	ogori
燻す	いぶす|くゆらす	ibusu|kuyurasu
釣り竿	つりざお	tsurizao
臥す	ふす	fusu
鞍替え	くらがえ	kuragae
呆気ない	あっけない	akkenai
お揃いで	おそろいで	osoroide
翔ける	かける	kakeru
訝しげ	いぶかしげ	ibukashige
曰う	のたまう|のたもう	notamau|notamou
酉の市	とりのいち	torinoichi
灼く	やく	yaku
伊勢参り	いせまいり	isemairi
惚ける	とぼける|ほうける|ぼける|ほける	tobokeru|houkeru|bokeru|hokeru
孵る	かえる	kaeru
讀む	よむ	yomu
凪ぐ	なぐ	nagu
靡く	なびく	nabiku
手漉き	てすき	tesuki
翔る	かける	kakeru
轟かせる	とどろかせる	todorokaseru
屠る	ほふる|はふる	hofuru|hafuru
手馴れる	てなれる	tenareru
吊し	つるし	tsurushi
咎める	とがめる	togameru
謳い文句	うたいもんく	utaimonnku
鄙びる	ひなびる	hinabiru
翳り	かげり	kageri
蔓延る	はびこる	habikoru
頗る	すこぶる	sukoburu
牽く	ひく	hiku
睨み合う	にらみあう|にらみおう	niramiau|niramiou
挽き肉	ひきにく	hikiniku
粕漬け	かすづけ	kasuduke
賑わしい	にぎわしい	nigiwashii
掻き回す	かきまわす	kakimawasu
蚤の市	のみのいち	nominoichi
丸呑み	まるのみ	marunomi
漉す	こす|ごす	kosu|gosu
胡麻和え	ごまあえ	gomaae
蹲る	うずくまる|つくばる	uzukumaru|tsukubaru
凭れる	もたれる	motareru
喧しい	やかましい|かまびすしい	yakamashii|kamabisushii
驕り	おごり	ogori
賑わせる	にぎわせる	nigiwaseru
蕩ける	とろける	torokeru
毅然と	きぜんと	kizennto
夜這い	よばい	yobai
銜える	くわえる	kuwaeru
這いずる	はいずる	haizuru
謂れ	いわれ	iware
吊上げる	つりあげる|つるしあげる	tsuriageru|tsurushiageru
諍い	いさかい	isakai
睨める	ねめる|にらめる	nemeru|nirameru
腑抜け	ふぬけ	funuke
譬え	たとえ	tatoe
倦む	あぐむ|うむ	agumu|umu
馴らす	ならす	narasu
引き攣る	ひきつる	hikitsuru
這入る	はいいる|はいる	haiiru|hairu
箔押し	はくおし	hakuoshi
毟る	むしる	mushiru
淀む	よどむ	yodomu
此の世	このよ	konoyo
揉み合う	もみあう|もみおう	momiau|momiou
淀み	よどみ	yodomi
膿む	うむ	umu
歯軋り	はぎしり	hagishiri
嗜み	たしなみ|だしなみ	tashinami|dashinami
滾る	たぎる	tagiru
冴え渡る	さえわたる	saewataru
薙ぐ	なぐ	nagu
侘しい	わびしい	wabishii
瓦葺き	かわらぶき	kawarabuki
這い出す	はいだす	haidasu
賽の河原	さいのかわら	sainokawara
糠漬け	ぬかづけ	nukaduke
吹き溜まり	ふきだまり	fukidamari
掃き溜め	はきだめ	hakidame
お伽	おとぎ	otogi
褪せる	あせる	aseru
揉み消す	もみけす	momikesu
辻斬り	つじぎり	tsujigiri
濾す	こす	kosu
溜る	たまる	tamaru
嘯く	うそぶく	usobuku
恰も	あたかも|あだかも	atakamo|adakamo
逆撫で	さかなで	sakanade
嘘っぱち	うそっぱち	usoppachi
蝉しぐれ	せみしぐれ	semishigure
譬えば	たとえば	tatoeba
噤む	つぐむ	tsugumu
吊す	つるす	tsurusu
味噌和え	みそあえ	misoae
歯痒い	はがゆい	hagayui
薙ぎ払う	なぎはらう|なぎはろう	nagiharau|nagiharou
捌け	はけ|さばけ	hake|sabake
躱す	かわす	kawasu
撒ける	まける	makeru
澱む	よどむ|おどむ	yodomu|odomu
翳す	かざす	kazasu
木っ端微塵	こっぱみじん	koppamijinn
買い叩く	かいたたく	kaitataku
哭く	なく	naku
仄めかす	ほのめかす	honomekasu
爛れ	ただれ|ただれれ	tadare|tadarere
譬へば	たとへば	tatoheba
驕る	おごる	ogoru
坐り	すわり|ずわり	suwari|zuwari
身悶え	みもだえ	mimodae
丑三つ	うしみつ	ushimitsu
喰える	くえる	kueru
竦む	すくむ	sukumu
摺る	する|ずる	suru|zuru
看做す	みなす	minasu
耳掻き	みみかき	mimikaki
肥溜め	こえだめ	koedame
ご馳走さま	ごちそうさま	gochisousama
捺す	おす	osu
嵩む	かさむ	kasamu
然し乍ら	しかしながら	shikashinagara
噛み殺す	かみころす	kamikorosu
堰く	せく	seku
酒呑み	さけのみ	sakenomi
凌げる	しのげる	shinogeru
振り撒く	ふりまく	furimaku
詫び状	わびじょう	wabijou
已に	すでに	sudeni
生け簀	いけす	ikesu
水溜まり	みずたまり	mizutamari
弛み	ゆるみ|たるみ|たゆみ|だるみ	yurumi|tarumi|tayumi|darumi
蝶結び	ちょうむすび	tyoumusubi
丸儲け	まるもうけ	marumouke
呑み屋	のみや	nomiya
取揃える	とりそろえる	torisoroeru
聞き惚れる	ききほれる	kikihoreru
蒼白い	あおじろい	aojiroi
糊付け	のりづけ	noriduke
漕げる	こげる	kogeru
撫ぜる	なぜる	nazeru
紙漉き	かみすき	kamisuki
お釈迦	おしゃか	oshaka
聡い	さとい	satoi
むず痒い	むずがゆい	muzugayui
こし餡	こしあん	koshiann
掻き出す	かきだす	kakidasu
掴まえる	つかまえる	tsukamaeru
当て嵌る	あてはまる	atehamaru
鵜飼い	うかい	ukai
這いつくばう	はいつくばう	haitsukubau
甲斐甲斐しい	かいがいしい	kaigaishii
嵩上げ	かさあげ	kasaage
宙吊り	ちゅうづり	tyuuduri
漕ぎ着ける	こぎつける	kogitsukeru
狡い	こすい|ずるい|こしい|ずりい	kosui|zurui|koshii|zurii
馴れ初め	なれそめ	naresome
嵌め込む	はめこむ	hamekomu
擽る	くすぐる|こそぐる	kusuguru|kosoguru
叩き上げる	たたきあげる	tatakiageru
縺れる	もつれる	motsureru
掴みかかる	つかみかかる	tsukamikakaru
貰い物	もらいもの	moraimono
付き纏う	つきまとう	tsukimatou
代掻き	しろかき	shirokaki
浚う	さらう|さろう	sarau|sarou
掻き毟る	かきむしる	kakimushiru
汲める	くめる	kumeru
叩き台	たたきだい	tatakidai
蕗の薹	ふきのとう	fukinotou
憑き物	つきもの	tsukimono
元の木阿弥	もとのもくあみ	motonomokuami
輿入れ	こしいれ	koshiire
掻き集める	かきあつめる	kakiatsumeru
姦しい	かしましい	kashimashii
轢き殺す	ひきころす	hikikorosu
訝る	いぶかる	ibukaru
亙る	わたる	wataru
惚れこむ	ほれこむ	horekomu
穢い	きたない|ぎたない	kitanai|gitanai
軋る	きしる|ぎしる	kishiru|gishiru
呆れ返る	あきれかえる	akirekaeru
焙る	あぶる	aburu
謗る	そしる	soshiru
灯篭流し	とうろうながし	tourounagashi
衒う	てらう|てろう	terau|terou
嵩張る	かさばる	kasabaru
足掻き	あがき	agaki
寝惚ける	ねとぼける|ねぼける	netobokeru|nebokeru
揉みほぐす	もみほぐす	momihogusu
青天の霹靂	せいてんのへきれき	seitennnohekireki
賑わす	にぎわす	nigiwasu
歯噛み	はがみ	hagami
翳る	かげる	kageru
窘める	たしなめる	tashinameru
賑やかす	にぎやかす	nigiyakasu
掻き混ぜる	かきまぜる	kakimazeru
綴れ	つづれ	tsudure
呑み込み	のみこみ	nomikomi
耀く	かがやく	kagayaku
疚しい	やましい	yamashii
澱み	よどみ|おどみ	yodomi|odomi
掻きむしる	かきむしる	kakimushiru
熾す	おこす	okosu
横這い	よこばい	yokobai
擂る	する	suru
錆び付く	さびつく	sabitsuku
嬉し涙	うれしなみだ	ureshinamida
撓む	たわむ	tawamu
溯る	さかのぼる	sakanoboru
見廻す	みまわす	mimawasu
掻き消える	かききえる	kakikieru
捌ける	さばける|はける	sabakeru|hakeru
読み耽る	よみふける	yomifukeru
綴じ込む	とじこむ	tojikomu
楯突く	たてつく	tatetsuku
呑みこむ	のみこむ	nomikomu
遅れ馳せ	おくればせ	okurebase
舁く	かく	kaku
たらば蟹	たらばがに	tarabagani
薙ぎ倒す	なぎたおす	nagitaosu
雛まつり	ひなまつり	hinamatsuri
遊び呆ける	あそびほうける	asobihoukeru
取り纏める	とりまとめる	torimatomeru
錆止め	さびどめ	sabidome
綴じる	とじる	tojiru
お伽噺	おとぎばなし	otogibanashi
捌け口	さばけぐち|はけぐち	sabakeguchi|hakeguchi
恙無い	つつがない	tsutsuganai
貰い手	もらいて	moraite
数珠繋ぎ	じゅずつなぎ	juzutsunagi
焚き付ける	たきつける	takitsukeru
焚きつける	たきつける	takitsukeru
燕返し	つばめがえし	tsubamegaeshi
汲み出す	くみだす	kumidasu
腋の下	わきのした	wakinoshita
草臥れる	くたびれる	kutabireru
持て囃す	もてはやす	motehayasu
焙じ茶	ほうじちゃ	houjitya
昏れる	くれる	kureru
撰ぶ	えらぶ	erabu
狐の嫁入り	きつねのよめいり	kitsunenoyomeiri
昂る	たかぶる	takaburu
臥せる	ふせる	fuseru
紐付き	ひもつき	himotsuki
雪掻き	ゆきかき	yukikaki
狼狽える	うろたえる	urotaeru
轢き逃げ	ひきにげ	hikinige
糺す	ただす	tadasu
篩う	ふるう	furuu
聊か	いささか	isasaka
嗄れる	かれる|しゃがれる|しわがれる	kareru|shagareru|shiwagareru
褪める	さめる	sameru
撓る	しわる|しなる	shiwaru|shinaru
廻せる	まわせる	mawaseru
見廻る	みまわる|みめぐる	mimawaru|mimeguru
掻い潜る	かいくぐる|かいもぐる	kaikuguru|kaimoguru
当て嵌める	あてはめる	atehameru
掻き乱す	かきみだす	kakimidasu
眇める	すがめる	sugameru
咲き揃う	さきそろう	sakisorou
板葺き	いたぶき	itabuki
木洩れ日	こもれび	komorebi
呷る	あおる	aoru
濡れそぼつ	ぬれそぼつ	nuresobotsu
顔馴染み	かおなじみ	kaonajimi
取り揃える	とりそろえる	torisoroeru
冴えわたる	さえわたる	saewataru
學ぶ	まなぶ	manabu
錆びつく	さびつく	sabitsuku
搦める	からめる	karameru
抓る	つねる|つめる	tsuneru|tsumeru
祓い清める	はらいきよめる	haraikiyomeru
稔り	みのり	minori
捩り	もじり|すじり|ねじり|よじり	mojiri|sujiri|nejiri|yojiri
籾摺り	もみすり	momisuri
咳く	せく|しわぶく	seku|shiwabuku
日溜まり	ひだまり	hidamari
祓え	はらえ|ばらえ	harae|barae
腹這い	はらばい	harabai
厭き	あき	aki
篭める	こめる	komeru
栗まんじゅう	くりまんじゅう	kurimannjuu
嬉し泣き	うれしなき	ureshinaki
煉る	ねる	neru
紅蓮の炎	ぐれんのほのお	gurennnohonoo
鬨の声	ときのこえ	tokinokoe
弛める	ゆるめる|たるめる	yurumeru|tarumeru
熔ける	とける	tokeru
和綴じ	わとじ	watoji
引き篭る	ひきこもる	hikikomoru
お陀仏	おだぶつ	odabutsu
鋤く	すく	suku
梳かす	とかす	tokasu
蕎麦切り	そばきり	sobakiri
嵌め込み	はめこみ	hamekomi
子供騙し	こどもだまし	kodomodamashi
捩じる	ねじる	nejiru
涙脆い	なみだもろい	namidamoroi
咳込む	せきこむ	sekikomu
簀巻き	すまき	sumaki
啄む	ついばむ	tsuibamu
組み紐	くみひも	kumihimo
曰く付き	いわくつき	iwakutsuki
踏み躙る	ふみにじる	fuminijiru
濡れ縁	ぬれえん	nureenn
弘める	ひろめる|びろめる	hiromeru|biromeru
豆撒き	まめまき	mamemaki
立ち竦む	たちすくむ	tachisukumu
鞣す	なめす	namesu
萌え出る	もえでる	moederu
刳る	くる|ぐる|えぐる	kuru|guru|eguru
待ち侘びる	まちわびる	machiwabiru
磯臭い	いそくさい	isokusai
血腥い	ちなまぐさい	chinamagusai
粒揃い	つぶぞろい	tsubuzoroi
鸚鵡返し	おうむがえし	oumugaeshi
廻らす	めぐらす	megurasu
漉し餡	こしあん	koshiann
誅する	ちゅうする	tyuusuru
嘶く	いななく	inanaku
お櫃	おひつ	ohitsu
黴臭い	かびくさい	kabikusai
鍔迫り合い	つばぜりあい	tsubazeriai
最後っ屁	さいごっぺ	saigoppe
擧げる	あげる	ageru
誹る	そしる	soshiru
お蔭さま	おかげさま	okagesama
火炙り	ひあぶり	hiaburi
穢らわしい	けがらわしい	kegarawashii
賎しい	いやしい	iyashii
茹だる	うだる|ゆだる	udaru|yudaru
蒔ける	まける	makeru
臍の緒	へそのお|ほぞのお	hesonoo|hozonoo
毅然たる	きぜんたる	kizenntaru
誑かす	たぶらかす	taburakasu
掴み取り	つかみどり|つかみとり	tsukamidori|tsukamitori
賽の目	さいのめ	sainome
辿れる	たどれる	tadoreru
樺の木	かばのき	kabanoki
勿体ぶる	もったいぶる	mottaiburu
呆れかえる	あきれかえる	akirekaeru
逢魔が時	おうまがとき	oumagatoki
嗜める	たしなめる	tashinameru
魘される	うなされる	unasareru
丑の刻参り	うしのときまいり	ushinotokimairi
疳の虫	かんのむし	kannnomushi
烏滸がましい	おこがましい	okogamashii
厭わしい	いとわしい	itowashii
錆付く	さびつく	sabitsuku
轟かす	とどろかす	todorokasu
誦する	しょうする|じゅする	shousuru|jusuru
擽ったい	くすぐったい	kusuguttai
皺寄せ	しわよせ	shiwayose
釜茹で	かまゆで	kamayude
吊り革	つりかわ	tsurikawa
憚り	はばかり	habakari
馨しい	かぐわしい	kaguwashii
縒り	より	yori
打出の小槌	うちでのこづち	uchidenokoduchi
鞘取り	さやとり	sayatori
暈し	ぼかし	bokashi
壷焼き	つぼやき	tsuboyaki
悴む	かじかむ	kajikamu
腑甲斐無い	ふがいない	fugainai
口喧しい	くちやかましい	kuchiyakamashii
掴み所	つかみどころ	tsukamidokoro
擡げる	もたげる	motageru
おが屑	おがくず	ogakuzu
馨る	かおる	kaoru
睨みあう	にらみあう	niramiau
凛凛しい	りりしい	ririshii
掻き込む	かきこむ	kakikomu
粟立つ	あわだつ	awadatsu
吊り上がる	つりあがる	tsuriagaru
釘抜き	くぎぬき	kuginuki
売り捌く	うりさばく	urisabaku
掻ける	かける	kakeru
胡散い	うさんい	usanni
焚ける	たける	takeru
阿る	おもねる	omoneru
蕾む	つぼむ	tsubomu
雁字搦め	がんじがらめ	gannjigarame
お伽草子	おとぎぞうし	otogizoushi
掻い摘む	かいつまむ	kaitsumamu
嵩じる	こうじる	koujiru
噛み合せる	かみあわせる	kamiawaseru
諂う	へつらう|へつろう	hetsurau|hetsurou
按ずる	あんずる	annzuru
煽て	おだて	odate
孵す	かえす	kaesu
溜り場	たまりば	tamariba
人馴れ	ひとなれ	hitonare
上がり框	あがりかまち|あがりがまち	agarikamachi|agarigamachi
爺むさい	じじむさい	jijimusai
繙く	ひもとく	himotoku
槍投げ	やりなげ	yarinage
瑞瑞しい	みずみずしい	mizumizushii
焙じる	ほうじる	houjiru
咬める	かめる	kameru
物淋しい	ものさびしい	monosabishii
紐解ける	ひもとける	himotokeru
棹さす	さおさす	saosasu
隈取り	くまどり	kumadori
忝ない	かたじけない	katajikenai
撫で付ける	なでつける	nadetsukeru
窄まる	すぼまる|つぼまる	subomaru|tsubomaru
もの淋しい	ものさびしい	monosabishii
托す	たくす	takusu
囂しい	かまびすしい	kamabisushii
婀娜っぽい	あだっぽい	adappoi
洒落臭い	しゃらくさい	sharakusai
一の酉	いちのとり	ichinotori
漕ぎつける	こぎつける	kogitsukeru
尖らす	とがらす	togarasu
下拵え	したごしらえ	shitagoshirae
稔る	みのる	minoru
吝い	しわい	shiwai
腥い	なまぐさい	namagusai
繋る	かかる|つながる	kakaru|tsunagaru
挾む	はさむ	hasamu
掠り	かすり	kasuri
日溜り	ひだまり	hidamari
呑み込める	のみこめる	nomikomeru
掴みどころ	つかみどころ	tsukamidokoro
ちょび髭	ちょびひげ	tyobihige
葵祭り	あおいまつり	aoimatsuri
拗る	ねじる|こじれる|すねる|ねじける	nejiru|kojireru|suneru|nejikeru
双頭の鷲	そうとうのわし	soutounowashi
捲し立てる	まくしたてる	makushitateru
狡っ辛い	こすっからい	kosukkarai
月の桂	つきのかつら	tsukinokatsura
穢らしい	きたならしい	kitanarashii
弛い	たゆい	tayui
馴れなれしい	なれなれしい	narenareshii
うら淋しい	うらさびしい	urasabishii
俯せる	うつぶせる	utsubuseru
吊るせる	つるせる	tsuruseru
山篭り	やまごもり	yamagomori
引っ掴む	ひっつかむ	hittsukamu
與える	あたえる	ataeru
掻き鳴らす	かきならす	kakinarasu
腑分け	ふわけ	fuwake
綯う	なう|のう	nau|nou
吊れる	つれる	tsureru
泣き濡れる	なきぬれる	nakinureru
狸寝入り	たぬきねいり	tanukineiri
脹らむ	ふくらむ	fukuramu
懶い	ものうい	monoui
寝穢い	いぎたない	igitanai
二の酉	にのとり	ninotori
諳んじる	そらんじる	sorannjiru
毫も	ごうも	goumo
洽い	あまねい	amanei
言い淀む	いいよどむ	iiyodomu
遽しい	あわただしい	awatadashii
傳える	つたえる	tsutaeru
詫びしい	わびしい	wabishii
疳高い	かんだかい	kanndakai
狡っからい	こすっからい	kosukkarai
鏤める	ちりばめる	chiribameru
耀かしい	かがやかしい	kagayakashii
粕取り	かすとり	kasutori
聰い	さとい	satoi
懈い	たゆい|だるい|だりい	tayui|darui|darii
吝か	やぶさか	yabusaka
廻れる	まわれる|めぐれる	mawareru|megureru
猥りがわしい	みだりがわしい	midarigawashii
賑にぎしい	にぎにぎしい	niginigishii
勿体らしい	もったいらしい	mottairashii
佩く	はく	haku
狡辛い	こすっからい|こすからい	kosukkarai|kosukarai
馴なれしい	なれなれしい	narenareshii
穢れる	けがれる	kegareru
劈く	つんざく	tsunnzaku
辿たどしい	たどたどしい	tadotadoshii
腹穢い	はらぎたない	haragitanai
賑賑しい	にぎにぎしい	niginigishii
枉枉しい	まがまがしい	magamagashii
袈裟斬り	けさぎり	kesagiri
鯉こく	こいこく	koikoku
狐憑き	きつねつき	kitsunetsuki
袈裟懸け	けさがけ	kesagake
耳聰い	みみざとい	mimizatoi
忽ちに	たちまちに	tachimachini
身篭る	みごもる	migomoru
祟り目	たたりめ	tatarime
水捌け	みずはけ	mizuhake
此の方	このかた|このほう	konokata|konohou
吃り	どもり	domori
湯飲み茶碗	ゆのみぢゃわん	yunomidyawann
撫でつける	なでつける	nadetsukeru
碾く	ひく|びく	hiku|biku
夙に	つとに	tsutoni
脹れる	ふくれる|ぶくれる	fukureru|bukureru
悖る	もとる	motoru
胃の腑	いのふ	inofu
佇つ	たつ|だつ	tatsu|datsu
犇めく	ひしめく	hishimeku
人攫い	ひとさらい	hitosarai
三の酉	さんのとり	sannnotori
悪足掻き	わるあがき	waruagaki
吃る	どもる	domoru
啜り泣く	すすりなく	susurinaku
此の度	このたび	konotabi
鍬入れ	くわいれ	kuwaire
お萩	おはぎ	ohagi
働き蟻	はたらきあり	hatarakiari
貰い泣き	もらいなき	morainaki
直播き	じかまき|じきまき	jikamaki|jikimaki
攀じ登る	よじのぼる	yojinoboru
賣る	うる	uru
炒り豆	いりまめ	irimame
ばら蒔く	ばらまく	baramaku
蟠り	わだかまり	wadakamari
撥ねる	はねる|ぱねる	haneru|paneru
思う壷	おもうつぼ	omoutsubo
汲み取れる	くみとれる	kumitoreru
絆される	ほだされる	hodasareru
一纏め	ひとまとめ	hitomatome
拱く	こまぬく|こまねく	komanuku|komaneku
剃り落とす	そりおとす	soriotosu
矧ぐ	はぐ	hagu
吊し上げ	つるしあげ	tsurushiage
抛る	ほうる	houru
餅搗き	もちつき	mochitsuki
噎せる	むせる	museru
四つ辻	よつつじ	yotsutsuji
足手纏い	あしてまとい	ashitematoi
俯ける	うつむける	utsumukeru
見蕩れる	みとれる	mitoreru
溜めこむ	ためこむ	tamekomu
出涸らし	でがらし	degarashi
天翔る	あまがける|あまかける	amagakeru|amakakeru
揉み手	もみで	momide
齧り付く	かじりつく|かぶりつく	kajiritsuku|kaburitsuku
穢す	けがす	kegasu
合い挽き	あいびき	aibiki
水掻き	みずかき	mizukaki