感じ	かんじ	kannji
商品	しょうひん	shouhinn
写真	しゃしん|じゃしん	shashinn|jashinn
問題	もんだい	monndai
世界	せかい	sekai
記事	きじ	kiji
問い合わせ	といあわせ	toiawase
仕事	しごと	shigoto
使用	しよう	shiyou
研究	けんきゅう	kennkyuu
時代	じだい	jidai
事業	じぎょう	jigyou
言葉	ことば	kotoba
活動	かつどう	katsudou
意味	いみ	imi
作品	さくひん	sakuhinn
受け	うけ	uke
場所	ばしょ	basho
教育	きょういく	kyouiku
部屋	へや|べや	heya|beya
全国	ぜんこく	zennkoku
向け	むけ	muke
予定	よてい	yotei
病院	びょういん	byouinn
部分	ぶぶん	bubunn
会員	かいいん	kaiinn
開発	かいはつ	kaihatsu
相談	そうだん	soudann
相手	あいて	aite
始め	はじめ	hajime
委員	いいん	iinn
全て	すべて	subete
意見	いけん	ikenn
旅行	りょこう	ryokou
気持ち	きもち	kimochi
悪い	わるい|わりい|わろい	warui|warii|waroi
一部	いちぶ	ichibu
注文	ちゅうもん|ちゅうぶん	chuumonn|chuubunn
家族	かぞく	kazoku
注意	ちゅうい	chuui
理由	りゆう	riyuu
指定	してい	shitei
期待	きたい	kitai
発表	はっぴょう	happyou
代表	だいひょう	daihyou
文化	ぶんか	bunnka
公開	こうかい	koukai
流れ	ながれ	nagare
登場	とうじょう	toujou
使い	つかい|つかわい|づかい	tsukai|tsukawai|dukai
安全	あんぜん	annzenn
年度	ねんど	nenndo
作業	さぎょう	sagyou
安心	あんしん	annshinn
自身	じしん	jishinn
取引	とりひき	torihiki
使う	つかう|つこう	tsukau|tsukou
開始	かいし	kaishi
自由	じゆう	jiyuu
全体	ぜんたい	zenntai
一度	ひとたび|いちど	hitotabi|ichido
勉強	べんきょう	bennkyou
決定	けってい	kettei
話題	わだい	wadai
時期	じき	jiki
期間	きかん	kikann
発生	はっせい	hassei
放送	ほうそう	housou
全く	まったく	mattaku
発売	はつばい	hatsubai
行動	こうどう	koudou
動画	どうが	douga
工事	こうじ	kouji
番号	ばんごう	banngou
持つ	もつ	motsu
中央	ちゅうおう	chuuou
練習	れんしゅう	rennshuu
食事	しょくじ	shokuji
第一	だいいち	daiichi
全部	ぜんぶ	zennbu
運動	うんどう	unndou
歯科	しか	shika
様子	ようす	yousu
道路	どうろ	douro
注目	ちゅうもく	chuumoku
発見	はっけん	hakkenn
今度	こんど	konndo
感想	かんそう	kannsou
家庭	かてい	katei
心配	しんぱい	shinnpai
有名	ゆうめい	yuumei
都市	とし	toshi
学習	がくしゅう	gakushuu
面白い	おもしろい	omoshiroi
動物	どうぶつ	doubutsu
住所	じゅうしょ	juusho
自動車	じどうしゃ	jidousha
事実	じじつ	jijitsu
方向	ほうこう	houkou
神社	じんじゃ	jinnja
地区	ちく	chiku
予想	よそう	yosou
決め	きめ|ぎめ	kime|gime
持ち	もち	mochi
画面	がめん	gamenn
動き	うごき	ugoki
落ち	おち	ochi
用意	ようい	youi
身体	しんたい|からだ	shinntai|karada
運転	うんてん	unntenn
幸せ	しあわせ	shiawase
野球	やきゅう	yakyuu
調べ	しらべ	shirabe
負け	まけ	make
銀行	ぎんこう	ginnkou
地球	ちきゅう	chikyuu
美味しい	おいしい	oishii
食品	しょくひん	shokuhinn
終わり	おわり	owari
発送	はっそう	hassou
遊び	あそび|すさび	asobi|susabi
仕方	しかた	shikata
物語	ものがたり	monogatari
祭り	まつり	matsuri
飲み	のみ	nomi
業者	ぎょうしゃ	gyousha
感じる	かんじる	kannjiru
鉄道	てつどう	tetsudou
起き	おき	oki
大事	おおごと|だいじ	oogoto|daiji
発言	はつげん	hatsugenn
美しい	うつくしい	utsukushii
気軽	きがる	kigaru
病気	びょうき	byouki
全員	ぜんいん	zenninn
発行	はっこう	hakkou
交流	こうりゅう	kouryuu
問合せ	といあわせ	toiawase
業界	ぎょうかい	gyoukai
買い物	かいもの	kaimono
人物	じんぶつ	jinnbutsu
同様	どうよう	douyou
文章	ぶんしょう	bunnshou
取り	とり|どり	tori|dori
調整	ちょうせい	chousei
感動	かんどう	kanndou
用品	ようひん	youhinn
反対	はんたい	hanntai
具体	ぐたい	gutai
高速	こうそく	kousoku
医院	いいん	iinn
社員	しゃいん	shainn
目指し	めざし	mezashi
受ける	うける	ukeru
自転車	じてんしゃ	jitennsha
住まい	すまい|ずまい	sumai|zumai
勝手	かって|がって	katte|gatte
安定	あんてい	anntei
飲ん	のん|やん	nonn|yann
送る	おくる	okuru
集め	あつめ	atsume
息子	むすこ	musuko
向上	こうじょう	koujou
植物	しょくぶつ	shokubutsu
安い	やすい|やしい	yasui|yashii
予算	よさん	yosann
相当	そうとう	soutou
次回	じかい	jikai
読者	どくしゃ	dokusha
平和	へいわ	heiwa
公式	こうしき	koushiki
路線	ろせん	rosenn
自動	じどう	jidou
丁目	ちょうめ	choume
方面	ほうめん	houmenn
農業	のうぎょう	nougyou
事前	じぜん	jizenn
出発	しゅっぱつ	shuppatsu
年代	ねんだい	nenndai
始まり	はじまり	hajimari
新着	しんちゃく	shinnchaku
出身	しゅっしん	shusshinn
整理	せいり	seiri
使える	つかえる	tsukaeru
首相	しゅしょう	shushou
旅館	りょかん	ryokann
近所	きんじょ	kinnjo
有り	あり	ari
強化	きょうか	kyouka
実行	じっこう	jikkou
他人	たにん|ひと|びと	taninn|hito|bito
使い方	つかいかた	tsukaikata
空港	くうこう	kuukou
子育て	こそだて	kosodate
集中	しゅうちゅう	shuuchuu
定期	ていき	teiki
生命	せいめい|いのち	seimei|inochi
配送	はいそう	haisou
始まる	はじまる	hajimaru
去年	こぞ|きょねん	kozo|kyonenn
主な	おもな	omona
登山	とざん	tozann
勝手に	かってに	katteni
目指す	めざす	mezasu
太陽	たいよう	taiyou
深い	ふかい|ぶかい	fukai|bukai
守る	まもる|もる	mamoru|moru
決して	けっして|けして	kesshite|keshite
都合	つごう	tsugou
始める	はじめる	hajimeru
始めて	はじめて	hajimete
次第	しだい	shidai
県内	けんない	kennnai
世代	せだい	sedai
仕様	しよう	shiyou
記者	きしゃ	kisha
表記	ひょうき	hyouki
勝ち	かち|がち	kachi|gachi
定める	さだめる	sadameru
高級	こうきゅう	koukyuu
運用	うんよう	unnyou
係る	かかわる|かかる	kakawaru|kakaru
取り組み	とりくみ	torikumi
車両	しゃりょう	sharyou
見事	みごと	migoto
回転	かいてん	kaitenn
調子	ちょうし|ぢょうし	choushi|dyoushi
返品	へんぴん	hennpinn
内部	ないぶ	naibu
進む	すすむ	susumu
商店	しょうてん	shoutenn
文庫	ぶんこ	bunnko
主に	おもに	omoni
列車	れっしゃ	ressha
代わり	かわり|がわり	kawari|gawari
化学	かがく|ばけがく	kagaku|bakegaku
取る	とる|どる	toru|doru
流し	ながし	nagashi
乗り	のり	nori
駅前	えきまえ	ekimae
理事	りじ	riji
表面	ひょうめん	hyoumenn
向かう	むかう	mukau
生物	せいぶつ|なまもの	seibutsu|namamono
助け	たすけ|すけ	tasuke|suke
部門	ぶもん	bumonn
長期	ちょうき	chouki
形式	けいしき	keishiki
待ち	まち	machi
工業	こうぎょう	kougyou
寒い	さむい|さぶい|さみい|さびい	samui|sabui|samii|sabii
出来事	できごと	dekigoto
返事	へんじ	hennji
終わる	おわる	owaru
落とし	おとし	otoshi
場面	ばめん	bamenn
飲食	いんしょく|おんじき	innshoku|onnjiki
世の中	よのなか	yononaka
代金	だいきん	daikinn
早速	さっそく	sassoku
育て	そだて	sodate
本部	ほんぶ	honnbu
苦手	にがて	nigate
主人	しゅじん	shujinn
方式	ほうしき	houshiki
勝負	しょうぶ|かちまけ	shoubu|kachimake
相場	そうば	souba
温度	おんど	onndo
所有	しょゆう	shoyuu
死ぬ	しぬ	shinu
思想	しそう	shisou
理想	りそう	risou
暑い	あつい|あちい	atsui|achii
中身	なかみ	nakami
同意	どうい	doui
医学	いがく	igaku
実家	じっか	jikka
進行	しんこう	shinnkou
投げ	なげ	nage
幸い	さいわい	saiwai
放題	ほうだい	houdai
起こし	おこし	okoshi
入荷	にゅうか	nyuuka
意外	いがい	igai
行事	ぎょうじ	gyouji
発電	はつでん	hatsudenn
動作	どうさ	dousa
漢字	かんじ	kannji
速度	そくど	sokudo
定め	さだめ	sadame
家具	かぐ	kagu
一定	いちじょう|いってい	ichijou|ittei
実感	じっかん	jikkann
集合	しゅうごう	shuugou
調べる	しらべる	shiraberu
化する	かする	kasuru
開き	あき|ひらき|びらき	aki|hiraki|biraki
出品	しゅっぴん	shuppinn
入院	にゅういん	nyuuinn
向こう	むこう	mukou
部品	ぶひん	buhinn
飲む	のむ	nomu
医者	いしゃ	isha
作者	さくしゃ	sakusha
知事	ちじ	chiji
打ち	うち|ぶち	uchi|buchi
両方	りょうほう	ryouhou
真実	しんじつ	shinnjitsu
仕上げ	しあげ	shiage
短い	みじかい	mijikai
重ね	かさね|がさね	kasane|gasane
荷物	にもつ	nimotsu
想い	おもい	omoi
出荷	しゅっか	shukka
部長	ぶちょう	buchou
屋根	やね	yane
開く	あく|ひらく	aku|hiraku
道具	どうぐ	dougu
地下鉄	ちかてつ	chikatetsu
海岸	うみぎし|かいがん	umigishi|kaigann
近代	きんだい	kinndai
本物	ほんもの	honnmono
外部	がいぶ	gaibu
体調	たいちょう	taichou
美人	びじん|めいれん	bijinn|meirenn
多様	たよう	tayou
着物	きもの	kimono
向き	むき	muki
両親	りょうしん	ryoushinn
役立つ	やくだつ	yakudatsu
実に	げに	geni
食べ物	たべもの	tabemono
気温	きおん	kionn
古代	こだい	kodai
受け入れ	うけいれ	ukeire
返し	かえし|がえし	kaeshi|gaeshi
平日	へいじつ	heijitsu
高等	こうとう	koutou
買取	かいとり	kaitori
有する	ゆうする	yuusuru
住む	すむ	sumu
具合	ぐあい|ぐわい	guai|guwai
重い	おもい	omoi
進化	しんか	shinnka
人事	じんじ|ひとごと	jinnji|hitogoto
実力	じつりょく	jitsuryoku
動く	うごく	ugoku
決勝	けっしょう	kesshou
進み	すすみ	susumi
世間	せけん	sekenn
役員	やくいん	yakuinn
仕方ない	しかたない	shikatanai
取り上げ	とりあげ	toriage
仕組み	しくみ	shikumi
高度	こうど	koudo
深夜	しんや	shinnya
向い	むい|むかい	mui|mukai
待つ	まつ	matsu
乗る	のる	noru
首都	しゅと	shuto
有る	ある	aru
調理	ちょうり	chouri
上部	じょうぶ	joubu
気味	きみ|ぎみ	kimi|gimi
味わい	あじわい	ajiwai
意思	いし	ishi
流れる	ながれる	nagareru
由来	ゆらい	yurai
物理	ぶつり	butsuri
投手	とうしゅ	toushu
次元	じげん	jigenn
身近	みじか	mijika
運命	うんめい	unnmei
発明	はつめい	hatsumei
正式	せいしき	seishiki
店員	てんいん	tenninn
向かい	むかい	mukai
天使	てんし	tennshi
起こる	おこる	okoru
公表	こうひょう	kouhyou
代理	だいり	dairi
表紙	ひょうし|びょうし	hyoushi|byoushi
体重	たいじゅう	taijuu
農家	のうか	nouka
植え	うえ	ue
登り	のぼり	nobori
全身	ぜんしん	zennshinn
会館	かいかん	kaikann
決める	きめる	kimeru
乗せ	のせ	nose
軽い	かるい|かりい	karui|karii
死に	しに|じに	shini|jini
悲しい	かなしい	kanashii
薬局	やっきょく	yakkyoku
教員	きょういん	kyouinn
予め	あらかじめ	arakajime
整形	せいけい	seikei
県立	けんりつ	kennritsu
発想	はっそう	hassou
小屋	こや|ごや|しょうおく	koya|goya|shouoku
開業	かいぎょう	kaigyou
南部	なんぶ	nannbu
開放	かいほう	kaihou
正面	せいめん|しょうめん	seimenn|shoumenn
進出	しんしゅつ	shinnshutsu
流行	りゅうこう|はやり|ばやり	ryuukou|hayari|bayari
決算	けっさん	kessann
守り	まもり|もり	mamori|mori
消し	けし	keshi
想定	そうてい	soutei
動向	どうこう	doukou
意図	いと	ito
商業	しょうぎょう	shougyou
作曲	さっきょく	sakkyoku
落ちる	おちる	ochiru
定番	ていばん	teibann
進学	しんがく	shinngaku
風味	ふうみ	fuumi
真ん中	まんなか	mannnaka
遊ぶ	あそぶ	asobu
学者	がくしゃ	gakusha
悪化	あっか	akka
決まり	きまり	kimari
進める	すすめる	susumeru
真面目	まじめ	majime
流通	りゅうつう|るずう	ryuutsuu|ruzuu
起動	きどう	kidou
主体	しゅたい	shutai
生き物	いきもの	ikimono
美し	うつくし	utsukushi
集会	しゅうかい	shuukai
短期	たんき	tannki
集まり	あつまり	atsumari
送り	おくり	okuri
消化	しょうか	shouka
手軽	てがる	tegaru
交代	こうたい	koutai
様式	ようしき	youshiki
表明	ひょうめい	hyoumei
全面	ぜんめん	zennmenn
目安	めやす	meyasu
早期	そうき	souki
電波	でんぱ	dennpa
休業	きゅうぎょう	kyuugyou
運行	うんこう	unnkou
問い合せ	といあわせ	toiawase
味方	みかた	mikata
乗車	じょうしゃ	jousha
代行	だいこう	daikou
学問	がくもん	gakumonn
小物	こもの	komono
強調	きょうちょう	kyouchou
学部	がくぶ	gakubu
合意	ごうい	goui
都内	とない	tonai
投入	とうにゅう	tounyuu
名物	めいぶつ	meibutsu
自主	じしゅ	jishu
暗い	くらい|ぐらい	kurai|gurai
和食	わしょく	washoku
石油	せきゆ	sekiyu
間取り	まどり	madori
勝つ	かつ|まさつ	katsu|masatsu
区間	くかん	kukann
区分	くぶん	kubunn
決意	けつい	ketsui
集まる	あつまる	atsumaru
気配	けはい|きはい	kehai|kihai
平気	へいき	heiki
根本	こんぼん|こんぽん|ねもと	konnbonn|konnponn|nemoto
体育	たいいく	taiiku
農薬	のうやく	nouyaku
幸福	こうふく	koufuku
客室	きゃくしつ	kyakushitsu
取り入れ	とりいれ	toriire
回路	かいろ	kairo
育てる	そだてる	sodateru
配合	はいごう	haigou
島根	しまね	shimane
予感	よかん	yokann
実用	じつよう	jitsuyou
合流	ごうりゅう	gouryuu
後期	こうき	kouki
商売	しょうばい	shoubai
実習	じっしゅう	jisshuu
この世	このよ	konoyo
主役	しゅやく	shuyaku
北部	ほくぶ	hokubu
庭園	ていえん	teienn
両手	りょうて|もろて	ryoute|morote
地面	じめん	jimenn
仕入れ	しいれれ|しいれ	shiirere|shiire
和風	わふう	wafuu
全力	ぜんりょく	zennryoku
西洋	せいよう	seiyou
一面	いちめん	ichimenn
目次	もくじ	mokuji
住人	じゅうにん	juuninn
起きる	おきる	okiru
行列	ぎょうれつ	gyouretsu
局長	きょくちょう	kyokuchou
打つ	うつ|ぶつ	utsu|butsu
角度	かくど	kakudo
都会	とかい	tokai
集落	しゅうらく	shuuraku
手配	てはい	tehai
指名	しめい	shimei
市区	しく	shiku
大根	だいこん|おおね	daikonn|oone
合宿	がっしゅく	gasshuku
起こす	おこす	okosu
名所	めいしょ|などころ	meisho|nadokoro
寺院	じいん	jiinn
強度	きょうど	kyoudo
感心	かんしん	kannshinn
着く	つく	tsuku
登る	のぼる	noboru
手帳	てちょう	techou
流石	さすが	sasuga
受注	じゅちゅう	juchuu
発注	はっちゅう	hacchuu
本屋	ほんや	honnya
暗号	あんごう	anngou
新品	しんぴん	shinnpinn
中部	ちゅうぶ	chuubu
起業	きぎょう	kigyou
落語	らくご	rakugo
取れる	とれる	toreru
動かす	うごかす	ugokasu
対立	たいりつ	tairitsu
開花	かいか	kaika
対決	たいけつ	taiketsu
中島	なかじま	nakajima
起こり	おこり	okori
落とす	おとす	otosu
定食	ていしょく	teishoku
橋本	はしもと	hashimoto
大宮	おおみや	oomiya
発足	ほっそく|はっそく	hossoku|hassoku
打ち合わせ	うちあわせ	uchiawase
大島	おおしま	ooshima
神話	しんわ	shinnwa
工具	こうぐ	kougu
活発	かっぱつ	kappatsu
反発	はんぱつ	hannpatsu
苦しい	くるしい|ぐるしい	kurushii|gurushii
大豆	だいず	daizu
整体	せいたい	seitai
定員	ていいん	teiinn
丁度	ちょうど	choudo
一品	いっぴん	ippinn
問い	とい	toi
開ける	あける|ひらける	akeru|hirakeru
重大	じゅうだい	juudai
表す	あらわす|ひょうす	arawasu|hyousu
取り出し	とりだし	toridashi
半島	はんとう	hanntou
地味	ちみ|じみ	chimi|jimi
登記	とうき	touki
速い	はやい|ばやい	hayai|bayai
身長	しんちょう	shinnchou
市区町村	しくちょうそん	shikuchousonn
役者	やくしゃ	yakusha
東洋	とうよう	touyou
先進	せんしん	sennshinn
全文	ぜんぶん	zennbunn
育ち	そだち	sodachi
部下	ぶか	buka
県道	けんどう	kenndou
着用	ちゃくよう	chakuyou
定着	ていちゃく	teichaku
当局	とうきょく	toukyoku
返答	へんとう	henntou
平野	へいや	heiya
平安	へいあん	heiann
何事	なにごと	nanigoto
決まる	きまる	kimaru
返す	かえす	kaesu
負荷	ふか	fuka
洋服	ようふく	youfuku
階級	かいきゅう	kaikyuu
水着	みずぎ	mizugi
仕立て	したて|じたて	shitate|jitate
部員	ぶいん	buinn
開店	かいてん	kaitenn
転送	てんそう	tennsou
海洋	かいよう	kaiyou
進歩	しんぽ	shinnpo
前向き	まえむき	maemuki
同期	どうき	douki
発音	はつおん	hatsuonn
負ける	まける	makeru
真っ赤	まっか	makka
発動	はつどう	hatsudou
仕上がり	しあがり	shiagari
世話	せわ|ぜわ	sewa|zewa
院長	いんちょう	innchou
下着	したぎ	shitagi
子宮	しきゅう	shikyuu
飲み物	のみもの	nomimono
都心	としん	toshinn
物流	ぶつりゅう	butsuryuu
一族	いちぞく	ichizoku
生息	せいそく	seisoku
上品	じょうぼん|じょうひん	joubonn|jouhinn
大橋	おおはし	oohashi
死体	したい	shitai
運送	うんそう	unnsou
重さ	おもさ	omosa
一流	いちりゅう	ichiryuu
金持ち	かねもち|がねもち	kanemochi|ganemochi
温かい	あたたかい	atatakai
駅名	えきめい	ekimei
学院	がくいん	gakuinn
集計	しゅうけい	shuukei
内定	ないてい	naitei
対話	たいわ	taiwa
流出	りゅうしゅつ	ryuushutsu
筆者	ひっしゃ	hissha
西部	せいぶ	seibu
上流	じょうりゅう	jouryuu
部会	ぶかい	bukai
行使	こうし	koushi
楽曲	がっきょく	gakkyoku
体感	たいかん	taikann
進路	しんろ	shinnro
記号	きごう	kigou
他社	たしゃ	tasha
神田	しんでん	shinndenn
店主	てんしゅ	tennshu
農園	のうえん	nouenn
消える	きえる	kieru
運び	はこび	hakobi
身分	みぶん	mibunn
食感	しょっかん	shokkann
通路	つうろ|かよいじ	tsuuro|kayoiji
両者	りょうしゃ	ryousha
急速	きゅうそく	kyuusoku
美味い	うまい	umai
受け取り	うけとり	uketori
出血	しゅっけつ|でち	shukketsu|dechi
下落	げらく	geraku
調和	ちょうわ	chouwa
有力	ゆうりょく	yuuryoku
指し	さし|ざし	sashi|zashi
電化	でんか	dennka
緑色	みどりいろ|りょくしょく	midoriiro|ryokushoku
調味	ちょうみ	choumi
女神	めがみ|じょしん|にょしん	megami|joshinn|nyoshinn
学級	がっきゅう	gakkyuu
勝てる	かてる	kateru
打ち上げ	うちあげ|ぶちあげ	uchiage|buchiage
中世	ちゅうせい	chuusei
死者	ししゃ	shisha
心身	しんしん	shinnshinn
指数	しすう	shisuu
商工	しょうこう	shoukou
線路	せんろ	sennro
会談	かいだん	kaidann
前期	ぜんき	zennki
物事	ものごと	monogoto
上級	じょうきゅう	joukyuu
先発	せんぱつ	sennpatsu
配当	はいとう	haitou
直送	ちょくそう	chokusou
和室	わしつ	washitsu
家事	かじ	kaji
流す	ながす	nagasu
定休	ていきゅう	teikyuu
万全	ばんぜん	bannzenn
部活	ぶかつ	bukatsu
問う	とう	tou
図面	ずめん	zumenn
後者	こうしゃ	kousha
開通	かいつう	kaitsuu
水面	すいめん|みなも|みのも	suimenn|minamo|minomo
代引き	だいびき	daibiki
食物	くいもの|しょくもつ	kuimono|shokumotsu
東部	とうぶ	toubu
集める	あつめる	atsumeru
球場	きゅうじょう	kyuujou
農村	のうそん	nousonn
口調	くちょう	kuchou
真相	しんそう	shinnsou
美味	びみ|うま	bimi|uma
天神	てんしん|てんじん	tennshinn|tennjinn
意向	いこう	ikou
館内	かんない	kannnai
台所	だいどころ	daidokoro
カ所	かしょ	kasho
礼金	れいきん	reikinn
写し	うつし	utsushi
高温	こうおん	kouonn
漢方	かんぽう	kannpou
相対	あいたい|そうたい	aitai|soutai
屋外	おくがい	okugai
屋台	やたい	yatai
実物	じつぶつ|みもの	jitsubutsu|mimono
真理	しんり	shinnri
指す	さす	sasu
運ぶ	はこぶ	hakobu
区画	くかく	kukaku
平等	びょうどう	byoudou
転用	てんよう	tennyou
所持	しょじ	shoji
電動	でんどう	denndou
服用	ふくよう	fukuyou
屋上	おくじょう	okujou
急行	きゅうこう	kyuukou
用事	ようじ	youji
味わう	あじわう	ajiwau
美女	びじょ	bijo
同等	どうとう	doutou
飲み会	のみかい	nomikai
登校	とうこう	toukou
追う	おう	ou
文部	もんぶ	monnbu
追記	ついき	tsuiki
宿題	しゅくだい	shukudai
水平	すいへい	suihei
当院	とういん	touinn
鉄板	てっぱん	teppann
大物	おおもの	oomono
持ち主	もちぬし	mochinushi
対談	たいだん	taidann
日和	ひより|びより	hiyori|biyori
問屋	といや|とんや|どいや|どんや	toiya|tonnya|doiya|donnya
使命	しめい	shimei
前進	ぜんしん	zennshinn
持ち帰り	もちかえり	mochikaeri
役所	やくしょ|やくどころ	yakusho|yakudokoro
去る	さる	saru
着る	きる	kiru
重点	じゅうてん	juutenn
所定	しょてい	shotei
原油	げんゆ	gennyu
放出	ほうしゅつ	houshutsu
助手	じょしゅ	joshu
農林	のうりん	nourinn
飲酒	いんしゅ|おんじゅ	innshu|onnju
申し出	もうしで	moushide
詩人	しじん	shijinn
薬物	やくぶつ	yakubutsu
題名	だいめい	daimei
路面	ろめん	romenn
真っ白	まっしろ	masshiro
農地	のうち	nouchi
電流	でんりゅう	dennryuu
路上	ろじょう	rojou
他者	たしゃ	tasha
安打	あんだ	annda
悲鳴	ひめい	himei
先物	さきもの	sakimono
算定	さんてい	sanntei
定年	ていねん	teinenn
下部	かぶ	kabu
幸運	こううん	kouunn
中期	ちゅうき	chuuki
家屋	かおく	kaoku
両国	りょうこく	ryoukoku
葉っぱ	はっぱ	happa
真夏	まなつ	manatsu
うつ病	うつびょう	utsubyou
主流	しゅりゅう	shuryuu
神宮	じんぐう	jinnguu
化合	かごう	kagou
落ち着き	おちつき	ochitsuki
主力	しゅりょく	shuryoku
悪口	わるぐち|あっこう|わるくち	waruguchi|akkou|warukuchi
商人	しょうにん|あきんど|あきゅうど	shouninn|akinndo|akyuudo
配線	はいせん	haisenn
毎度	まいど	maido
書面	しょめん	shomenn
大使	たいし	taishi
所長	しょちょう	shochou
急ぎ	いそぎ	isogi
やり取り	やりとり	yaritori
役場	やくば	yakuba
有用	ゆうよう	yuuyou
乗客	じょうきゃく	joukyaku
買物	かいもの	kaimono
配列	はいれつ	hairetsu
返金	へんきん	hennkinn
学期	がっき	gakki
人員	じんいん	jinninn
速やか	すみやか	sumiyaka
親族	しんぞく	shinnzoku
曲げ	まげ	mage
神楽	かぐら	kagura
習い事	ならいごと	naraigoto
命名	めいめい	meimei
島田	しまだ	shimada
消す	けす	kesu
路地	ろじ	roji
配分	はいぶん	haibunn
ため息	ためいき	tameiki
茶屋	じゃや|ちゃや	jaya|chaya
前面	ぜんめん	zennmenn
名曲	めいきょく	meikyoku
陽気	ようき	youki
反日	はんにち	hannnichi
電鉄	でんてつ	denntetsu
次男	じなん	jinann
落下	らっか	rakka
助ける	たすける|すける	tasukeru|sukeru
役目	やくめ	yakume
言動	げんどう	genndou
育つ	そだつ	sodatsu
小島	こじま	kojima
水泳	すいえい	suiei
列島	れっとう	rettou
向ける	むける	mukeru
新曲	しんきょく	shinnkyoku
原発	げんぱつ	gennpatsu
取り消し	とりけし	torikeshi
放つ	はなつ	hanatsu
体温	たいおん	taionn
反する	はんする	hannsuru
化石	かせき	kaseki
部落	ぶらく	buraku
味わえる	あじわえる	ajiwaeru
出題	しゅつだい	shutsudai
投下	とうか	touka
全集	ぜんしゅう	zennshuu
指先	ゆびさき	yubisaki
洋食	ようしょく	youshoku
待ち合わせ	まちあわせ	machiawase
両面	りょうめん	ryoumenn
着手	ちゃくしゅ	chakushu
負う	おう	ou
下流	かりゅう	karyuu
港区	こうく	kouku
助言	じょげん|じょごん	jogenn|jogonn
当面	とうめん	toumenn
多発	たはつ	tahatsu
集い	すだい|つどい	sudai|tsudoi
全開	ぜんかい	zennkai
両立	りょうりつ	ryouritsu
前者	ぜんしゃ	zennsha
炭火	すみび	sumibi
生育	せいいく	seiiku
船橋	せんきょう|ふなばし	sennkyou|funabashi
気持	きもち	kimochi
何者	なにもの	nanimono
頭部	とうぶ	toubu
身内	みうち|しんない	miuchi|shinnnai
物体	ぶったい	buttai
地酒	じざけ	jizake
早起き	はやおき	hayaoki
取組	とりくみ	torikumi
音波	おんぱ	onnpa
注入	ちゅうにゅう	chuunyuu
反面	はんめん	hannmenn
遊べる	あそべる	asoberu
決着	けっちゃく	kecchaku
対面	たいめん|だいめん	taimenn|daimenn
公平	こうへい	kouhei
入所	にゅうしょ	nyuusho
物品	ぶっぴん	buppinn
相方	あいかた	aikata
起用	きよう	kiyou
真空	しんくう	shinnkuu
感度	かんど	kanndo
問合わせ	といあわせ	toiawase
拾い	ひろい	hiroi
次期	じき	jiki
乗り物	のりもの	norimono
曲目	きょくもく	kyokumoku
期日	きじつ	kijitsu
死去	しきょ	shikyo
役人	やくにん	yakuninn
遊園	ゆうえん	yuuenn
見物	けんぶつ|みもの	kennbutsu|mimono
手持ち	てもち	temochi
事由	じゆう	jiyuu
日向	ひなた	hinata
終点	しゅうてん	shuutenn
王者	おうじゃ|おうしゃ	ouja|ousha
一員	いちいん	ichiinn
開会	かいかい	kaikai
青葉	あおば	aoba
お守り	おまもり	omamori
作物	さくぶつ|さくもつ	sakubutsu|sakumotsu
先着	せんちゃく	sennchaku
集客	しゅうきゃく	shuukyaku
持てる	もてる	moteru
通院	つういん	tsuuinn
用具	ようぐ	yougu
流動	りゅうどう	ryuudou
全角	ぜんかく	zennkaku
農場	のうじょう	noujou
顔面	がんめん	gannmenn
調教	ちょうきょう	choukyou
重ねる	かさねる	kasaneru
平面	へいめん	heimenn
平行	へいこう	heikou
新緑	しんりょく	shinnryoku
打者	だしゃ	dasha
転落	てんらく	tennraku
真田	さなだ	sanada
持たせ	もたせ	motase
作動	さどう	sadou
死後	しご	shigo
火事	かじ	kaji
化け	ばけ	bake
図表	ずひょう	zuhyou
千代	せんだい|ちよ	senndai|chiyo
終始	しゅうし	shuushi
命中	めいちゅう	meichuu
仕分け	しわけ	shiwake
早急	さっきゅう|そうきゅう	sakkyuu|soukyuu
旅人	たびびと|たびにん|りょじん	tabibito|tabininn|ryojinn
虫歯	むしば	mushiba
使い勝手	つかいがって	tsukaigatte
薬品	やくひん	yakuhinn
入れ歯	いれば	ireba
品目	ひんもく	hinnmoku
筆頭	ひっとう|ふでがしら	hittou|fudegashira
商社	しょうしゃ	shousha
飲める	のめる	nomeru
投げる	なげる	nageru
見送り	みおくり	miokuri
品切れ	しなぎれ	shinagire
短大	たんだい	tanndai
夏祭り	なつまつり	natsumatsuri
本館	ほんかん	honnkann
県外	けんがい	kenngai
皮肉	ひにく	hiniku
着実	ちゃくじつ	chakujitsu
今期	こんき	konnki
一息	ひといき	hitoiki
和紙	わし	washi
和牛	わぎゅう	wagyuu
陽子	ようし	youshi
羽根	はね|ばね	hane|bane
他国	たこく	takoku
直面	ちょくめん	chokumenn
意地	いじ	iji
手打ち	てうち	teuchi
定数	ていすう	teisuu
内面	ないめん|うちづら	naimenn|uchidura
童話	どうわ	douwa
実名	じつめい|じつみょう	jitsumei|jitsumyou
年次	ねんじ	nennji
分配	ぶんぱい	bunnpai
波動	はどう	hadou
水路	すいろ	suiro
真っ直ぐ	まっすぐ	massugu
暗黒	あんこく	annkoku
区内	くない	kunai
文具	ぶんぐ	bunngu
終える	おえる	oeru
大神	おおみかみ|だいじん	oomikami|daijinn
親指	おやゆび	oyayubi
重力	じゅうりょく	juuryoku
開運	かいうん	kaiunn
練り	ねり	neri
引き受け	ひきうけ	hikiuke
落書き	らくがき	rakugaki
曲線	きょくせん	kyokusenn
本命	ほんめい	honnmei
動員	どういん	douinn
直感	ちょっかん	chokkann
追放	ついほう	tsuihou
出世	しゅっせ	shusse
神道	しんとう	shinntou
主題	しゅだい	shudai
取組み	とりくみ	torikumi
打線	だせん	dasenn
時事	じじ	jiji
水温	すいおん	suionn
当館	とうかん	toukann
実体	じったい|じってい	jittai|jittei
頭皮	とうひ	touhi
次いで	ついで	tsuide
深める	ふかめる	fukameru
見受け	みうけ	miuke
石橋	いしばし	ishibashi
品物	しなもの|しなもん	shinamono|shinamonn
見所	みどころ	midokoro
予言	よげん	yogenn
食育	しょくいく	shokuiku
坂道	さかみち	sakamichi
屋内	おくない	okunai
短歌	たんか	tannka
川島	かわしま	kawashima
苦しむ	くるしむ	kurushimu
着色	ちゃくしょく	chakushoku
定時	ていじ	teiji
院内	いんない	innnai
都度	つど	tsudo
温室	おんしつ|うんしつ	onnshitsu|unnshitsu
談話	だんわ	dannwa
出動	しゅつどう	shutsudou
表れ	あらわれ	araware
整える	ととのえる	totonoeru
発作	ほっさ	hossa
名乗る	なのる	nanoru
放流	ほうりゅう	houryuu
根元	こんげん|ねもと	konngenn|nemoto
書物	かきもの|しょもつ	kakimono|shomotsu
発する	はっする	hassuru
酒場	さかば	sakaba
次会	じかい	jikai
有数	ゆうすう	yuusuu
平家	ひらや	hiraya
流星	ながれぼし|りゅうせい	nagareboshi|ryuusei
始動	しどう	shidou
発着	はっちゃく	hacchaku
新橋	しんばし	shinnbashi
持ち出し	もちだし	mochidashi
向く	むく	muku
公安	こうあん	kouann
福音	ふくいん	fukuinn
局面	きょくめん	kyokumenn
悪意	あくい	akui
真っ暗	まっくら	makkura
多重	たじゅう	tajuu
田植え	たうえ	taue
一味	いちみ|ひとあじ	ichimi|hitoaji
車庫	しゃこ	shako
定めて	さだめて	sadamete
等しい	ひとしい	hitoshii
全米	ぜんべい	zennbei
石炭	せきたん	sekitann
消去	しょうきょ	shoukyo
緑化	りょっか|りょくか	ryokka|ryokuka
決心	けっしん	kesshinn
金具	かなぐ	kanagu
読み取り	よみとり	yomitori
全室	ぜんしつ	zennshitsu
洋書	ようしょ	yousho
近世	きんせい	kinnsei
反転	はんてん	hanntenn
回想	かいそう	kaisou
発車	はっしゃ	hassha
実写	じっしゃ	jissha
教委	きょうい	kyoui
書式	しょしき	shoshiki
着工	ちゃっこう	chakkou
泳ぐ	およぐ	oyogu
商談	しょうだん	shoudann
来院	らいいん	raiinn
細部	さいぶ	saibu
重なる	かさなる	kasanaru
年配	ねんぱい	nennpai
花屋	はなや	hanaya
林業	りんぎょう	rinngyou
後世	こうせい|ごせ	kousei|gose
発光	はっこう	hakkou
面談	めんだん	menndann
楽章	がくしょう	gakushou
中級	ちゅうきゅう	chuukyuu
直進	ちょくしん	chokushinn
紙面	しめん	shimenn
弱者	じゃくしゃ	jakusha
帰路	きろ	kiro
真っ黒	まっくろ	makkuro
泳ぎ	およぎ	oyogi
消火	しょうか	shouka
使い分け	つかいわけ	tsukaiwake
取り外し	とりはずし	torihazushi
係数	けいすう	keisuu
和書	わしょ	washo
植木	うえき	ueki
想い出	おもいで	omoide
取消	とりけし	torikeshi
育毛	いくもう	ikumou
三味線	しゃみせん	shamisenn
対岸	たいがん	taigann
昔話	むかしばなし	mukashibanashi
進入	しんにゅう	shinnnyuu
反動	はんどう	hanndou
対人	たいじん	taijinn
着うた	ちゃくうた	chakuuta
空調	くうちょう	kuuchou
全長	ぜんちょう	zennchou
た感	たかん	takann
着目	ちゃくもく	chakumoku
真っ先	まっさき	massaki
開館	かいかん	kaikann
緑茶	りょくちゃ	ryokucha
他方	たほう	tahou
外相	がいしょう|げそう	gaishou|gesou
助かる	たすかる	tasukaru
動力	どうりょく	douryoku
行進	こうしん	koushinn
受取	うけとり	uketori
流入	りゅうにゅう	ryuunyuu
等級	とうきゅう	toukyuu
去り	さり	sari
全品	ぜんぴん	zennpinn
流用	りゅうよう	ryuuyou
悲し	かなし	kanashi
投球	とうきゅう	toukyuu
区切り	くぎり	kugiri
電球	でんきゅう	dennkyuu
注ぐ	そそぐ|つぐ	sosogu|tsugu
館長	かんちょう	kannchou
二部	にぶ	nibu
実業	じつぎょう	jitsugyou
勝ち組	かちぐみ	kachigumi
写メ	しゃめ	shame
乗船	じょうせん	jousenn
登用	とうよう	touyou
本業	ほんぎょう	honngyou
朝起き	あさおき	asaoki
長所	ちょうしょ	chousho
都立	とりつ	toritsu
代わる	かわる	kawaru
夏期	かき	kaki
商事	しょうじ	shouji
金庫	きんこ	kinnko
送金	そうきん	soukinn
品書き	しながき	shinagaki
起点	きてん	kitenn
緑地	りょくち	ryokuchi
読み返し	よみかえし	yomikaeshi
開口	かいこう	kaikou
集う	つどう	tsudou
乗り場	のりば	noriba
身の回り	みのまわり	minomawari
返送	へんそう	hennsou
小豆	あずき	azuki
和洋	わよう	wayou
打ち出し	うちだし	uchidashi
神事	しんじ	shinnji
問いかけ	といかけ	toikake
一式	いっしき	isshiki
手動	しゅどう	shudou
曲がり	まがり	magari
代え	かえ|がえ	kae|gae
受理	じゅり	juri
安らぎ	やすらぎ	yasuragi
買い取り	かいとり	kaitori
平米	へいべい	heibei
度合い	どあい	doai
中庭	なかにわ	nakaniwa
上着	うわぎ	uwagi
様相	ようそう	yousou
酒屋	さかや|ざかや	sakaya|zakaya
荷重	かじゅう|におも	kajuu|niomo
主たる	しゅたる	shutaru
乗せる	のせる	noseru
答申	とうしん	toushinn
南向き	みなみむき	minamimuki
国有	こくゆう	kokuyuu
学童	がくどう	gakudou
洋風	ようふう	youfuu
引き起こし	ひきおこし	hikiokoshi
学区	がっく	gakku
平山	ひらやま	hirayama
配り	くばり	kubari
洋画	ようが	youga
旅客	りょかく|りょきゃく	ryokaku|ryokyaku
か所	かしょ	kasho
終り	おわり	owari
想う	おもう	omou
急ぐ	いそぐ	isogu
転生	てんしょう|てんせい	tennshou|tennsei
和歌	わか	waka
宿命	しゅくめい	shukumei
一転	いってん	ittenn
仕草	しぐさ	shigusa
原始	げんし	gennshi
橋下	きょうか	kyouka
放火	ほうか	houka
医薬	いやく	iyaku
鼻水	はなみず	hanamizu
空想	くうそう	kuusou
大祭	たいさい	taisai
一人旅	ひとりたび	hitoritabi
後部	こうぶ	koubu
動植物	どうしょくぶつ	doushokubutsu
死神	しにがみ	shinigami
談合	だんごう	danngou
面会	めんかい	mennkai
ゴミ箱	ごみばこ	gomibako
重度	じゅうど	juudo
仕え	つかえ	tsukae
商用	しょうよう	shouyou
夕陽	ゆうひ	yuuhi
事後	じご	jigo
詩集	ししゅう	shishuu
買取り	かいとり	kaitori
見習い	みならい	minarai
風習	ふうしゅう	fuushuu
持ち物	もちもの	mochimono
手助け	てだすけ	tedasuke
重なり	かさなり	kasanari
水深	すいしん	suishinn
小路	こうじ	kouji
指向	しこう	shikou
暗記	あんき	annki
下品	げぼん|げひん	gebonn|gehinn
人身	じんしん|ひとみ	jinnshinn|hitomi
帰化	きか	kika
台帳	だいちょう	daichou
乗れる	のれる	noreru
休息	きゅうそく	kyuusoku
先代	せんだい	senndai
本題	ほんだい	honndai
温か	あたたか|あったか	atataka|attaka
飲み屋	のみや	nomiya
万葉	まんよう	mannyou
乗馬	じょうば	jouba
三宮	さんぐう	sannguu
整合	せいごう	seigou
前身	ぜんしん	zennshinn
代用	だいよう	daiyou
旅立ち	たびだち	tabidachi
定か	さだか	sadaka
曲名	きょくめい	kyokumei
発進	はっしん	hasshinn
長者	ちょうじゃ	chouja
海面	かいめん|うなづら	kaimenn|unadura
神父	しんぷ	shinnpu
乗り入れ	のりいれ	noriire
所見	しょけん	shokenn
打合せ	うちあわせ	uchiawase
波長	はちょう	hachou
商会	しょうかい	shoukai
銀色	ぎんいろ|ぎんしょく	ginniro|ginnshoku
読み物	よみもの	yomimono
着地	ちゃくち	chakuchi
来館	らいかん	raikann
長持ち	ながもち	nagamochi
打ち切り	うちきり	uchikiri
決め手	きめて	kimete
温水	おんすい	onnsui
次女	じじょ	jijo
仕切り	しきり|じきり	shikiri|jikiri
悪人	あくにん	akuninn
自発	じはつ	jihatsu
筆記	ひっき	hikki
申し入れ	もうしいれ	moushiire
仕出し	しだし	shidashi
県下	けんか	kennka
病理	びょうり	byouri
対等	たいとう	taitou
問答	もんどう	monndou
記帳	きちょう	kichou
待ち受け	まちうけ	machiuke
水銀	すいぎん	suiginn
向う	むかう|むこう	mukau|mukou
転売	てんばい	tennbai
和え	あえ	ae
対外	たいがい	taigai
遊具	ゆうぐ	yuugu
申立て	もうしたて	moushitate
登板	とうばん	toubann
美白	びはく	bihaku
落ち葉	おちば	ochiba
黒豆	くろまめ	kuromame
休館	きゅうかん	kyuukann
分身	ぶんしん	bunnshinn
落葉	らくよう|おちば	rakuyou|ochiba
四球	しきゅう	shikyuu
持ち合わせ	もちあわせ	mochiawase
洋楽	ようがく	yougaku
平ら	たいら|だいら	taira|daira
係員	かかりいん	kakariinn
次ぐ	つぐ	tsugu
始発	しはつ	shihatsu
苦い	にがい	nigai
使者	ししゃ	shisha
楽屋	がくや	gakuya
名乗り	なのり	nanori
大福	だいふく	daifuku
温もり	ぬくもり	nukumori
表題	ひょうだい	hyoudai
年表	ねんぴょう	nennpyou
県南	けんなん	kennnann
育む	はぐくむ	hagukumu
使い道	つかいみち	tsukaimichi
平地	ひらち|へいち	hirachi|heichi
本島	ほんとう	honntou
式場	しきじょう	shikijou
古都	こと	koto
新宮	しんぐう|しんみや	shinnguu|shinnmiya
植林	しょくりん	shokurinn
曲がる	まがる	magaru
仕事場	しごとば	shigotoba
流行り	はやり|ばやり	hayari|bayari
悪役	あくやく	akuyaku
薬草	やくそう	yakusou
足湯	あしゆ	ashiyu
前世	ぜんせ|ぜんせい	zennse|zennsei
子守	こもり	komori
葉山	はやま	hayama
真冬	まふゆ	mafuyu
山登り	やまのぼり	yamanobori
両足	りょうあし	ryouashi
申し立て	もうしたて	moushitate
分化	ぶんか	bunnka
仕入	しいれ	shiire
板金	いたがね|ばんきん	itagane|bannkinn
習い	ならい	narai
横目	よこめ	yokome
代物	しろもの|だいぶつ|だいもつ	shiromono|daibutsu|daimotsu
区長	くちょう	kuchou
君主	くんしゅ	kunnshu
開校	かいこう	kaikou
横丁	よこちょう	yokochou
文集	ぶんしゅう	bunnshuu
自重	じちょう|じじゅう	jichou|jijuu
茶葉	ちゃば	chaba
仕上げる	しあげる	shiageru
局所	きょくしょ	kyokusho
血行	けっこう	kekkou
起算	きさん	kisann
湯船	ゆぶね	yubune
時速	じそく	jisoku
終日	ひもすがら|しゅうじつ	himosugara|shuujitsu
海運	かいうん	kaiunn
重心	じゅうしん	juushinn
同感	どうかん	doukann
後味	あとあじ	atoaji
真心	まごころ	magokoro
旅先	たびさき	tabisaki
対局	たいきょく	taikyoku
持たせる	もたせる	motaseru
組曲	くみきょく	kumikyoku
引き取り	ひきとり	hikitori
宿場	しゅくば	shukuba
同和	どうわ	douwa
和子	わこ	wako
間取	まどり	madori
病室	びょうしつ	byoushitsu
聞き取り	ききとり	kikitori
感知	かんち	kannchi
ラー油	らーゆ	ra-yu
楽勝	らくしょう	rakushou
文面	ぶんめん	bunnmenn
勝者	しょうしゃ	shousha
他人事	ひとごと	hitogoto
申出	もうしで	moushide
父様	とうさま	tousama
軽やか	かるやか|かろやか	karuyaka|karoyaka
追っかけ	おっかけ	okkake
地主	じぬし	jinushi
毛皮	けがわ	kegawa
流体	りゅうたい	ryuutai
薬用	やくよう	yakuyou
申立	もうしたて	moushitate
五感	ごかん	gokann
美化	びか	bika
円安	えんやす	ennyasu
一服	いっぷく	ippuku
発育	はついく	hatsuiku
定住	ていじゅう	teijuu
当主	とうしゅ	toushu
全線	ぜんせん	zennsenn
電柱	でんちゅう	dennchuu
実り	みのり	minori
当期	とうき	touki
校庭	こうてい	koutei
界面	かいめん	kaimenn
祭神	さいじん	saijinn
国庫	こっこ	kokko
教習	きょうしゅう	kyoushuu
有明	ありあけ	ariake
来客	らいきゃく	raikyaku
次長	じちょう	jichou
自負	じふ	jifu
拾う	ひろう	hirou
物色	ぶっしょく	busshoku
着こなし	きこなし	kikonashi
本県	ほんけん	honnkenn
取消し	とりけし	torikeshi
白銀	しろがね|はくぎん	shirogane|hakuginn
有事	ゆうじ	yuuji
調書	ちょうしょ	chousho
取りあえず	とりあえず	toriaezu
明神	あきつかみ|みょうじん	akitsukami|myoujinn
歯ごたえ	はごたえ	hagotae
寒天	かんてん	kanntenn
打球	だきゅう	dakyuu
真意	しんい	shinni
通帳	つうちょう|かよいちょう	tsuuchou|kayoichou
予知	よち	yochi
対向	たいこう	taikou
重たい	おもたい	omotai
かけ流し	かけながし	kakenagashi
田畑	たはた|でんぱた	tahata|dennpata
本宮	ほんぐう	honnguu
着メロ	ちゃくめろ	chakumero
送り出し	おくりだし	okuridashi
仕業	しわざ|しぎょう	shiwaza|shigyou
放電	ほうでん	houdenn
お化け	おばけ	obake
転写	てんしゃ	tennsha
意地悪	いじわる	ijiwaru
勝る	まさる	masaru
同調	どうちょう	douchou
金物	かなもの	kanamono
切実	せつじつ	setsujitsu
決行	けっこう	kekkou
病人	びょうにん	byouninn
出向	しゅっこう	shukkou
上等	じょうとう	joutou
開場	かいじょう	kaijou
悪用	あくよう	akuyou
部数	ぶすう	busuu
有様	ありさま	arisama
取り直し	とりなおし	torinaoshi
見落とし	みおとし	miotoshi
鉄人	てつじん	tetsujinn
待ち遠しい	まちどおしい	machidooshii
洋室	ようしつ	youshitsu
根気	こんき	konnki
究明	きゅうめい	kyuumei
入部	にゅうぶ	nyuubu
横顔	よこがお	yokogao
文様	もんよう	monnyou
転向	てんこう	tennkou
切開	せっかい	sekkai
八重	やえ	yae
中等	ちゅうとう	chuutou
通商	つうしょう	tsuushou
苦味	くみ|にがみ	kumi|nigami
打開	だかい	dakai
発声	はっせい	hassei
生死	せいし|しょうし|しょうじ	seishi|shoushi|shouji
交配	こうはい	kouhai
持ち運び	もちはこび	mochihakobi
引き返し	ひきかえし	hikikaeshi
火薬	かやく	kayaku
和服	わふく	wafuku
係長	かかりちょう	kakarichou
出所	しゅっしょ|でどころ	shussho|dedokoro
全校	ぜんこう	zennkou
実話	じつわ	jitsuwa
身元	みもと	mimoto
予習	よしゅう	yoshuu
横手	よこて|よこで	yokote|yokode
手放し	てばなし	tebanashi
上乗せ	うわのせ	uwanose
終身	しゅうしん	shuushinn
会期	かいき	kaiki
歯車	はぐるま	haguruma
入館	にゅうかん	nyuukann
発色	はっしょく	hasshoku
下宿	げしゅく	geshuku
指南	しなん	shinann
取りまとめ	とりまとめ	torimatome
有線	ゆうせん	yuusenn
駅員	えきいん	ekiinn
開港	かいこう	kaikou
前列	ぜんれつ	zennretsu
地消	ちしょう	chishou
血流	けつりゅう	ketsuryuu
他所	たしょ|よそ	tasho|yoso
助け合い	たすけあい	tasukeai
葉書	はがき	hagaki
美学	びがく	bigaku
切れ味	きれあじ	kireaji
植える	うえる	ueru
小指	こゆび	koyubi
代打	だいだ	daida
化け物	ばけもの	bakemono
金運	きんうん	kinnunn
申す	もうす	mousu
有形	ゆうけい	yuukei
足取り	あしとり|あしどり	ashitori|ashidori
持ち味	もちあじ	mochiaji
病名	びょうめい	byoumei
黒板	こくばん	kokubann
長屋	ながや	nagaya
先取り	さきどり	sakidori
打てる	うてる	uteru
落し	おとし	otoshi
先送り	さきおくり	sakiokuri
和平	わへい	wahei
半身	はんしん|はんみ	hannshinn|hannmi
急落	きゅうらく	kyuuraku
親身	しんみ	shinnmi
花言葉	はなことば	hanakotoba
地表	ちひょう	chihyou
あの世	あのよ	anoyo
根っこ	ねっこ	nekko
病原	びょうげん	byougenn
葉月	はづき	haduki
酒店	さけてん|しゅてん	saketenn|shutenn
寒気	さむけ|かんき	samuke|kannki
主食	しゅしょく	shushoku
女流	じょりゅう	joryuu
生薬	しょうやく|きぐすり	shouyaku|kigusuri
美食	びしょく	bishoku
発病	はつびょう	hatsubyou
予期	よき	yoki
医大	いだい	idai
配る	くばる	kubaru
古着	ふるぎ	furugi
一路	いちろ	ichiro
部外	ぶがい	bugai
走者	そうしゃ	sousha
全曲	ぜんきょく	zennkyoku
かき氷	かきごおり	kakigoori
終電	しゅうでん	shuudenn
気品	きひん	kihinn
対する	たいする	taisuru
写り	うつり	utsuri
三世	みよ	miyo
大昔	おおむかし	oomukashi
同県	どうけん	doukenn
安物	やすもの	yasumono
負け犬	まけいぬ	makeinu
着ぐるみ	きぐるみ	kigurumi
木の実	きのみ|このみ	kinomi|konomi
本意	ほんい	honni
遊び心	あそびごころ	asobigokoro
遊び場	あそびば	asobiba
年始	ねんし	nennshi
秒間	びょうかん	byoukann
部族	ぶぞく	buzoku
白身	しろみ|はくしん	shiromi|hakushinn
転校	てんこう	tennkou
真下	ました	mashita
口実	こうじつ	koujitsu
取り返し	とりかえし	torikaeshi
歯肉	はにく	haniku
駅間	えきかん	ekikann
和やか	なごやか	nagoyaka
返り	かえり|がえり	kaeri|gaeri
船員	せんいん	senninn
波形	なみがた|はけい	namigata|hakei
気配り	きくばり	kikubari
前歯	まえば	maeba
相乗	そうじょう	soujou
耳鼻	じび	jibi
面子	めんこ|めんつ	mennko|menntsu
美形	びけい	bikei
見返し	みかえし	mikaeshi
女医	じょい	joi
室温	しつおん	shitsuonn
重合	じゅうごう	juugou
絵の具	えのぐ	enogu
題目	だいもく	daimoku
両社	りょうしゃ	ryousha
童子	どうじ	douji
区立	くりつ	kuritsu
転入	てんにゅう	tennnyuu
軽食	けいしょく	keishoku
植生	しょくせい	shokusei
運気	うんき	unnki
全土	ぜんど	zenndo
身動き	みうごき	miugoki
真中	まんなか	mannnaka
部局	ぶきょく	bukyoku
直筆	じきひつ|ちょくひつ	jikihitsu|chokuhitsu
本流	ほんりゅう	honnryuu
等身	とうしん	toushinn
温める	あたためる|ぬくめる|ぬるめる	atatameru|nukumeru|nurumeru
太平	たいへい	taihei
見返り	みかえり	mikaeri
平原	へいげん	heigenn
取り方	とりかた	torikata
出港	しゅっこう	shukkou
定理	ていり	teiri
消息	しょうそく	shousoku
山羊	やぎ	yagi
悪し	あし	ashi
港町	みなとまち	minatomachi
同定	どうてい	doutei
悪寒	おかん	okann
食い物	くいもの	kuimono
売主	うりぬし	urinushi
命題	めいだい	meidai
習う	ならう|なろう	narau|narou
助長	じょちょう	jochou
放し	はなし|ほかし|ぱなし	hanashi|hokashi|panashi
度数	どすう	dosuu
魚屋	さかなや	sakanaya
鼻血	はなじ	hanaji
行者	ぎょうじゃ	gyouja
他県	たけん	takenn
第一線	だいいっせん	daiissenn
深海	しんかい	shinnkai
同業	どうぎょう	dougyou
短所	たんしょ	tannsho
流水	りゅうすい	ryuusui
他店	たてん	tatenn
平年	へいねん	heinenn
箱入り	はこいり	hakoiri
見苦しい	みぐるしい	migurushii
鉄分	てつぶん	tetsubunn
色調	しきちょう	shikichou
球根	きゅうこん	kyuukonn
和み	なごみ	nagomi
入港	にゅうこう	nyuukou
次号	じごう	jigou
医科	いか	ika
県人	けんじん	kennjinn
勝ち点	かちてん	kachitenn
自決	じけつ	jiketsu
根強い	ねづよい	neduyoi
追い出し	おいだし	oidashi
図式	ずしき	zushiki
受かる	うかる	ukaru
祭礼	さいれい	sairei
長身	ちょうしん	choushinn
相反	そうはん	souhann
真弓	まゆみ	mayumi
湯気	ゆげ	yuge
花畑	はなばたけ	hanabatake
合言葉	あいことば	aikotoba
全日	ぜんじつ|ぜんにち	zennjitsu|zennnichi
細身	ほそみ	hosomi
子役	こやく	koyaku
真っ青	まっさお	massao
原酒	げんしゅ	gennshu
暑中	しょちゅう	shochuu
係り	かかわり|かかり|がかり	kakawari|kakari|gakari
有意	ゆうい	yuui
左岸	さがん	sagann
銀山	ぎんざん	ginnzann
通所	つうしょ	tsuusho
一代	いちだい	ichidai
神学	しんがく	shinngaku
一様	いちよう	ichiyou
駅近	えきちか	ekichika
家主	やぬし|いえぬし|いえあるじ	yanushi|ienushi|iearuji
深まる	ふかまる	fukamaru
和光	わこう	wakou
薬事	やくじ	yakuji
開局	かいきょく	kaikyoku
助っ人	すけっと	suketto
部室	ぶしつ	bushitsu
軽度	けいど	keido
立命	りつめい	ritsumei
配色	はいしょく	haishoku
木の葉	このは	konoha
決起	けっき	kekki
生き様	いきざま	ikizama
一昔	ひとむかし	hitomukashi
取手	とって|とりて	totte|torite
両日	りょうじつ	ryoujitsu
名神	めいしん	meishinn
数式	すうしき	suushiki
同乗	どうじょう	doujou
読取	よみとり	yomitori
配下	はいか	haika
死人	しにん|しびと	shininn|shibito
命日	めいにち	meinichi
書院	しょいん	shoinn
王宮	おうきゅう	oukyuu
右岸	うがん	ugann
対日	たいにち	tainichi
根ざし	ねざし	nezashi
安らか	やすらか	yasuraka
真上	まうえ	maue
申し分	もうしぶん	moushibunn
横行	おうこう	oukou
返上	へんじょう	hennjou
歯止め	はどめ	hadome
調合	ちょうごう	chougou
受入	うけいれ	ukeire
回遊	かいゆう	kaiyuu
開園	かいえん	kaienn
一等	いっとう	ittou
二世	にせ	nise
校区	こうく	kouku
宮内	くない	kunai
宿る	やどる	yadoru
負け組	まけぐみ	makegumi
大勝	たいしょう	taishou
送電	そうでん	soudenn
冬期	とうき	touki
上院	じょういん	jouinn
起立	きりつ	kiritsu
全う	まっとう	mattou
前号	ぜんごう	zenngou
新調	しんちょう	shinnchou
同化	どうか	douka
運休	うんきゅう	unnkyuu
売り物	うりもの	urimono
悪者	わるもの	warumono
動ける	うごける	ugokeru
県北	けんほく	kennhoku
実地	じっち	jicchi
歌集	かしゅう	kashuu
仕える	つかえる	tsukaeru
気取り	きどり|けどり	kidori|kedori
品等	ひんとう	hinntou
天板	てんばん|てんいた	tennbann|tennita
持分	もちぶん	mochibunn
外注	がいちゅう	gaichuu
画集	がしゅう	gashuu
勝目	かちめ	kachime
安売り	やすうり	yasuuri
漢文	かんぶん	kannbunn
薬味	やくみ	yakumi
投げかけ	なげかけ	nagekake
乗組	のりくみ	norikumi
流氷	りゅうひょう	ryuuhyou
神起	しんき	shinnki
風化	ふうか	fuuka
血中	けっちゅう	kecchuu
送れる	おくれる	okureru
薬学	やくがく	yakugaku
身勝手	みがって	migatte
住戸	じゅうこ	juuko
悪事	あくじ	akuji
内湯	うちゆ	uchiyu
反感	はんかん	hannkann
宮中	きゅうちゅう	kyuuchuu
味見	あじみ	ajimi
発毛	はつもう	hatsumou
水遊び	みずあそび	mizuasobi
三十路	みそじ	misoji
整数	せいすう	seisuu
直球	ちょっきゅう	chokkyuu
高所	こうしょ	kousho
研ぎ	とぎ	togi
受動	じゅどう	judou
名勝	めいしょう	meishou
祭日	さいじつ	saijitsu
表向き	おもてむき	omotemuki
米屋	こめや	komeya
見開き	みひらき	mihiraki
転がし	ころがし|まろがし	korogashi|marogashi
二期	にき	niki
全社	ぜんしゃ	zennsha
打点	だてん	datenn
金銀	きんぎん	kinnginn
仕立	したて|じたて	shitate|jitate
院生	いんせい	innsei
開山	かいさん|かいざん	kaisann|kaizann
下院	かいん	kainn
炭化	たんか	tannka
神主	かんぬし	kannnushi
農道	のうどう	noudou
子持ち	こもち	komochi
手取り	てとり|てどり	tetori|tedori
乗り心地	のりごこち	norigokochi
来期	らいき	raiki
氷室	ひむろ|ひょうしつ	himuro|hyoushitsu
品番	しなばん|ひんばん	shinabann|hinnbann
万事	ばんじ	bannji
神明	しんめい	shinnmei
学業	がくぎょう	gakugyou
受け皿	うけざら	ukezara
天守	てんしゅ	tennshu
ひな祭り	ひなまつり	hinamatsuri
客船	きゃくせん	kyakusenn
強者	きょうしゃ	kyousha
他界	たかい	takai
八百屋	やおや	yaoya
まな板	まないた	manaita
球体	きゅうたい	kyuutai
神代	かみよ|じんだい	kamiyo|jinndai
秋祭り	あきまつり	akimatsuri
皮切り	かわきり	kawakiri
客車	きゃくしゃ	kyakusha
追い風	おいかぜ	oikaze
化物	ばけもの	bakemono
野宿	のじゅく	nojuku
後進	こうしん	koushinn
中指	なかゆび	nakayubi
想起	そうき	souki
風速	ふうそく	fuusoku
和名	わめい|わみょう	wamei|wamyou
平屋	ひらや	hiraya
書庫	しょこ	shoko
国定	こくてい	kokutei
放水	ほうすい	housui
起し	おこし	okoshi
一丁	いっちょう	icchou
年式	ねんしき	nennshiki
東宮	とうぐう	touguu
鉄橋	てっきょう	tekkyou
安楽	あんらく	annraku
仕事人	しごとにん	shigotoninn
対空	たいくう	taikuu
湯本	ゆもと	yumoto
引取	ひきとり	hikitori
生身	なまみ	namami
相生	あいおい|そうしょう	aioi|soushou
使い物	つかいもの	tsukaimono
名湯	めいとう	meitou
転がり	ころがり	korogari
集金	しゅうきん	shuukinn
風流	ふうりゅう	fuuryuu
写る	うつる	utsuru
中長期	ちゅうちょうき	chuuchouki
陽光	ようこう	youkou
ぬるま湯	ぬるまゆ	nurumayu
注力	ちゅうりょく	chuuryoku
上向き	うわむき	uwamuki
命がけ	いのちがけ	inochigake
羽化	うか	uka
自習	じしゅう	jishuu
中流	ちゅうりゅう	chuuryuu
手品	てじな	tejina
身代わり	みがわり	migawari
一期	いちご	ichigo
下取り	したどり	shitadori
洋館	ようかん	youkann
下り坂	くだりざか	kudarizaka
合板	ごうはん|ごうばん	gouhann|goubann
発火	はっか	hakka
係わる	かかわる	kakawaru
後発	こうはつ	kouhatsu
中和	ちゅうわ	chuuwa
新館	しんかん	shinnkann
人命	じんめい	jinnmei
酒飲み	さけのみ	sakenomi
真言	しんごん	shinngonn
流れ星	ながれぼし	nagareboshi
一世	いっせ|いっせい	isse|issei
高次	こうじ	kouji
小部屋	こべや	kobeya
所用	しょよう	shoyou
指さし	ゆびさし	yubisashi
商号	しょうごう	shougou
宿屋	やどや	yadoya
取水	しゅすい	shusui
新薬	しんやく	shinnyaku
着ける	つける|づける	tsukeru|dukeru
草の根	くさのね	kusanone
意気	いき|いく	iki|iku
心待ち	こころまち	kokoromachi
後ろ向き	うしろむき	ushiromuki
取り調べ	とりしらべ	torishirabe
定形	ていけい	teikei
調度	ちょうど	choudo
転出	てんしゅつ	tennshutsu
油絵	あぶらえ	aburae
次代	じだい	jidai
美男	びなん	binann
急坂	きゅうざか|きゅうはん	kyuuzaka|kyuuhann
住まいづくり	すまいづくり	sumaidukuri
歯石	しせき	shiseki
主語	しゅご	shugo
旅立つ	たびだつ	tabidatsu
着心地	きごこち	kigokochi
終い	しまい|じまい	shimai|jimai
等分	とうぶん	toubunn
道州	どうしゅう	doushuu
手相	てそう	tesou
公庫	こうこ	kouko
九重	ここのえ	kokonoe
家業	かぎょう	kagyou
漢詩	かんし|からうた	kannshi|karauta
大流行	おおはやり|だいりゅうこう	oohayari|dairyuukou
多面	ためん	tamenn
万物	ばんぶつ|よろずもの	bannbutsu|yorozumono
整い	ととのい	totonoi
生業	せいぎょう|なりわい	seigyou|nariwai
前駅	ぜんえき	zenneki
美ら	ちゅら	chura
島内	とうない	tounai
水流	すいりゅう	suiryuu
気球	ききゅう	kikyuu
取り合い	とりあい	toriai
歌曲	かきょく	kakyoku
新都	しんと	shinnto
有人	ゆうじん	yuujinn
軽油	けいゆ	keiyu
名品	めいひん	meihinn
肉屋	にくや	nikuya
真っ向	まっこう	makkou
取っ手	とって	totte
屋号	やごう	yagou
回送	かいそう	kaisou
乗員	じょういん	jouinn
町屋	まちや	machiya
時短	じたん	jitann
受入れ	うけいれ	ukeire
死語	しご	shigo
代引	だいびき	daibiki
駅ビル	えきびる	ekibiru
和音	わおん	waonn
歯列	しれつ	shiretsu
農水	のうすい	nousui
美顔	びがん	bigann
息切れ	いきぎれ	ikigire
取り引き	とりひき	torihiki
取り立て	とりたて	toritate
下級	かきゅう	kakyuu
投薬	とうやく	touyaku
終る	おわる	owaru
持病	じびょう	jibyou
上面	うわつら|じょうめん	uwatsura|joumenn
直流	ちょくりゅう	chokuryuu
気流	きりゅう	kiryuu
手の平	てのひら	tenohira
物言い	ものいい	monoii
勝ち負け	かちまけ	kachimake
何物	なにもの	nanimono
深まり	ふかまり	fukamari
同族	どうぞく	douzoku
悲しむ	かなしむ	kanashimu
表皮	ひょうひ	hyouhi
飲用	いんよう	innyou
急登	きゅうとう	kyuutou
庭木	にわき	niwaki
取り合えず	とりあえず	toriaezu
転がる	ころがる	korogaru
羊毛	ようもう	youmou
次ぎ	つぎ	tsugi
名医	めいい	meii
湯葉	ゆば	yuba
大曲	たいきょく	taikyoku
名取	なとり	natori
朝礼	ちょうれい	chourei
世相	せそう	sesou
山岸	やまぎし	yamagishi
大乗	だいじょう	daijou
員数	いんずう	innzuu
予後	よご	yogo
写す	うつす	utsusu
死角	しかく	shikaku
一期一会	いちごいちえ	ichigoichie
安っぽい	やすっぽい	yasuppoi
対米	たいべい	taibei
反落	はんらく	hannraku
深度	しんど	shinndo
病死	びょうし	byoushi
湖面	こめん	komenn
上皮	うわかわ|じょうひ	uwakawa|jouhi
転身	てんしん	tennshinn
品名	ひんめい	hinnmei
子息	しそく	shisoku
命ずる	めいずる	meizuru
竹炭	ちくたん	chikutann
一役	ひとやく	hitoyaku
一助	いちじょ	ichijo
急所	きゅうしょ	kyuusho
配役	はいやく	haiyaku
入湯	にゅうとう	nyuutou
赤面	せきめん|あかづら	sekimenn|akadura
始業	しぎょう	shigyou
駅長	えきちょう	ekichou
荷台	にだい	nidai
食味	しょくみ	shokumi
面目	めんぼく|めんもく	mennboku|mennmoku
物語る	ものがたる	monogataru
寒波	かんぱ	kannpa
注記	ちゅうき	chuuki
守れる	まもれる	mamoreru
油田	ゆでん	yudenn
君子	くんし	kunnshi
色使い	いろづかい	irodukai
商い	あきない	akinai
知育	ちいく	chiiku
旅路	たびじ	tabiji
今昔	こんじゃく	konnjaku
深山	しんざん|みやま	shinnzann|miyama
化す	かす	kasu
助役	じょやく	joyaku
神子	みこ	miko
流木	りゅうぼく	ryuuboku
身軽	みがる	migaru
返る	かえる	kaeru
ひと味	ひとあじ	hitoaji
整列	せいれつ	seiretsu
和む	なごむ	nagomu
湖北	こほく	kohoku
五味	ごみ	gomi
手放す	てばなす	tebanasu
落花生	らっかせい	rakkasei
古式	こしき	koshiki
分業	ぶんぎょう	bunngyou
向き合い	むきあい	mukiai
全勝	ぜんしょう	zennshou
工期	こうき	kouki
両目	りょうめ	ryoume
小橋	こばし	kobashi
定点	ていてん	teitenn
真横	まよこ	mayoko
化身	けしん	keshinn
度重なる	たびかさなる	tabikasanaru
岩屋	いわや	iwaya
反米	はんべい	hannbei
苦言	くげん	kugenn
新酒	しんしゅ	shinnshu
配水	はいすい	haisui
開国	かいこく	kaikoku
王族	おうぞく	ouzoku
赤身	あかみ	akami
薬指	くすりゆび	kusuriyubi
月面	げつめん	getsumenn
落着	らくちゃく|らくじゃく	rakuchaku|rakujaku
大洋	たいよう	taiyou
引受	ひきうけ	hikiuke
全話	ぜんわ	zennwa
死ねる	しねる	shineru
真木	まき	maki
商船	しょうせん	shousenn
屋形船	やかたぶね	yakatabune
主君	しゅくん	shukunn
引き落とし	ひきおとし	hikiotoshi
電荷	でんか	dennka
神前	しんぜん	shinnzenn
遊女	ゆうじょ	yuujo
語り部	かたりべ	kataribe
形相	ぎょうそう|けいそう	gyousou|keisou
自他	じた	jita
速読	そくどく	sokudoku
号外	ごうがい	gougai
年号	ねんごう	nenngou
音速	おんそく	onnsoku
明暗	めいあん	meiann
反り	そり|ぞり	sori|zori
波乗り	なみのり	naminori
使い手	つかいて	tsukaite
重き	おもき	omoki
外界	がいかい	gaikai
身上	しんしょう|しんじょう	shinnshou|shinnjou
三流	さんりゅう	sannryuu
お日様	おひさま	ohisama
入庫	にゅうこ	nyuuko
県内外	けんないがい	kennnaigai
日進	にっしん	nisshinn
命じる	めいじる	meijiru
強打	きょうだ	kyouda
仕打ち	しうち	shiuchi
油分	ゆぶん	yubunn
倍速	ばいそく	baisoku
通期	つうき	tsuuki
物音	ものおと	monooto
仕上	しあげ	shiage
湯元	ゆもと	yumoto
先客	せんきゃく	sennkyaku
下界	かかい|げかい	kakai|gekai
悪行	あっこう|あくぎょう	akkou|akugyou
くり返し	くりかえし	kurikaeshi
神体	しんたい	shinntai
切り返し	きりかえし	kirikaeshi
安上がり	やすあがり	yasuagari
見向き	みむき	mimuki
原曲	げんきょく	gennkyoku
主事	しゅじ	shuji
取り決め	とりきめ	torikime
次週	じしゅう	jishuu
小品	しょうひん	shouhinn
短パン	たんぱん	tannpann
庭先	にわさき	niwasaki
教区	きょうく	kyouku
手指	しゅし	shushi
死す	しす	shisu
球界	きゅうかい	kyuukai
横ばい	よこばい	yokobai
重荷	おもに	omoni
上り坂	のぼりざか	noborizaka
入植	にゅうしょく	nyuushoku
進級	しんきゅう	shinnkyuu
同列	どうれつ	douretsu
同表	どうひょう	douhyou
客員	かくいん|きゃくいん	kakuinn|kyakuinn
家路	いえじ	ieji
長調	ちょうちょう	chouchou
品数	しなかず	shinakazu
草取り	くさとり	kusatori
豆まき	まめまき	mamemaki
定植	ていしょく	teishoku
勉学	べんがく	benngaku
追究	ついきゅう	tsuikyuu
事物	じぶつ	jibutsu
色味	いろみ	iromi
相反する	あいはんする	aihannsuru
陽だまり	ひだまり	hidamari
安で	やすで	yasude
用命	ようめい	youmei
真っ当	まっとう	mattou
同院	どういん	douinn
親和	しんわ	shinnwa
代り	かわり|がわり	kawari|gawari
西岸	せいがん	seigann
子安	こやす	koyasu
黄身	きみ	kimi
茶の湯	ちゃのゆ	chanoyu
氷上	ひょうじょう	hyoujou
曲げる	まげる	mageru
使い心地	つかいごこち	tsukaigokochi
聞き流し	ききながし	kikinagashi
内服	ないふく	naifuku
引取り	ひきとり	hikitori
神木	しんぼく	shinnboku
動かせる	うごかせる	ugokaseru
仕返し	しかえし	shikaeshi
軽トラ	けいとら	keitora
面持ち	おももち	omomochi
一筆	いっぴつ|ひとふで	ippitsu|hitofude
自筆	じひつ	jihitsu
真人	しんじん|まひと	shinnjinn|mahito
急死	きゅうし	kyuushi
むし歯	むしば	mushiba
飲茶	やむちゃ|いんさ	yamucha|innsa
洋式	ようしき	youshiki
局員	きょくいん	kyokuinn
馬主	ばしゅ	bashu
安住	あんじゅう	annjuu
服薬	ふくやく	fukuyaku
詩歌	しいか|しか	shiika|shika
送球	そうきゅう	soukyuu
横たわる	よこたわる	yokotawaru
練る	ねる	neru
味気	あじき|あじけ	ajiki|ajike
写本	しゃほん	shahonn
代役	だいやく	daiyaku
終業	しゅうぎょう	shuugyou
全店	ぜんてん	zenntenn
母屋	おもや|もや	omoya|moya
仕入れる	しいれる	shiireru
深部	しんぶ	shinnbu
温まる	あたたまる|ぬくまる	atatamaru|nukumaru
全館	ぜんかん	zennkann
開帳	かいちょう|がいちょう	kaichou|gaichou
曲集	きょくしゅう	kyokushuu
雨具	あまぐ	amagu
川遊び	かわあそび	kawaasobi
短調	たんちょう	tannchou
八丁	はっちょう	hacchou
重箱	じゅうばこ	juubako
両院	りょういん	ryouinn
落石	らくせき	rakuseki
感服	かんぷく	kannpuku
口笛	くちぶえ	kuchibue
進言	しんげん	shinngenn
物心	ぶっしん|ものごころ	busshinn|monogokoro
流血	りゅうけつ	ryuuketsu
追い上げ	おいあげ	oiage
木箱	きばこ	kibako
大葉	おおば	ooba
重体	じゅうたい	juutai
登れる	のぼれる	noboreru
パチ屋	ぱちや	pachiya
習字	しゅうじ	shuuji
乗合	のりあい	noriai
川岸	かわぎし	kawagishi
両岸	りょうがん	ryougann
重ね合わせ	かさねあわせ	kasaneawase
宿主	しゅくしゅ|やどぬし	shukushu|yadonushi
酒気	さかけ|しゅき	sakake|shuki
宮地	みやどころの	miyadokorono
自助	じじょ	jijo
植毛	しょくもう	shokumou
島国	しまぐに	shimaguni
持ち前	もちまえ	mochimae
っ放し	っぱなし	ppanashi
決死	けっし	kesshi
持ち手	もちて	mochite
小皿	こざら	kozara
外面	がいめん|げめん|そとづら	gaimenn|gemenn|sotodura
横向き	よこむき	yokomuki
白根	しらね	shirane
天界	てんかい|てんがい	tennkai|tenngai
勝間	かつま	katsuma
真顔	まがお	magao
部内	ぶない	bunai
曲調	きょくちょう	kyokuchou
切り取り	きりとり	kiritori
名指し	なざし	nazashi
乗っ取り	のっとり	nottori
住める	すめる	sumeru
取調べ	とりしらべ	torishirabe
所作	しょさ	shosa
新進	しんしん	shinnshinn
年祭	ねんさい	nennsai
他校	たこう	takou
病弱	びょうじゃく	byoujaku
取り下げ	とりさげ	torisage
重油	じゅうゆ	juuyu
所内	しょない	shonai
落ちこぼれ	おちこぼれ	ochikobore
山神	さんしん|さんじん	sannshinn|sannjinn
列強	れっきょう	rekkyou
同号	どうごう	dougou
切り身	きりみ	kirimi
手仕事	てしごと	teshigoto
風向き	かざむき|かぜむき	kazamuki|kazemuki
向日	こうじつ	koujitsu
横切る	よこぎる	yokogiru
局地	きょくち	kyokuchi
丸投げ	まるなげ	marunage
持ち直し	もちなおし	mochinaoshi
仕上がる	しあがる	shiagaru
全道	ぜんどう	zenndou
追分	おいわけ	oiwake
苦心	くしん	kushinn
平方	へいほう	heihou
転ぶ	ころぶ	korobu
光速	こうそく	kousoku
流行る	はやる	hayaru
悪気	わるぎ	warugi
乗用	じょうよう	jouyou
鉄工	てっこう	tekkou
全会	ぜんかい	zennkai
石坂	いしざか	ishizaka
医局	いきょく	ikyoku
手打	てうち	teuchi
地平	ちへい	chihei
音階	おんかい	onnkai
帰着	きちゃく	kichaku
頭取	とうどり	toudori
急きょ	きゅうきょ	kyuukyo
土着	どちゃく	dochaku
面する	めんする	mennsuru
委員会	いいんかい	iinnkai
何度	なんど	nanndo
主人公	しゅじんこう	shujinnkou
図書館	としょかん	toshokann
研究所	けんきゅうしょ|けんきゅうじょ	kennkyuusho|kennkyuujo
商取引	しょうとりひき	shoutorihiki
事業者	じぎょうしゃ	jigyousha
委員長	いいんちょう	iinnchou
面白	おもしろ	omoshiro
研究会	けんきゅうかい	kennkyuukai
飲食店	いんしょくてん	innshokutenn
世界中	せかいじゅう	sekaijuu
歯医者	はいしゃ	haisha
大学院	だいがくいん	daigakuinn
研究者	けんきゅうしゃ	kennkyuusha
市役所	しやくしょ	shiyakusho
事業所	じぎょうしょ	jigyousho
日本酒	にほんしゅ	nihonnshu
期間中	きかんちゅう	kikannchuu
旅行記	りょこうき	ryokouki
問題点	もんだいてん	monndaitenn
写真集	しゃしんしゅう	shashinnshuu
正社員	せいしゃいん	seishainn
理事長	りじちょう	rijichou
医薬品	いやくひん	iyakuhinn
研究室	けんきゅうしつ	kennkyuushitsu
発売日	はつばいび	hatsubaibi
代理店	だいりてん	dairitenn
有名人	ゆうめいじん	yuumeijinn
運転手	うんてんしゅ	unntennshu
動物園	どうぶつえん	doubutsuenn
今年度	こんねんど	konnnenndo
体育館	たいいくかん	taiikukann
当事者	とうじしゃ	toujisha
太陽光	たいようこう	taiyoukou
全日本	ぜんにっぽん|ぜんにほん	zennnipponn|zennnihonn
発表会	はっぴょうかい	happyoukai
次世代	じせだい	jisedai
同級生	どうきゅうせい	doukyuusei
勉強会	べんきょうかい	bennkyoukai
暗号化	あんごうか	anngouka
運動会	うんどうかい	unndoukai
王様	おうさま	ousama
新商品	しんしょうひん	shinnshouhinn
文字列	もじれつ	mojiretsu
所有者	しょゆうしゃ	shoyuusha
定休日	ていきゅうび	teikyuubi
短時間	たんじかん	tannjikann
代表者	だいひょうしゃ	daihyousha
美少女	びしょうじょ	bishoujo
組合員	くみあいいん	kumiaiinn
医学部	いがくぶ	igakubu
理事会	りじかい	rijikai
水族館	すいぞくかん	suizokukann
予定日	よていび	yoteibi
化合物	かごうぶつ	kagoubutsu
用語集	ようごしゅう	yougoshuu
日用品	にちようひん	nichiyouhinn
事実上	じじつじょう	jijitsujou
交流会	こうりゅうかい	kouryuukai
発電所	はつでんしょ	hatsudennsho
主題歌	しゅだいか	shudaika
登山口	とざんぐち	tozannguchi
下半身	かはんしん	kahannshinn
家庭用	かていよう	kateiyou
大部分	だいぶぶん	daibubunn
代理人	だいりにん	dairininn
電話帳	でんわちょう	dennwachou
短期間	たんきかん	tannkikann
取引所	とりひきしょ|とりひきじょ	torihikisho|torihikijo
会社員	かいしゃいん	kaishainn
回答者	かいとうしゃ	kaitousha
相談所	そうだんしょ|そうだんじょ	soudannsho|soudannjo
工作員	こうさくいん	kousakuinn
先進国	せんしんこく	sennshinnkoku
県知事	けんちじ	kennchiji
知名度	ちめいど	chimeido
来年度	らいねんど	rainenndo
一時期	いちじき	ichijiki
放送局	ほうそうきょく	housoukyoku
集中力	しゅうちゅうりょく	shuuchuuryoku
取引先	とりひきさき	torihikisaki
文化祭	ぶんかさい	bunnkasai
研究科	けんきゅうか	kennkyuuka
発売中	はつばいちゅう	hatsubaichuu
野球部	やきゅうぶ	yakyuubu
注意点	ちゅういてん	chuuitenn
科学者	かがくしゃ	kagakusha
使用者	しようしゃ	shiyousha
写真館	しゃしんかん	shashinnkann
公開中	こうかいちゅう	koukaichuu
作曲家	さっきょくか	sakkyokuka
遊歩道	ゆうほどう	yuuhodou
漢方薬	かんぽうやく	kannpouyaku
四半期	しはんき	shihannki
長期間	ちょうきかん	choukikann
少子化	しょうしか	shoushika
遊園地	ゆうえんち	yuuennchi
大使館	たいしかん	taishikann
乗用車	じょうようしゃ	jouyousha
一級	いっきゅう	ikkyuu
開発者	かいはつしゃ	kaihatsusha
予想外	よそうがい	yosougai
研究員	けんきゅういん	kennkyuuinn
大都市	だいとし	daitoshi
生放送	なまほうそう	namahousou
意見書	いけんしょ	ikennsho
古本屋	ふるほんや	furuhonnya
本年度	ほんねんど	honnnenndo
写真家	しゃしんか	shashinnka
上半身	じょうはんしん	jouhannshinn
歩行者	ほこうしゃ	hokousha
出身者	しゅっしんしゃ	shusshinnsha
軽自動車	けいじどうしゃ	keijidousha
多様化	たようか	tayouka
前年度	ぜんねんど	zennnenndo
安心感	あんしんかん	annshinnkann
出身地	しゅっしんち	shusshinnchi
事業主	じぎょうぬし	jigyounushi
仕事中	しごとちゅう	shigotochuu
中央線	ちゅうおうせん	chuuousenn
実用化	じつようか	jitsuyouka
真夜中	まよなか	mayonaka
近代化	きんだいか	kinndaika
教習所	きょうしゅうじょ	kyoushuujo
区役所	くやくしょ	kuyakusho
生物学	せいぶつがく	seibutsugaku
旅行者	りょこうしゃ	ryokousha
起業家	きぎょうか	kigyouka
工事中	こうじちゅう	koujichuu
入学式	にゅうがくしき	nyuugakushiki
問題集	もんだいしゅう	monndaishuu
商品化	しょうひんか	shouhinnka
代表作	だいひょうさく	daihyousaku
正当化	せいとうか	seitouka
植物園	しょくぶつえん	shokubutsuenn
思春期	ししゅんき	shishunnki
作品集	さくひんしゅう	sakuhinnshuu
活動中	かつどうちゅう	katsudouchuu
大集合	だいしゅうごう	daishuugou
海岸線	かいがんせん	kaigannsenn
一体化	いったいか	ittaika
相手方	あいてがた	aitegata
期間内	きかんない	kikannnai
部活動	ぶかつどう	bukatsudou
小売業	こうりぎょう	kourigyou
様子見	ようすみ	yousumi
来場者	らいじょうしゃ	raijousha
本部長	ほんぶちょう	honnbuchou
地上波	ちじょうは	chijouha
開会式	かいかいしき	kaikaishiki
都市部	としぶ	toshibu
自動化	じどうか	jidouka
生活者	せいかつしゃ	seikatsusha
上級者	じょうきゅうしゃ	joukyuusha
物理学	ぶつりがく	butsurigaku
自由度	じゆうど	jiyuudo
新発売	しんはつばい	shinnhatsubai
工学部	こうがくぶ	kougakubu
練習場	れんしゅうじょう	rennshuujou
合理化	ごうりか	gourika
進行中	しんこうちゅう	shinnkouchuu
開放感	かいほうかん	kaihoukann
待合室	まちあいしつ	machiaishitsu
生意気	なまいき	namaiki
研究家	けんきゅうか	kennkyuuka
人気者	にんきもの	ninnkimono
山小屋	やまごや	yamagoya
生命力	せいめいりょく	seimeiryoku
手作業	てさぎょう	tesagyou
登山者	とざんしゃ	tozannsha
作業員	さぎょういん	sagyouinn
風物詩	ふうぶつし	fuubutsushi
放送中	ほうそうちゅう	housouchuu
正反対	せいはんたい	seihanntai
教育長	きょういくちょう	kyouikuchou
部屋数	へやかず	heyakazu
感想文	かんそうぶん	kannsoubunn
農作物	のうさくもつ	nousakumotsu
町役場	まちやくば	machiyakuba
安定感	あんていかん	annteikann
安定所	あんていしょ	annteisho
新年度	しんねんど	shinnnenndo
古事記	こじき	kojiki
科学館	かがくかん	kagakukann
中古品	ちゅうこひん	chuukohinn
作業中	さぎょうちゅう	sagyouchuu
農作業	のうさぎょう	nousagyou
小動物	しょうどうぶつ	shoudoubutsu
万葉集	まんようしゅう	mannyoushuu
行動力	こうどうりょく	koudouryoku
開発中	かいはつちゅう	kaihatsuchuu
歯科医	しかい	shikai
原動力	げんどうりょく	genndouryoku
学園祭	がくえんさい	gakuennsai
原作者	げんさくしゃ	gennsakusha
元首相	もとしゅしょう	motoshushou
文学部	ぶんがくぶ	bunngakubu
都知事	とちじ	tochiji
音楽祭	おんがくさい	onngakusai
安定化	あんていか	annteika
内定者	ないていしゃ	naiteisha
電気代	でんきだい	dennkidai
三者	さんしゃ	sannsha
具体化	ぐたいか	gutaika
出発点	しゅっぱつてん	shuppatsutenn
自由化	じゆうか	jiyuuka
家庭内	かていない	kateinai
開始日	かいしび	kaishibi
文庫本	ぶんこぼん	bunnkobonn
一部分	いちぶぶん	ichibubunn
真正面	ましょうめん|まっしょうめん	mashoumenn|masshoumenn
作業所	さぎょうしょ	sagyousho
鉄道駅	てつどうえき	tetsudoueki
炭水化物	たんすいかぶつ	tannsuikabutsu
七福神	しちふくじん	shichifukujinn
白血病	はっけつびょう	hakketsubyou
野球場	やきゅうじょう	yakyuujou
注目度	ちゅうもくど	chuumokudo
高度化	こうどか	koudoka
相談員	そうだんいん	soudanninn
顔写真	かおしゃしん	kaoshashinn
新登場	しんとうじょう	shinntoujou
小道具	こどうぐ	kodougu
食事会	しょくじかい	shokujikai
生命体	せいめいたい	seimeitai
耳鼻科	じびか	jibika
出発日	しゅっぱつび	shuppatsubi
外科医	げかい	gekai
次回作	じかいさく	jikaisaku
後頭部	こうとうぶ	koutoubu
運動場	うんどうじょう	unndoujou
親近感	しんきんかん	shinnkinnkann
落語家	らくごか	rakugoka
体育祭	たいいくさい	taiikusai
活動家	かつどうか	katsudouka
地球人	ちきゅうじん	chikyuujinn
上半期	かみはんき	kamihannki
体育会	たいいくかい	taiikukai
大公開	だいこうかい	daikoukai
学習者	がくしゅうしゃ	gakushuusha
心意気	こころいき	kokoroiki
活発化	かっぱつか	kappatsuka
等身大	とうしんだい	toushinndai
使用人	しようにん	shiyouninn
交通局	こうつうきょく	koutsuukyoku
相談者	そうだんしゃ	soudannsha
定食屋	ていしょくや	teishokuya
運転者	うんてんしゃ	unntennsha
日記帳	にっきちょう	nikkichou
万年筆	まんねんひつ	mannnennhitsu
同年代	どうねんだい	dounenndai
高速化	こうそくか	kousokuka
予定者	よていしゃ	yoteisha
乗組員	のりくみいん	norikumiinn
作品名	さくひんめい	sakuhinnmei
角部屋	かどべや	kadobeya
運転中	うんてんちゅう	unntennchuu
決算書	けっさんしょ	kessannsho
発送日	はっそうび	hassoubi
新世界	しんせかい	shinnsekai
同業者	どうぎょうしゃ	dougyousha
絵葉書	えはがき	ehagaki
農業者	のうぎょうしゃ	nougyousha
配送先	はいそうさき	haisousaki
茶道具	ちゃどうぐ	chadougu
進学校	しんがくこう	shinngakukou
練習中	れんしゅうちゅう	rennshuuchuu
弱体化	じゃくたいか	jakutaika
多方面	たほうめん	tahoumenn
正会員	せいかいいん	seikaiinn
仕様書	しようしょ	shiyousho
注文日	ちゅうもんび	chuumonnbi
電子化	でんしか	dennshika
歩道橋	ほどうきょう	hodoukyou
高感度	こうかんど	koukanndo
開業医	かいぎょうい	kaigyoui
発行者	はっこうしゃ	hakkousha
休館日	きゅうかんび	kyuukannbi
役員会	やくいんかい	yakuinnkai
間取図	まどりず	madorizu
水平線	すいへいせん	suiheisenn
西海岸	にしかいがん	nishikaigann
美少年	びしょうねん	bishounenn
配当金	はいとうきん	haitoukinn
工作物	こうさくぶつ	kousakubutsu
事業化	じぎょうか	jigyouka
一本化	いっぽんか	ipponnka
福音書	ふくいんしょ	fukuinnsho
期待感	きたいかん	kitaikann
実業家	じつぎょうか	jitsugyouka
見放題	みほうだい	mihoudai
世話人	せわにん	sewaninn
目薬	めぐすり	megusuri
北西部	ほくせいぶ	hokuseibu
前夜祭	ぜんやさい	zennyasai
向上心	こうじょうしん	koujoushinn
手荷物	てにもつ	tenimotsu
高級車	こうきゅうしゃ	koukyuusha
温度計	おんどけい	onndokei
事業場	じぎょうじょう	jigyoujou
教育者	きょういくしゃ	kyouikusha
実力者	じつりょくしゃ	jitsuryokusha
地平線	ちへいせん	chiheisenn
想定外	そうていがい	souteigai
白血球	はっけっきゅう	hakkekkyuu
予定表	よていひょう	yoteihyou
一元化	いちげんか	ichigennka
理学部	りがくぶ	rigakubu
入場者	にゅうじょうしゃ	nyuujousha
集合体	しゅうごうたい	shuugoutai
練習会	れんしゅうかい	rennshuukai
新世代	しんせだい	shinnsedai
用水路	ようすいろ	yousuiro
人一倍	ひといちばい	hitoichibai
流行語	りゅうこうご	ryuukougo
思想家	しそうか	shisouka
南西部	なんせいぶ	nannseibu
家庭科	かていか	kateika
文学者	ぶんがくしゃ	bunngakusha
赤血球	せっけっきゅう	sekkekkyuu
行進曲	こうしんきょく	koushinnkyoku
大都会	だいとかい	daitokai
作業場	さぎょうば	sagyouba
入学者	にゅうがくしゃ	nyuugakusha
血小板	けっしょうばん	kesshoubann
作曲者	さっきょくしゃ	sakkyokusha
表面化	ひょうめんか	hyoumennka
転校生	てんこうせい	tennkousei
定年後	ていねんご	teinenngo
細分化	さいぶんか	saibunnka
北東部	ほくとうぶ	hokutoubu
学会員	がっかいいん	gakkaiinn
十字路	じゅうじろ	juujiro
都心部	としんぶ	toshinnbu
次年度	じねんど	jinenndo
実生活	じっせいかつ	jisseikatsu
寺子屋	てらこや	terakoya
文学館	ぶんがくかん	bunngakukann
宿場町	しゅくばまち	shukubamachi
年度内	ねんどない	nenndonai
集客力	しゅうきゃくりょく	shuukyakuryoku
地理院	ちりいん	chiriinn
氷点下	ひょうてんか	hyoutennka
談話室	だんわしつ	dannwashitsu
計算式	けいさんしき	keisannshiki
定形外	ていけいがい	teikeigai
数学者	すうがくしゃ	suugakusha
同行者	どうこうしゃ	doukousha
農学部	のうがくぶ	nougakubu
発起人	ほっきにん	hokkininn
玉手箱	たまてばこ	tamatebako
使命感	しめいかん	shimeikann
進行形	しんこうけい	shinnkoukei
全国区	ぜんこくく	zennkokuku
病原体	びょうげんたい	byougenntai
洋食屋	ようしょくや	youshokuya
全自動	ぜんじどう	zennjidou