場合	ばあい	baai
必要	ひつよう	hitsuyou
利用	りよう	riyou
自分	じぶん	jibunn
記事	きじ	kiji
商品	しょうひん	shouhinn
使用	しよう	shiyou
登録	とうろく	touroku
最近	さいきん	saikinn
今日	きょう|こんにち	kyou|konnnichi
写真	しゃしん|じゃしん	shashinn|jashinn
参加	さんか	sannka
出来	しゅったい|しゅつらい|でき	shuttai|shutsurai|deki
問題	もんだい	monndai
以下	いか	ika
地図	ちず	chizu
時間	じかん	jikann
入力	にゅうりょく	nyuuryoku
関連	かんれん	kannrenn
意見	いけん	ikenn
最新	さいしん	saishinn
意味	いみ	imi
無料	むりょう	muryou
期待	きたい	kitai
参考	さんこう	sannkou
仕事	しごと	shigoto
希望	きぼう	kibou
中心	ちゅうしん	tyuushinn
追加	ついか	tsuika
説明	せつめい	setsumei
注文	ちゅうもん|ちゅうぶん	tyuumonn|tyuubunn
指定	してい	shitei
言葉	ことば	kotoba
住所	じゅうしょ	juusho
大切	たいせつ	taisetsu
用意	ようい	youi
目的	もくてき	mokuteki
人気	にんき|ひとけ|じんき	ninnki|hitoke|jinnki
発表	はっぴょう	happyou
気軽	きがる	kigaru
作成	さくせい	sakusei
周辺	しゅうへん	shuuhenn
予約	よやく	yoyaku
名前	なまえ	namae
今回	こんかい	konnkai
電話	でんわ	dennwa
関係	かんけい	kannkei
発生	はっせい	hassei
先頭	せんとう	senntou
注目	ちゅうもく	tyuumoku
今年	ことし|こんねん	kotoshi|konnnenn
世界	せかい	sekai
全国	ぜんこく	zennkoku
生活	せいかつ	seikatsu
安心	あんしん	annshinn
病院	びょういん	byouinn
相談	そうだん	soudann
公開	こうかい	koukai
話題	わだい	wadai
会員	かいいん	kaiinn
友達	ともだち	tomodachi
注意	ちゅうい	tyuui
部屋	へや|べや	heya|beya
回答	かいとう	kaitou
予定	よてい	yotei
下記	かき	kaki
当社	とうしゃ	tousha
大変	たいへん	taihenn
求人	きゅうじん	kyuujinn
発見	はっけん	hakkenn
本文	ほんぶん|ほんもん	honnbunn|honnmonn
結果	けっか	kekka
仕方	しかた	shikata
送信	そうしん	soushinn
心配	しんぱい	shinnpai
案内	あんない	annnai
重要	じゅうよう	juuyou
東京	とうきょう	toukyou
作品	さくひん	sakuhinn
協力	きょうりょく	kyouryoku
勉強	べんきょう	bennkyou
何度	なんど	nanndo
健康	けんこう	kennkou
開発	かいはつ	kaihatsu
最後	さいご	saigo
動画	どうが	douga
大事	おおごと|だいじ	oogoto|daiji
感想	かんそう	kannsou
開始	かいし	kaishi
文字	もじ|もんじ	moji|monnji
場所	ばしょ	basho
活動	かつどう	katsudou
会社	かいしゃ|がいしゃ	kaisha|gaisha
決定	けってい	kettei
無理	むり	muri
登場	とうじょう	toujou
旅行	りょこう	ryokou
今後	こんご	konngo
以上	いじょう	ijou
中古	ちゅうこ|ちゅうぶる	tyuuko|tyuuburu
様子	ようす	yousu
上記	じょうき	jouki
理由	りゆう	riyuu
昨日	きのう|さくじつ	kinou|sakujitsu
最初	さいしょ	saisho
残念	ざんねん	zannnenn
発売	はつばい	hatsubai
方法	ほうほう	houhou
便利	べんり	bennri
機会	きかい	kikai
発送	はっそう	hassou
成功	せいこう	seikou
送料	そうりょう	souryou
土地	とち	tochi
予想	よそう	yosou
元気	げんき	gennki
返品	へんぴん	hennpinn
料理	りょうり	ryouri
日記	にっき	nikki
変化	へんか|へんげ	hennka|hennge
学校	がっこう	gakkou
新着	しんちゃく	shinntyaku
活用	かつよう	katsuyou
当然	とうぜん	touzenn
時代	じだい	jidai
明日	あした|あす|みょうにち	ashita|asu|myounichi
天気	てんき	tennki
同意	どうい	doui
自然	しぜん|じねん	shizenn|jinenn
部分	ぶぶん	bubunn
体験	たいけん	taikenn
投票	とうひょう	touhyou
相手	あいて	aite
参照	さんしょう	sannshou
大人	おとな|たいじん|だいにん|うし	otona|taijinn|daininn|ushi
観光	かんこう	kannkou
自由	じゆう	jiyuu
完成	かんせい	kannsei
向上	こうじょう	koujou
特集	とくしゅう	tokushuu
失敗	しっぱい	shippai
読者	どくしゃ	dokusha
事前	じぜん	jizenn
位置	いち	ichi
放送	ほうそう	housou
記入	きにゅう	kinyuu
楽天	らくてん	rakutenn
人間	にんげん|じんかん	ninngenn|jinnkann
家族	かぞく	kazoku
管理	かんり	kannri
返信	へんしん	hennshinn
感動	かんどう	kanndou
形成	けいせい	keisei
本当	ほんとう|ほんと	honntou|honnto
満足	まんぞく	mannzoku
食事	しょくじ	shokuji
料金	りょうきん	ryoukinn
安全	あんぜん	annzenn
要望	ようぼう	youbou
気分	きぶん	kibunn
文章	ぶんしょう	bunnshou
研究	けんきゅう	kennkyuu
季節	きせつ	kisetsu
発行	はっこう	hakkou
記録	きろく	kiroku
成長	せいちょう	seityou
有名	ゆうめい	yuumei
音楽	おんがく	onngaku
時期	じき	jiki
自信	じしん	jishinn
努力	どりょく	doryoku
本日	ほんじつ	honnjitsu
事実	じじつ	jijitsu
配信	はいしん	haishinn
特定	とくてい	tokutei
通知	つうち	tsuuchi
自身	じしん	jishinn
失礼	しつれい	shitsurei
練習	れんしゅう	rennshuu
当店	とうてん	toutenn
用品	ようひん	youhinn
毎日	まいにち	mainichi
受付	うけつけ	uketsuke
大阪	おおさか	oosaka
店名	てんめい	tennmei
旅館	りょかん	ryokann
社会	しゃかい	shakai
実感	じっかん	jikkann
不安	ふあん	fuann
時計	とけい|どけい	tokei|dokei
全部	ぜんぶ	zennbu
約束	やくそく	yakusoku
以前	いぜん	izenn
印刷	いんさつ	innsatsu
種類	しゅるい	shurui
英語	えいご	eigo
京都	きょうと	kyouto
計画	けいかく	keikaku
地元	じもと	jimoto
本人	ほんにん	honnninn
家電	かでん	kadenn
成立	せいりつ	seiritsu
引用	いんよう	innyou
達成	たっせい	tassei
近所	きんじょ	kinnjo
都合	つごう	tsugou
中国	ちゅうこく	tyuukoku
番組	ばんぐみ	banngumi
路線	ろせん	rosenn
不明	ふめい	fumei
要求	ようきゅう	youkyuu
画面	がめん	gamenn
以外	いがい	igai
先生	せんせい	sennsei
集中	しゅうちゅう	shuutyuu
改正	かいせい	kaisei
返事	へんじ	hennji
馬鹿	ばか|ばかげ	baka|bakage
実行	じっこう	jikkou
目標	もくひょう	mokuhyou
人生	じんせい	jinnsei
次回	じかい	jikai
大学	だいがく	daigaku
計算	けいさん	keisann
行動	こうどう	koudou
最高	さいこう	saikou
関心	かんしん	kannshinn
立場	たちば|たてば	tachiba|tateba
発言	はつげん	hatsugenn
試合	しあい|じあい|しあう	shiai|jiai|shiau
何人	なにびと|なんぴと|なんびと|なにじん|なんにん	nanibito|nannpito|nannbito|nanijinn|nannninn
沖縄	おきなわ	okinawa
教育	きょういく	kyouiku
勝手	かって|がって	katte|gatte
法人	ほうじん	houjinn
全体	ぜんたい	zenntai
食品	しょくひん	shokuhinn
苦手	にがて	nigate
調子	ちょうし|ぢょうし	tyoushi|dyoushi
病気	びょうき	byouki
当時	とうじ	touji
海外	かいがい	kaigai
発信	はっしん	hasshinn
医院	いいん	iinn
強調	きょうちょう	kyoutyou
地球	ちきゅう	chikyuu
強化	きょうか	kyouka
課題	かだい	kadai
会場	かいじょう	kaijou
特化	とっか	tokka
安定	あんてい	anntei
電車	でんしゃ	dennsha
時点	じてん	jitenn
想定	そうてい	soutei
今週	こんしゅう	konnshuu
分類	ぶんるい	bunnrui
未来	みらい	mirai
区別	くべつ	kubetsu
中止	ちゅうし	tyuushi
共通	きょうつう	kyoutsuu
共有	きょうゆう	kyouyuu
礼金	れいきん	reikinn
入手	にゅうしゅ	nyuushu
調整	ちょうせい	tyousei
空気	くうき	kuuki
同一	どういつ	douitsu
出席	しゅっせき	shusseki
学問	がくもん	gakumonn
明記	めいき	meiki
出荷	しゅっか	shukka
点数	てんすう	tennsuu
低下	ていか	teika
各号	かくごう	kakugou
整理	せいり	seiri
小説	しょうせつ	shousetsu
配置	はいち	haichi
公表	こうひょう	kouhyou
来店	らいてん	raitenn
取材	しゅざい	shuzai
放置	ほうち	houchi
代表	だいひょう	daihyou
記念	きねん	kinenn
見方	みかた	mikata
学生	がくせい	gakusei
表明	ひょうめい	hyoumei
見学	けんがく	kenngaku
同様	どうよう	douyou
新聞	しんぶん	shinnbunn
国内	こくない	kokunai
最大	さいだい	saidai
相当	そうとう	soutou
駅名	えきめい	ekimei
反対	はんたい	hanntai
人物	じんぶつ	jinnbutsu
苦労	くろう|ぐろう	kurou|gurou
家庭	かてい	katei
他人	たにん|ひと|びと	taninn|hito|bito
学習	がくしゅう	gakushuu
歯科	しか	shika
各種	かくしゅ	kakushu
医者	いしゃ	isha
笑顔	えがお	egao
友人	ゆうじん	yuujinn
感心	かんしん	kannshinn
完全	かんぜん	kannzenn
今月	こんげつ	konngetsu
第一	だいいち	daiichi
配送	はいそう	haisou
観察	かんさつ	kannsatsu
工夫	くふう|こうふ	kufuu|koufu
出品	しゅっぴん	shuppinn
受信	じゅしん	jushinn
作業	さぎょう	sagyou
不足	ふそく|ぶそく	fusoku|busoku
高校	こうこう	koukou
公式	こうしき	koushiki
出発	しゅっぱつ	shuppatsu
氏名	しめい	shimei
生産	せいさん	seisann
数字	すうじ	suuji
昨年	さくねん	sakunenn
上部	じょうぶ	joubu
運転	うんてん	unntenn
事業	じぎょう	jigyou
図表	ずひょう	zuhyou
左右	さゆう	sayuu
取引	とりひき	torihiki
育成	いくせい	ikusei
理想	りそう	risou
固定	こてい	kotei
正直	しょうじき	shoujiki
辞書	じしょ	jisho
表記	ひょうき	hyouki
公共	こうきょう	koukyou
目安	めやす	meyasu
教養	きょうよう	kyouyou
卒業	そつぎょう	sotsugyou
身体	からだ|しんたい	karada|shinntai
出前	でまえ	demae
去年	きょねん|こぞ	kyonenn|kozo
意外	いがい	igai
休日	きゅうじつ	kyuujitsu
健全	けんぜん	kennzenn
今度	こんど	konndo
多数	たすう	tasuu
当日	とうじつ	toujitsu
地名	ちめい	chimei
祝日	しゅくじつ	shukujitsu
太陽	たいよう	taiyou
休業	きゅうぎょう	kyuugyou
先週	せんしゅう	sennshuu
交付	こうふ	koufu
土産	みやげ|どさん	miyage|dosann
外部	がいぶ	gaibu
入荷	にゅうか	nyuuka
出場	しゅつじょう|でば	shutsujou|deba
文化	ぶんか	bunnka
会話	かいわ	kaiwa
追求	ついきゅう|おいもとめ	tsuikyuu|oimotome
来年	らいねん	rainenn
加工	かこう	kakou
交流	こうりゅう	kouryuu
前日	ぜんじつ|まえび	zennjitsu|maebi
老人	ろうじん	roujinn
本社	ほんしゃ	honnsha
市民	しみん	shiminn
建物	たてもの|たてもん	tatemono|tatemonn
食材	しょくざい	shokuzai
必死	ひっし	hisshi
自動	じどう	jidou
発明	はつめい	hatsumei
加入	かにゅう	kanyuu
国民	こくみん|くにたみ	kokuminn|kunitami
上手	うわて|かみて|じょうず|うま|じょうて	uwate|kamite|jouzu|uma|joute
由来	ゆらい	yurai
所有	しょゆう	shoyuu
来場	らいじょう	raijou
悪化	あっか	akka
書店	しょてん	shotenn
売買	ばいばい	baibai
送付	そうふ	soufu
半角	はんかく	hannkaku
散歩	さんぽ	sannpo
全文	ぜんぶん	zennbunn
空間	あきま|くうかん	akima|kuukann
無事	ぶじ	buji
電子	でんし	dennshi
用語	ようご	yougo
期間	きかん	kikann
身近	みぢか|みじか	midika|mijika
有無	うむ	umu
法令	ほうれい	hourei
面白	おもしろ	omoshiro
本気	ほんき|まじ	honnki|maji
勝利	しょうり	shouri
連想	れんそう	rennsou
予感	よかん	yokann
結局	けっきょく	kekkyoku
加算	かさん	kasann
当院	とういん	touinn
何回	なんかい	nannkai
成果	せいか	seika
不要	ふよう	fuyou
結成	けっせい	kessei
体調	たいちょう	taityou
入院	にゅういん	nyuuinn
倉庫	そうこ	souko
銀行	ぎんこう	ginnkou
何卒	なにとぞ	nanitozo
運用	うんよう	unnyou
目次	もくじ	mokuji
予算	よさん	yosann
定着	ていちゃく	teityaku
交通	こうつう	koutsuu
追記	ついき	tsuiki
主要	しゅよう	shuyou
先日	せんじつ	sennjitsu
愛用	あいよう	aiyou
反省	はんせい	hannsei
進行	しんこう	shinnkou
絵本	えほん	ehonn
特別	とくべつ	tokubetsu
中身	なかみ	nakami
地点	ちてん	chitenn
特典	とくてん	tokutenn
相場	そうば	souba
平和	へいわ	heiwa
入札	にゅうさつ	nyuusatsu
決意	けつい	ketsui
信用	しんよう	shinnyou
入会	にゅうかい|いりあい	nyuukai|iriai
動作	どうさ	dousa
美人	びじん|めいれん	bijinn|meirenn
勇気	ゆうき	yuuki
業界	ぎょうかい	gyoukai
進化	しんか	shinnka
次第	しだい	shidai
前回	ぜんかい	zennkai
短期	たんき	tannki
題材	だいざい	daizai
見事	みごと	migoto
町名	ちょうめい	tyoumei
手元	てもと	temoto
連動	れんどう	renndou
神社	じんじゃ|かむやしろ	jinnja|kamuyashiro
感覚	かんかく	kannkaku
手紙	てがみ	tegami
手帳	てちょう	tetyou
本書	ほんしょ	honnsho
物語	ものがたり|ものがた	monogatari|monogata
分野	ぶんや	bunnya
算出	さんしゅつ	sannshutsu
方向	ほうこう	houkou
形式	けいしき	keishiki
小物	こもの	komono
本来	ほんらい	honnrai
会議	かいぎ	kaigi
戦争	せんそう	sennsou
世話	せわ|ぜわ	sewa|zewa
出産	しゅっさん	shussann
計上	けいじょう	keijou
単語	たんご	tanngo
実家	じっか	jikka
科学	かがく|かがっ	kagaku|kagaxtu
運行	うんこう	unnkou
直面	ちょくめん	tyokumenn
業種	ぎょうしゅ	gyoushu
通信	つうしん	tsuushinn
投入	とうにゅう	tounyuu
重点	じゅうてん	juutenn
教室	きょうしつ	kyoushitsu
日中	にっちゅう|ひなか	nittyuu|hinaka
社長	しゃちょう	shatyou
活発	かっぱつ	kappatsu
機器	きき	kiki
選出	せんしゅつ	sennshutsu
出店	しゅってん|でみせ	shuttenn|demise
主体	しゅたい	shutai
自覚	じかく	jikaku
本作	ほんさく	honnsaku
文具	ぶんぐ	bunngu
野菜	やさい	yasai
育児	いくじ	ikuji
通用	つうよう	tsuuyou
作者	さくしゃ	sakusha
起算	きさん	kisann
配合	はいごう	haigou
事例	じれい	jirei
毎年	まいとし|まいねん	maitoshi|mainenn
連続	れんぞく	rennzoku
受験	じゅけん	jukenn
和食	わしょく	washoku
主流	しゅりゅう	shuryuu
空港	くうこう	kuukou
各社	かくしゃ	kakusha
完売	かんばい	kannbai
発達	はったつ	hattatsu
持参	じさん	jisann
開放	かいほう	kaihou
意向	いこう	ikou
生成	せいせい	seisei
入学	にゅうがく	nyuugaku
進学	しんがく	shinngaku
飲料	いんりょう|のみりょう	innryou|nomiryou
建立	こんりゅう	konnryuu
加筆	かひつ	kahitsu
風景	ふうけい	fuukei
転用	てんよう	tennyou
全力	ぜんりょく	zennryoku
発足	はっそく|ほっそく	hassoku|hossoku
変動	へんどう	henndou
何事	なにごと	nanigoto
買取	かいとり|かいと	kaitori|kaito
合意	ごうい	goui
進出	しんしゅつ	shinnshutsu
細心	さいしん	saishinn
午後	ごご	gogo
冷静	れいせい	reisei
王国	おうこく	oukoku
定番	ていばん	teibann
着物	きもの	kimono
香水	こうすい	kousui
生息	せいそく	seisoku
動物	どうぶつ	doubutsu
生徒	せいと	seito
選手	せんしゅ	sennshu
市長	しちょう	shityou
配達	はいたつ	haitatsu
梅雨	つゆ|ばいう|づゆ	tsuyu|baiu|duyu
荷物	にもつ	nimotsu
順調	じゅんちょう	junntyou
親切	しんせつ	shinnsetsu
工具	こうぐ	kougu
夕方	ゆうがた	yuugata
音声	おんせい|おんじょう	onnsei|onnjou
漢字	かんじ	kannji
店内	てんない	tennnai
新年	しんねん	shinnnenn
大量	たいりょう	tairyou
高速	こうそく	kousoku
薬局	やっきょく	yakkyoku
生命	いのち|せいめい	inochi|seimei
順位	じゅんい	junni
日付	ひづけ	hiduke
商標	しょうひょう	shouhyou
集計	しゅうけい	shuukei
大会	たいかい|だいえ	taikai|daie
手配	てはい	tehai
起動	きどう	kidou
工事	こうじ	kouji
文庫	ぶんこ	bunnko
公園	こうえん	kouenn
埼玉	さいたま	saitama
原料	げんりょう	gennryou
選定	せんてい	senntei
祝福	しゅくふく	shukufuku
家具	かぐ	kagu
開業	かいぎょう	kaigyou
東海	とうかい	toukai
入金	にゅうきん	nyuukinn
出典	しゅってん	shuttenn
定員	ていいん	teiinn
材料	ざいりょう	zairyou
伝説	でんせつ	dennsetsu
観点	かんてん	kanntenn
飲食	いんしょく|おんじき	innshoku|onnjiki
店側	みせがわ	misegawa
市場	いちば|しじょう	ichiba|shijou
最悪	さいあく	saiaku
有料	ゆうりょう	yuuryou
平日	へいじつ	heijitsu
人材	じんざい	jinnzai
電気	でんき	dennki
手間	てま|でま	tema|dema
半分	はんぶん	hannbunn
気配	けはい|きはい	kehai|kihai
回転	かいてん	kaitenn
仕様	しよう	shiyou
体感	たいかん	taikann
発覚	はっかく	hakkaku
運命	うんめい	unnmei
中学	ちゅうがく	tyuugaku
屋根	やね	yane
区分	くぶん|くわけ	kubunn|kuwake
多大	ただい	tadai
真実	しんじつ	shinnjitsu
戸建	こだて	kodate
意図	いと	ito
花見	はなみ	hanami
番号	ばんごう	banngou
医学	いがく|いがっ	igaku|igaxtu
議長	ぎちょう	gityou
景色	けしき|げしき	keshiki|geshiki
協議	きょうぎ	kyougi
命名	めいめい	meimei
当地	とうち	touchi
息子	むすこ	musuko
店頭	てんとう	tenntou
何時	いつ|なんどき	itsu|nanndoki
転送	てんそう	tennsou
徒然	つれづれ|とぜん	tsuredure|tozenn
行使	こうし	koushi
意思	いし	ishi
例外	れいがい	reigai
当選	とうせん	tousenn
原作	げんさく	gennsaku
徒歩	とほ	toho
場面	ばめん	bamenn
何者	なにもの	nanimono
不満	ふまん	fumann
所持	しょじ	shoji
服用	ふくよう	fukuyou
正式	せいしき	seishiki
下手	したて|しもて|へた|げしゅ|べた|したで	shitate|shimote|heta|geshu|beta|shitade
悲鳴	ひめい	himei
順番	じゅんばん	junnbann
気合	きあい	kiai
外観	がいかん	gaikann
光景	こうけい	koukei
台風	たいふう	taifuu
満開	まんかい	mannkai
愛知	あいち	aichi
東北	とうほく	touhoku
買物	かいもの	kaimono
着用	ちゃくよう	tyakuyou
選挙	せんきょ	sennkyo
加速	かそく	kasoku
合流	ごうりゅう	gouryuu
変身	へんしん	hennshinn
省令	しょうれい	shourei
着手	ちゃくしゅ	tyakushu
本屋	ほんや	honnya
流行	りゅうこう|はやり|はや|ばやり	ryuukou|hayari|haya|bayari
帰国	きこく	kikoku
商談	しょうだん	shoudann
実物	じつぶつ|みもの	jitsubutsu|mimono
好感	こうかん	koukann
実力	じつりょく	jitsuryoku
間近	まぢか|まじか	madika|majika
安置	あんち	annchi
児童	じどう	jidou
本年	ほんねん	honnnenn
広場	ひろば	hiroba
動向	どうこう	doukou
館内	かんない	kannnai
代金	だいきん	daikinn
共感	きょうかん	kyoukann
女子	じょし|おなご	joshi|onago
大手	おおて|おおで	oote|oode
手軽	てがる	tegaru
名所	めいしょ|などころ	meisho|nadokoro
日曜	にちよう	nichiyou
早速	さっそく	sassoku
気温	きおん	kionn
工場	こうじょう|こうば	koujou|kouba
昼食	ちゅうしょく|ちゅうじき|ひるげ	tyuushoku|tyuujiki|hiruge
地位	ちい	chii
朝食	ちょうしょく|あさげ	tyoushoku|asage
勝負	かちまけ|しょうぶ	kachimake|shoubu
円高	えんだか	enndaka
面積	めんせき	mennseki
前面	ぜんめん	zennmenn
前後	ぜんこう|ぜんご	zennkou|zenngo
兵庫	ひょうご	hyougo
焼肉	やきにく	yakiniku
部員	ぶいん	buinn
付着	ふちゃく	futyaku
花火	はなび	hanabi
同社	どうしゃ	dousha
食感	しょっかん	shokkann
作用	さよう	sayou
最強	さいきょう	saikyou
対戦	たいせん	taisenn
全角	ぜんかく	zennkaku
滋賀	しが	shiga
客室	きゃくしつ	kyakushitsu
少年	しょうねん	shounenn
天候	てんこう	tennkou
自負	じふ	jifu
業者	ぎょうしゃ	gyousha
店長	てんちょう	tenntyou
和書	わしょ	washo
運動	うんどう	unndou
返金	へんきん	hennkinn
平気	へいき	heiki
天使	てんし	tennshi
周知	しゅうち	shuuchi
今朝	けさ|こんちょう	kesa|konntyou
目前	もくぜん	mokuzenn
土曜	どよう	doyou
電化	でんか	dennka
大半	たいはん|たいぱん	taihann|taipann
最長	さいちょう	saityou
実験	じっけん	jikkenn
時空	じくう	jikuu
多発	たはつ	tahatsu
念頭	ねんとう	nenntou
正当	せいとう	seitou
夕食	ゆうしょく|ゆうげ	yuushoku|yuuge
急速	きゅうそく	kyuusoku
初期	しょき	shoki
用事	ようじ	youji
調和	ちょうわ	tyouwa
事由	じゆう	jiyuu
自社	じしゃ	jisha
流通	りゅうつう|るずう	ryuutsuu|ruzuu
同行	どうこう|どうぎょう	doukou|dougyou
改良	かいりょう	kairyou
考案	こうあん	kouann
指名	しめい	shimei
新品	しんぴん	shinnpinn
重大	じゅうだい	juudai
待機	たいき	taiki
中央	ちゅうおう	tyuuou
表紙	ひょうし|びょうし	hyoushi|byoushi
青空	あおぞら	aozora
広島	ひろしま	hiroshima
味方	みかた	mikata
満面	まんめん	mannmenn
週末	しゅうまつ	shuumatsu
親身	しんみ	shinnmi
具合	ぐあい|ぐわい	guai|guwai
合間	あいま	aima
節約	せつやく	setsuyaku
会長	かいちょう	kaityou
起用	きよう	kiyou
都内	とない	tonai
地方	ちほう|じかた	chihou|jikata
書類	しょるい	shorui
道路	どうろ	douro
調節	ちょうせつ	tyousetsu
見積	みつもり|みつも	mitsumori|mitsumo
集約	しゅうやく	shuuyaku
手順	てじゅん	tejunn
達人	たつじん	tatsujinn
世代	せだい	sedai
内科	ないか	naika
原点	げんてん	genntenn
有利	ゆうり	yuuri
録画	ろくが	rokuga
標高	ひょうこう	hyoukou
野球	やきゅう	yakyuu
静岡	しずおか	shizuoka
毎度	まいど	maido
曜日	ようび	youbi
各地	かくち	kakuchi
不幸	ふこう	fukou
夜景	やけい	yakei
県内	けんない	kennnai
人数	にんずう|にんず|ひとかず	ninnzuu|ninnzu|hitokazu
命令	めいれい	meirei
録音	ろくおん	rokuonn
文書	ぶんしょ|もんじょ	bunnsho|monnjo
返答	へんとう	henntou
後半	こうはん	kouhann
照合	しょうごう	shougou
短大	たんだい	tanndai
多様	たよう	tayou
出土	しゅつど	shutsudo
問屋	といや|とんや|どんや|どいや	toiya|tonnya|donnya|doiya
夜中	やちゅう|よなか	yatyuu|yonaka
入社	にゅうしゃ	nyuusha
未然	みぜん	mizenn
何物	なにもの	nanimono
教会	きょうかい	kyoukai
内定	ないてい	naitei
落札	らくさつ	rakusatsu
両立	りょうりつ	ryouritsu
良好	りょうこう	ryoukou
地上	ちじょう	chijou
行列	ぎょうれつ	gyouretsu
本音	ほんね	honnne
全然	ぜんぜん	zennzenn
帰省	きせい	kisei
信号	しんごう	shinngou
列車	れっしゃ	ressha
付加	ふか	fuka
放出	ほうしゅつ	houshutsu
試験	しけん	shikenn
先行	せんこう	sennkou
出力	しゅつりょく	shutsuryoku
苦笑	くしょう	kushou
役目	やくめ	yakume
多少	たしょう	tashou
最低	さいてい	saitei
近年	きんねん	kinnnenn
借金	しゃっきん	shakkinn
悪口	あっこう|わるくち|わるぐち	akkou|warukuchi|waruguchi
苦戦	くせん	kusenn
新潟	にいがた	niigata
観戦	かんせん	kannsenn
最中	さいちゅう|もなか|さなか	saityuu|monaka|sanaka
多用	たよう	tayou
都市	とし|まち	toshi|machi
自立	じりつ	jiritsu
不正	ふせい	fusei
楽器	がっき	gakki
算定	さんてい	sanntei
科目	かもく	kamoku
日当	にっとう	nittou
議決	ぎけつ	giketsu
不便	ふべん	fubenn
少女	しょうじょ|おとめ	shoujo|otome
産業	さんぎょう	sanngyou
明言	めいげん	meigenn
親子	おやこ|しんし	oyako|shinnshi
世間	せけん	sekenn
差別	さべつ|しゃべつ	sabetsu|shabetsu
米屋	こめや	komeya
特筆	とくひつ	tokuhitsu
間取	まどり	madori
全員	ぜんいん	zenninn
来週	らいしゅう	raishuu
物流	ぶつりゅう	butsuryuu
園芸	えんげい	enngei
発想	はっそう	hassou
行方	ゆくえ	yukue
右上	みぎうえ	migiue
当初	とうしょ	tousho
特色	とくしょく	tokushoku
代行	だいこう	daikou
成分	せいぶん	seibunn
開花	かいか	kaika
岩手	いわて	iwate
発動	はつどう	hatsudou
直前	ちょくぜん	tyokuzenn
付近	ふきん	fukinn
書式	しょしき	shoshiki
民宿	みんしゅく	minnshuku
着目	ちゃくもく	tyakumoku
合計	ごうけい	goukei
青春	せいしゅん	seishunn
植物	しょくぶつ	shokubutsu
読書	どくしょ|よみかき	dokusho|yomikaki
年配	ねんぱい	nennpai
楽曲	がっきょく	gakkyoku
両手	もろて|りょうて	morote|ryoute
行事	ぎょうじ	gyouji
鉄道	てつどう	tetsudou
思想	しそう	shisou
正体	しょうたい|せいたい	shoutai|seitai
頭皮	とうひ	touhi
決勝	けっしょう	kesshou
登山	とざん	tozann
機種	きしゅ	kishu
完結	かんけつ	kannketsu
神様	かみさま	kamisama
本名	ほんみょう	honnmyou
風味	ふうみ	fuumi
民主	みんしゅ	minnshu
多分	たぶん	tabunn
心身	しんしん	shinnshinn
発注	はっちゅう	hattyuu
幸福	こうふく	koufuku
所定	しょてい	shotei
開通	かいつう	kaitsuu
改変	かいへん	kaihenn
記法	きほう	kihou
真夏	まなつ	manatsu
訓練	くんれん	kunnrenn
単発	たんぱつ	tannpatsu
岐阜	ぎふ	gifu
入場	にゅうじょう	nyuujou
強要	きょうよう	kyouyou
手法	しゅほう	shuhou
古書	こしょ	kosho
直送	ちょくそう	tyokusou
道具	どうぐ	dougu
出題	しゅつだい	shutsudai
連結	れんけつ	rennketsu
様相	ようそう	yousou
毎週	まいしゅう	maishuu
外科	げか	geka
下落	げらく	geraku
考察	こうさつ	kousatsu
整体	せいたい	seitai
追放	ついほう	tsuihou
終始	しゅうし	shuushi
未定	みてい	mitei
流出	りゅうしゅつ|ながれで	ryuushutsu|nagarede
分身	ぶんしん	bunnshinn
高度	こうど	koudo
連発	れんぱつ	rennpatsu
足元	あしもと	ashimoto
続出	ぞくしゅつ	zokushutsu
利点	りてん	ritenn
味覚	みかく	mikaku
本物	ほんもの	honnmono
対立	たいりつ	tairitsu
直近	ちょっきん	tyokkinn
切手	きって|ぎって	kitte|gitte
自生	じせい	jisei
協働	きょうどう	kyoudou
言語	げんご|ごんご	genngo|gonngo
戦後	せんご	senngo
単位	たんい	tanni
半年	はんとし|はんねん	hanntoshi|hannnenn
新車	しんしゃ	shinnsha
王様	おうさま	ousama
分散	ぶんさん	bunnsann
町長	ちょうちょう	tyoutyou
役員	やくいん	yakuinn
定食	ていしょく	teishoku
持続	じぞく	jizoku
作曲	さっきょく	sakkyoku
愛犬	あいけん	aikenn
直結	ちょっけつ	tyokketsu
照会	しょうかい	shoukai
上位	じょうい	joui
月日	つきひ|がっぴ	tsukihi|gappi
大地	だいち	daichi
今夜	こんや	konnya
根底	こんてい	konntei
名言	めいげん	meigenn
明白	めいはく	meihaku
広大	こうだい	koudai
大分	だいぶ|だいぶん|おおいた	daibu|daibunn|ooita
体力	たいりょく	tairyoku
集合	しゅうごう	shuugou
当分	とうぶん	toubunn
中間	ちゅうかん|ちゅうげん	tyuukann|tyuugenn
図面	ずめん	zumenn
社寺	しゃじ	shaji
浴衣	ゆかた	yukata
主役	しゅやく	shuyaku
委員	いいん	iinn
部落	ぶらく	buraku
通学	つうがく	tsuugaku
訓令	くんれい	kunnrei
産地	さんち	sannchi
死去	しきょ	shikyo
生計	せいけい	seikei
正面	しょうめん|せいめん	shoumenn|seimenn
回数	かいすう	kaisuu
天国	てんごく	tenngoku
食育	しょくいく	shokuiku
大別	たいべつ	taibetsu
欠落	けつらく	ketsuraku
熱心	ねっしん	nesshinn
日数	にっすう|ひかず	nissuu|hikazu
近代	きんだい	kinndai
強力	きょうりょく|ごうりき|きょうりき	kyouryoku|gouriki|kyouriki
帰路	きろ	kiro
横目	よこめ	yokome
進歩	しんぽ	shinnpo
都会	とかい	tokai
県外	けんがい	kenngai
休止	きゅうし	kyuushi
参戦	さんせん	sannsenn
調理	ちょうり	tyouri
年末	ねんまつ	nennmatsu
連休	れんきゅう	rennkyuu
身長	しんちょう	shinntyou
養成	ようせい	yousei
関節	かんせつ	kannsetsu
理念	りねん	rinenn
議題	ぎだい	gidai
整形	せいけい	seikei
共同	きょうどう	kyoudou
右記	うき	uki
進路	しんろ	shinnro
人目	ひとめ	hitome
数量	すうりょう	suuryou
多岐	たき	taki
学者	がくしゃ	gakusha
受理	じゅり	juri
機械	きかい	kikai
高級	こうきゅう	koukyuu
文中	ぶんちゅう	bunntyuu
決心	けっしん	kesshinn
死者	ししゃ	shisha
乗車	じょうしゃ	jousha
首相	しゅしょう	shushou
何日	なんにち	nannnichi
愛車	あいしゃ	aisha
天才	てんさい	tennsai
同等	どうとう	doutou
天空	てんくう	tennkuu
申出	もうしで	moushide
起点	きてん	kitenn
助成	じょせい	josei
両方	りょうほう	ryouhou
赤毛	あかげ	akage
下車	げしゃ	gesha
投下	とうか	touka
人形	にんぎょう|ひとがた	ninngyou|hitogata
深夜	しんや	shinnya
住民	じゅうみん	juuminn
同店	どうてん	doutenn
星空	ほしぞら	hoshizora
社員	しゃいん	shainn
反発	はんぱつ	hannpatsu
主人	しゅじん	shujinn
事典	じてん	jitenn
出番	でばん	debann
成約	せいやく	seiyaku
駅近	えきちか	ekichika
題名	だいめい	daimei
使命	しめい	shimei
長期	ちょうき	tyouki
後者	こうしゃ	kousha
例年	れいねん	reinenn
最短	さいたん	saitann
店員	てんいん	tenninn
愛読	あいどく	aidoku
国家	こっか	kokka
絵画	かいが	kaiga
待望	たいぼう	taibou
走行	そうこう	soukou
合成	ごうせい	gousei
愛媛	えひめ	ehime
戦場	せんじょう|いくさば	sennjou|ikusaba
残業	ざんぎょう	zanngyou
表面	ひょうめん	hyoumenn
角度	かくど	kakudo
欠品	けっぴん	keppinn
極上	ごくじょう	gokujou
空室	くうしつ	kuushitsu
大目	おおめ	oome
極意	ごくい	gokui
農業	のうぎょう	nougyou
作動	さどう	sadou
寺院	じいん	jiinn
街中	まちじゅう|まちなか	machijuu|machinaka
赤字	あかじ	akaji
散見	さんけん	sannkenn
調達	ちょうたつ	tyoutatsu
新作	しんさく	shinnsaku
農家	のうか	nouka
浴室	よくしつ	yokushitsu
着実	ちゃくじつ	tyakujitsu
標的	ひょうてき	hyouteki
記者	きしゃ	kisha
姉妹	しまい	shimai
和風	わふう	wafuu
養子	ようし	youshi
右側	みぎがわ|うそく	migigawa|usoku
作家	さっか	sakka
横行	おうこう	oukou
紙面	しめん	shimenn
陽気	ようき	youki
来日	らいにち	rainichi
空白	くうはく	kuuhaku
矢印	やじるし	yajirushi
国語	こくご	kokugo
集結	しゅうけつ	shuuketsu
結合	けつごう	ketsugou
来院	らいいん	raiinn
毛皮	けがわ	kegawa
試算	しさん	shisann
暑中	しょちゅう	shotyuu
原案	げんあん	gennann
来館	らいかん	raikann
栄養	えいよう	eiyou
原文	げんぶん	gennbunn
小麦	こむぎ	komugi
立地	りっち	ricchi
分岐	ぶんき	bunnki
洋食	ようしょく	youshoku
要約	ようやく	youyaku
佐賀	さが	saga
遠方	えんぽう|おちかた	ennpou|ochikata
飲酒	いんしゅ|おんじゅ	innshu|onnju
商売	しょうばい	shoubai
各国	かくこく|かっこく	kakukoku|kakkoku
発令	はつれい	hatsurei
会計	かいけい	kaikei
上司	じょうし	joushi
人事	じんじ|ひとごと	jinnji|hitogoto
徳島	とやま	toyama
体内	たいない	tainai
各課	かくか	kakuka
以内	いない	inai
上陸	じょうりく	jouriku
通貨	つうか	tsuuka
今作	こんさく	konnsaku
全身	ぜんしん	zennshinn
社名	しゃめい	shamei
改定	かいてい	kaitei
会談	かいだん	kaidann
真相	しんそう	shinnsou
公言	こうげん	kougenn
終結	しゅうけつ	shuuketsu
負荷	ふか	fuka
心理	しんり	shinnri
国会	こっかい	kokkai
古代	こだい	kodai
鳥類	ちょうるい	tyourui
議会	ぎかい	gikai
決議	けつぎ	ketsugi
白銀	しろがね|はくぎん	shirogane|hakuginn
羽目	はめ|ばめ	hame|bame
手続	てつづき	tetsuduki
方式	ほうしき	houshiki
男女	だんじょ|なんにょ|おとこおんな	dannjo|nannnyo|otokoonnna
公立	こうりつ	kouritsu
時事	じじ	jiji
熱中	ねっちゅう	nettyuu
給料	きゅうりょう	kyuuryou
水曜	すいよう	suiyou
弟子	ていし|でし	teishi|deshi
連行	れんこう	rennkou
以来	いらい	irai
生地	きじ|せいち	kiji|seichi
書面	しょめん	shomenn
主題	しゅだい	shudai
当方	とうほう	touhou
週間	しゅうかん	shuukann
両親	りょうしん	ryoushinn
勇者	ゆうしゃ	yuusha
血行	けっこう	kekkou
左側	ひだりがわ|さそく	hidarigawa|sasoku
早目	はやめ	hayame
協会	きょうかい	kyoukai
相続	そうぞく	souzoku
洋服	ようふく	youfuku
議員	ぎいん	giinn
人種	じんしゅ	jinnshu
虫歯	むしば	mushiba
助長	じょちょう	jotyou
長年	ながねん|ちゃんねん	naganenn|tyannnenn
民族	みんぞく	minnzoku
仕業	しわざ|しぎょう	shiwaza|shigyou
旅先	たびさき	tabisaki
運送	うんそう	unnsou
父親	ちちおや	chichioya
院内	いんない	innnai
女神	めがみ|じょしん|にょしん	megami|joshinn|nyoshinn
原付	げんつき	genntsuki
群生	ぐんせい	gunnsei
週休	しゅうきゅう	shuukyuu
高台	こうだい|たかだい	koudai|takadai
皮肉	ひにく	hiniku
体重	たいじゅう	taijuu
文学	ぶんがく|ぶんがっ	bunngaku|bunngaxtu
幸運	こううん	kouunn
自体	じたい	jitai
小雨	こさめ|しょうう	kosame|shouu
金色	きんいろ|こんじき	kinniro|konnjiki
左記	さき	saki
競売	きょうばい|けいばい|せりうり	kyoubai|keibai|seriuri
右折	うせつ	usetsu
電波	でんぱ	dennpa
気長	きなが	kinaga
後世	こうせい|ごせ	kousei|gose
目線	めせん	mesenn
流用	りゅうよう	ryuuyou
出身	しゅっしん	shusshinn
上下	じょうげ|がみしも|うえした|かみしも|じょうか	jouge|gamishimo|ueshita|kamishimo|jouka
本市	ほんし	honnshi
見当	けんとう|みあた	kenntou|miata
強行	きょうこう	kyoukou
会見	かいけん	kaikenn
側面	そくめん	sokumenn
上場	じょうじょう	joujou
定年	ていねん	teinenn
集客	しゅうきゃく	shuukyaku
門地	もんち	monnchi
必見	ひっけん	hikkenn
好意	こうい	koui
社説	しゃせつ	shasetsu
日産	にっさん	nissann
改行	かいぎょう	kaigyou
左折	させつ	sasetsu
地面	じめん	jimenn
決着	けっちゃく	kettyaku
午前	ごぜん	gozenn
大雨	おおあめ	ooame
大豆	だいず	daizu
同時	どうじ	douji
和洋	わよう	wayou
美白	びはく	bihaku
東西	とうざい|ひんがしにし	touzai|hinngashinishi
人文	じんぶん|じんもん	jinnbunn|jinnmonn
欠点	けってん	kettenn
水気	みずけ|すいき	mizuke|suiki
不服	ふふく	fufuku
他店	たてん	tatenn
改名	かいめい	kaimei
物事	ものごと	monogoto
労働	ろうどう	roudou
名店	めいてん	meitenn
新緑	しんりょく	shinnryoku
入口	いりぐち|いりくち	iriguchi|irikuchi
切開	せっかい|きりひらけ	sekkai|kirihirake
身軽	みがる	migaru
有用	ゆうよう	yuuyou
神話	しんわ	shinnwa
決算	けっさん	kessann
土台	どだい	dodai
生業	せいぎょう|なりわい|すぎわい	seigyou|nariwai|sugiwai
国立	こくりつ	kokuritsu
水分	すいぶん	suibunn
生協	せいきょう	seikyou
花屋	はなや	hanaya
家主	やぬし|いえぬし|いえあるじ	yanushi|ienushi|iearuji
社外	しゃがい	shagai
入店	にゅうてん	nyuutenn
内包	ないほう	naihou
人口	じんこう	jinnkou
他社	たしゃ	tasha
注力	ちゅうりょく	tyuuryoku
各自	かくじ	kakuji
美味	びみ|うま	bimi|uma
県民	けんみん	kennminn
栃木	とちぎ	tochigi
会合	かいごう	kaigou
観客	かんきゃく	kannkyaku
列挙	れっきょ	rekkyo
声明	せいめい|しょうみょう	seimei|shoumyou
新書	しんしょ	shinnsho
大声	おおごえ|たいせい	oogoe|taisei
同課	どうか	douka
図書	としょ|ずしょ	tosho|zusho
松竹	しょうちく	shouchiku
悪用	あくよう	akuyou
群馬	ぐんま	gunnma
初日	しょにち|はつひ|はつび	shonichi|hatsuhi|hatsubi
指標	しひょう	shihyou
連日	れんじつ	rennjitsu
日課	にっか	nikka
本家	ほんけ	honnke
課金	かきん	kakinn
起業	きぎょう	kigyou
初回	しょかい	shokai
種別	しゅべつ	shubetsu
部類	ぶるい	burui
全集	ぜんしゅう	zennshuu
転落	てんらく|ころげおち	tennraku|korogeochi
流石	さすが	sasuga
加味	かみ	kami
前号	ぜんごう	zenngou
競争	きょうそう	kyousou
算入	さんにゅう	sannnyuu
高知	こうち	kouchi
洋画	ようが	youga
学区	がっく	gakku
他者	たしゃ	tasha
全室	ぜんしつ	zennshitsu
点灯	てんとう	tenntou
小売	こうり	kouri
特選	とくせん	tokusenn
口調	くちょう	kutyou
交差	こうさ	kousa
何本	なんぼん	nannbonn
青森	あおもり	aomori
満天	まんてん	manntenn
合体	がったい	gattai
注入	ちゅうにゅう	tyuunyuu
物心	ぶっしん|ものごころ	busshinn|monogokoro
死体	したい	shitai
当館	とうかん	toukann
番地	ばんち	bannchi
同表	どうひょう	douhyou
地酒	じざけ	jizake
水着	みずぎ	mizugi
無線	むせん	musenn
工芸	こうげい	kougei
良品	りょうひん	ryouhinn
足湯	あしゆ	ashiyu
未知	みち	michi
司会	しかい	shikai
神道	しんとう	shinntou
女医	じょい	joi
生育	せいいく	seiiku
右下	みぎした	migishita
転校	てんこう	tennkou
好調	こうちょう	koutyou
特長	とくちょう	tokutyou
親交	しんこう	shinnkou
入室	にゅうしつ	nyuushitsu
本業	ほんぎょう	honngyou
角地	かどち	kadochi
信念	しんねん	shinnnenn
初音	はつね	hatsune
本校	ほんこう	honnkou
月別	つきべつ	tsukibetsu
動員	どういん	douinn
山積	さんせき|やまづみ	sannseki|yamadumi
農薬	のうやく	nouyaku
学会	がっかい	gakkai
名物	めいぶつ	meibutsu
全面	ぜんめん	zennmenn
小児	しょうに	shouni
結集	けっしゅう	kesshuu
不利	ふり	furi
同点	どうてん	doutenn
店主	てんしゅ	tennshu
参画	さんかく	sannkaku
都心	としん	toshinn
登記	とうき	touki
母親	ははおや	hahaoya
直感	ちょっかん	tyokkann
金利	きんり	kinnri
給食	きゅうしょく	kyuushoku
意地	いじ	iji
右手	みぎて|めて	migite|mete
日時	にちじ	nichiji
気候	きこう	kikou
外灯	がいとう	gaitou
年月	としつき|ねんげつ	toshitsuki|nenngetsu
住人	じゅうにん	juuninn
外交	がいこう	gaikou
安静	あんせい	annsei
家中	いえじゅう|かちゅう	iejuu|katyuu
人類	じんるい	jinnrui
学科	がっか	gakka
活気	かっき	kakki
別人	べつじん	betsujinn
自作	じさく	jisaku
不当	ふとう	futou
長文	ちょうぶん	tyoubunn
後日	ごじつ|ごにち	gojitsu|gonichi
出庫	しゅっこ	shukko
毎月	まいつき|まいげつ	maitsuki|maigetsu
前記	ぜんき	zennki
大笑	たいしょう	taishou
数回	すうかい	suukai
人体	じんたい|じんてい|にんてい	jinntai|jinntei|ninntei
物色	ぶっしょく	busshoku
思考	しこう	shikou
取消	とりけし	torikeshi
洋楽	ようがく	yougaku
島根	しまね|しまね	shimane|shimane
人達	ひとたち	hitotachi
辞典	じてん	jitenn
放流	ほうりゅう	houryuu
男子	だんし	dannshi
入所	にゅうしょ	nyuusho
便乗	びんじょう	binnjou
究極	きゅうきょく	kyuukyoku
通院	つういん	tsuuinn
部活	ぶかつ	bukatsu
手前	てまえ|てめい	temae|temei
北東	ほくとう	hokutou
景観	けいかん	keikann
来月	らいげつ	raigetsu
発音	はつおん	hatsuonn
参入	さんにゅう	sannnyuu
曲名	きょくめい	kyokumei
察知	さっち	sacchi
機関	きかん	kikann
早急	さっきゅう|そうきゅう	sakkyuu|soukyuu
助言	じょげん|じょごん	jogenn|jogonn
開店	かいてん	kaitenn
感化	かんか	kannka
同席	どうせき	douseki
売上	うりあげ	uriage
原理	げんり	gennri
丁目	ちょうめ	tyoume
月曜	げつよう	getsuyou
作文	さくぶん	sakubunn
部門	ぶもん	bumonn
単品	たんぴん	tannpinn
成人	せいじん	seijinn
林道	りんどう	rinndou
調印	ちょういん	tyouinn
茨城	いばらぎ	ibaragi
知事	ちじ	chiji
温度	おんど	onndo
生物	せいぶつ|なまもの|いきもの	seibutsu|namamono|ikimono
本題	ほんだい	honndai
有力	ゆうりょく	yuuryoku
不動	ふどう	fudou
世辞	せじ	seji
消失	しょうしつ|きえうせ	shoushitsu|kieuse
軍配	ぐんばい	gunnbai
社内	しゃない	shanai
残暑	ざんしょ	zannsho
本場	ほんば	honnba
全開	ぜんかい	zennkai
車両	しゃりょう	sharyou
酒類	しゅるい	shurui
天神	てんじん|てんしん	tennjinn|tennshinn
借入	かりいれ	kariire
手足	しゅそく|てあし	shusoku|teashi
地区	ちく	chiku
本体	ほんたい	honntai
最速	さいそく	saisoku
用法	ようほう	youhou
坂道	さかみち	sakamichi
黄色	おうしょく|きいろ|こうしょく	oushoku|kiiro|koushoku
初夏	しょか	shoka
土日	どにち	donichi
金曜	きんよう	kinnyou
景気	けいき|げいき	keiki|geiki
年表	ねんぴょう	nennpyou
消化	しょうか	shouka
晴天	せいてん	seitenn
建学	けんがく	kenngaku
外国	がいこく|とつくに	gaikoku|totsukuni
病名	びょうめい	byoumei
地理	ちり	chiri
上京	じょうきょう	joukyou
底本	ていほん	teihonn
書名	しょめい	shomei
顔色	かおいろ|がんしょく	kaoiro|gannshoku
何分	なにぶん	nanibunn
食器	しょっき	shokki
打開	だかい	dakai
本案	ほんあん	honnann
手話	しゅわ	shuwa
台頭	たいとう	taitou
共生	きょうせい	kyousei
照明	しょうめい	shoumei
受取	うけとり|うけと	uketori|uketo
北部	ほくぶ	hokubu
以後	いご	igo
平行	へいこう	heikou
本紙	ほんし	honnshi
道場	どうじょう	doujou
土用	どよう	doyou
目印	めじるし	mejirushi
満席	まんせき	mannseki
借家	しゃくや|しゃっか|かりいえ	shakuya|shakka|kariie
入浴	にゅうよく	nyuuyoku
前進	ぜんしん	zennshinn
台場	だいば	daiba
挙行	きょこう	kyokou
下着	したぎ	shitagi
放題	ほうだい	houdai
知人	ちじん	chijinn
改札	かいさつ	kaisatsu
各週	かくしゅう	kakushuu
長男	ちょうなん	tyounann
左手	ひだりて|ゆんで	hidarite|yunnde
港区	こうく	kouku
気楽	きらく	kiraku
初心	うぶ|しょしん	ubu|shoshinn
健勝	けんしょう	kennshou
思案	しあん|じあん	shiann|jiann
学部	がくぶ	gakubu
子宮	しきゅう	shikyuu
都度	つど	tsudo
筆者	ひっしゃ	hissha
各店	かくてん	kakutenn
続行	ぞっこう	zokkou
各氏	かくし	kakushi
校正	こうせい	kousei
真心	まごころ	magokoro
部位	ぶい	bui
合算	がっさん	gassann
物理	ぶつり	butsuri
長所	ちょうしょ	tyousho
土木	どぼく	doboku
前者	ぜんしゃ	zennsha
想起	そうき	souki
好天	こうてん	koutenn
魚屋	さかなや	sakanaya
外見	がいけん|そとみ	gaikenn|sotomi
出先	でさき	desaki
用紙	ようし	youshi
代用	だいよう	daiyou
失望	しつぼう	shitsubou
雨天	うてん	utenn
始末	しまつ	shimatsu
上品	じょうひん|じょうぼん	jouhinn|joubonn
直後	ちょくご	tyokugo
受給	じゅきゅう	jukyuu
大差	たいさ	taisa
代引	だいびき	daibiki
対決	たいけつ	taiketsu
駅前	えきまえ	ekimae
公明	こうめい	koumei
落下	らっか	rakka
法事	ほうじ	houji
子犬	こいぬ	koinu
部品	ぶひん	buhinn
節目	ふしめ	fushime
自愛	じあい	jiai
歌声	うたごえ	utagoe
包丁	ほうちょう|ぼうちょう	houtyou|boutyou
開運	かいうん	kaiunn
同号	どうごう	dougou
洋書	ようしょ	yousho
通路	つうろ|かよいじ	tsuuro|kayoiji
白黒	しろくろ	shirokuro
前半	ぜんはん|ぜんぱん	zennhann|zennpann
番目	ばんめ	bannme
平然	へいぜん	heizenn
産学	さんがく	sanngaku
家事	かじ	kaji
両者	りょうしゃ	ryousha
下見	したみ	shitami
見本	みほん	mihonn
母体	ぼたい	botai
参列	さんれつ	sannretsu
速読	そくどく	sokudoku
消去	しょうきょ|きえさ	shoukyo|kiesa
夕日	ゆうひ	yuuhi
最終	さいしゅう	saishuu
副業	ふくぎょう	fukugyou
白羽	しらは	shiraha
早朝	そうちょう	soutyou
小社	しょうしゃ	shousha
本番	ほんばん	honnbann
教員	きょういん	kyouinn
変形	へんけい	hennkei
号給	ごうきゅう	goukyuu
品種	ひんしゅ	hinnshu
等級	とうきゅう	toukyuu
活力	かつりょく	katsuryoku
天井	てんじょう|てんせい	tennjou|tennsei
会館	かいかん	kaikann
内側	うちがわ|ないそく	uchigawa|naisoku
同名	どうめい	doumei
家計	かけい	kakei
昨夜	さくや|ゆうべ|ゆんべ	sakuya|yuube|yunnbe
式場	しきじょう	shikijou
借主	かりぬし	karinushi
火事	かじ	kaji
伝達	でんたつ	denntatsu
近辺	きんぺん	kinnpenn
開局	かいきょく	kaikyoku
失念	しつねん	shitsunenn
本店	ほんてん	honntenn
通園	つうえん	tsuuenn
市内	いちない|しない	ichinai|shinai
戦国	せんごく	senngoku
集積	しゅうせき	shuuseki
道順	みちじゅん	michijunn
反転	はんてん	hanntenn
母校	ぼこう	bokou
旅宿	りょしゅく	ryoshuku
教材	きょうざい	kyouzai
出動	しゅつどう	shutsudou
弱火	よわび	yowabi
台所	だいどころ	daidokoro
流入	りゅうにゅう	ryuunyuu
民間	みんかん	minnkann
前年	ぜんねん	zennnenn
本館	ほんかん	honnkann
酒屋	さかや|ざかや	sakaya|zakaya
転売	てんばい	tennbai
昼夜	ちゅうや|ひるよる	tyuuya|hiruyoru
下部	かぶ	kabu
清栄	せいえい	seiei
発散	はっさん	hassann
悪意	あくい	akui
国産	こくさん	kokusann
前身	ぜんしん	zennshinn
対話	たいわ	taiwa
的中	てきちゅう	tekityuu
不覚	ふかく	fukaku
中立	ちゅうりつ	tyuuritsu
住戸	じゅうこ	juuko
全品	ぜんぴん	zennpinn
同期	どうき	douki
名作	めいさく	meisaku
北上	ほくじょう	hokujou
夜空	よぞら	yozora
挙式	きょしき	kyoshiki
対談	たいだん	taidann
焼失	しょうしつ	shoushitsu
開館	かいかん	kaikann
算数	さんすう	sannsuu
学力	がくりょく	gakuryoku
戦死	せんし	sennshi
部下	ぶか	buka
商業	しょうぎょう	shougyou
宿場	しゅくば	shukuba
子孫	しそん	shisonn
点心	てんしん	tennshinn
下図	かず|したず	kazu|shitazu
体育	たいいく	taiiku
産物	さんぶつ	sannbutsu
無茶	むちゃ	mutya
室内	しつない	shitsunai
同乗	どうじょう	doujou
矢先	やさき	yasaki
近場	ちかば	chikaba
神官	しんかん	shinnkann
兄弟	きょうだい|けいてい	kyoudai|keitei
不育	ふいく	fuiku
北側	きたがわ	kitagawa
取付	とりつけ	toritsuke
実用	じつよう	jitsuyou
起立	きりつ	kiritsu
名曲	めいきょく	meikyoku
商材	しょうざい	shouzai
化学	かがく|かがっ|ばけがく	kagaku|kagaxtu|bakegaku
受注	じゅちゅう	jutyuu
競馬	けいば	keiba
日光	にっこう	nikkou
内部	ないぶ	naibu
教訓	きょうくん	kyoukunn
議事	ぎじ	giji
試読	しどく	shidoku
毎回	まいかい	maikai
力説	りきせつ	rikisetsu
熱意	ねつい	netsui
郡名	ぐんめい	gunnmei
投信	とうしん	toushinn
文芸	ぶんげい	bunngei
見物	けんぶつ|みもの	kennbutsu|mimono
天然	てんねん	tennnenn
前世	ぜんせ|ぜんせい	zennse|zennsei
予期	よき	yoki
上達	じょうたつ	joutatsu
先手	せんて|さきて	sennte|sakite
標語	ひょうご	hyougo
空想	くうそう	kuusou
水辺	すいへん|みずべ	suihenn|mizube
中部	ちゅうぶ	tyuubu
用量	ようりょう	youryou
予言	よげん	yogenn
青年	せいねん	seinenn
山梨	やまなし|やまなし	yamanashi|yamanashi
所要	しょよう	shoyou
数学	すうがく|すうがっ	suugaku|suugaxtu
対面	たいめん|だいめん	taimenn|daimenn
女王	じょおう|じょうおう	joou|jouou
老後	ろうご	rougo
人出	ひとで	hitode
寺社	じしゃ	jisha
取組	とりくみ|とりくめ	torikumi|torikume
音読	おんどく	onndoku
細部	さいぶ	saibu
願書	がんしょ	gannsho
様式	ようしき	youshiki
小顔	こがお	kogao
年季	ねんき	nennki
念願	ねんがん	nenngann
黒人	こくじん	kokujinn
理科	りか	rika
満月	まんげつ	manngetsu
英和	えいわ	eiwa
栄光	えいこう	eikou
愛想	あいそ|あいそう	aiso|aisou
何気	なにげ	nanige
集会	しゅうかい	shuukai
園内	えんない	ennnai
切望	せつぼう	setsubou
同法	どうほう	douhou
命中	めいちゅう	meityuu
借地	しゃくち	shakuchi
開会	かいかい	kaikai
発育	はついく	hatsuiku
大小	だいしょう	daishou
年代	ねんだい	nenndai
回線	かいせん	kaisenn
院長	いんちょう	inntyou
愛着	あいちゃく|あいじゃく	aityaku|aijaku
別名	べつめい|べつみょう	betsumei|betsumyou
自明	じめい	jimei
親友	しんゆう	shinnyuu
近道	ちかみち	chikamichi
決行	けっこう	kekkou
地形	ちけい|じぎょう	chikei|jigyou
風水	ふうすい	fuusui
感服	かんぷく	kannpuku
毎朝	まいあさ	maiasa
手当	てあて	teate
談笑	だんしょう	dannshou
手札	しゅさつ|てふだ	shusatsu|tefuda
無言	むごん	mugonn
上表	じょうひょう	jouhyou
有事	ゆうじ	yuuji
当面	とうめん	toumenn
美女	びじょ	bijo
意表	いひょう	ihyou
目玉	めだま	medama
白日	はくじつ	hakujitsu
直行	ちょっこう	tyokkou
実例	じつれい	jitsurei
公正	こうせい	kousei
最良	さいりょう	sairyou
地下	ちか|じげ	chika|jige
送達	そうたつ	soutatsu
食後	しょくご	shokugo
他界	たかい	takai
親指	おやゆび	oyayubi
学位	がくい	gakui
漢方	かんぽう	kannpou
中年	ちゅうねん	tyuunenn
米軍	べいぐん	beigunn
終戦	しゅうせん	shuusenn
新調	しんちょう	shinntyou
身分	みぶん	mibunn
外出	がいしゅつ	gaishutsu
日清	にっしん	nisshinn
大根	おおね|だいこん	oone|daikonn
家屋	かおく	kaoku
各界	かくかい|かっかい	kakukai|kakkai
車種	しゃしゅ	shashu
通例	つうれい	tsuurei
未満	みまん	mimann
争点	そうてん	soutenn
年号	ねんごう	nenngou
商用	しょうよう	shouyou
同人	どうじん|どうにん	doujinn|douninn
連番	れんばん	rennbann
英数	えいすう	eisuu
合宿	がっしゅく	gasshuku
何様	なにさま	nanisama
中秋	ちゅうしゅう	tyuushuu
先見	せんけん|さきみ	sennkenn|sakimi
人名	じんめい	jinnmei
折角	せっかく	sekkaku
力点	りきてん	rikitenn
血流	けつりゅう	ketsuryuu
試食	ししょく	shishoku
物議	ぶつぎ	butsugi
名医	めいい	meii
列島	れっとう	rettou
別物	べつもの	betsumono
火山	かざん	kazann
食料	しょくりょう	shokuryou
海上	かいじょう|かいしょう	kaijou|kaishou
昨今	さっこん	sakkonn
交代	こうたい	koutai
手先	てさき	tesaki
耳元	みみもと	mimimoto
風化	ふうか	fuuka
満室	まんしつ	mannshitsu
無実	むじつ	mujitsu
小鳥	ことり	kotori
宿題	しゅくだい	shukudai
功名	こうみょう	koumyou
商社	しょうしゃ	shousha
転向	てんこう	tennkou
変色	へんしょく	hennshoku
北国	きたぐに|ほっこく	kitaguni|hokkoku
静止	せいし	seishi
戦前	せんぜん	sennzenn
事案	じあん	jiann
手中	しゅちゅう	shutyuu
産科	さんか	sannka
電力	でんりょく	dennryoku
足音	あしおと	ashioto
水中	すいちゅう	suityuu
地道	じみち	jimichi
宿命	しゅくめい	shukumei
全米	ぜんべい	zennbei
飛来	ひらい	hirai
祭事	さいじ	saiji
行内	こうない	kounai
事後	じご	jigo
軽食	けいしょく	keishoku
大字	おおあざ|だいじ	ooaza|daiji
未読	みどく	midoku
返送	へんそう	hennsou
観念	かんねん	kannnenn
対等	たいとう	taitou
熱気	ねっき	nekki
野望	やぼう	yabou
主食	しゅしょく	shushoku
配当	はいとう	haitou
感知	かんち	kannchi
最小	さいしょう	saishou
早期	そうき	souki
水木	みずき	mizuki
方言	ほうげん	hougenn
後味	あとあじ	atoaji
入用	いりよう|にゅうよう	iriyou|nyuuyou
東部	とうぶ	toubu
重箱	じゅうばこ	juubako
木立	こだち	kodachi
用心	ようじん	youjinn
内見	ないけん	naikenn
完食	かんしょく	kannshoku
街道	かいどう	kaidou
電池	でんち	dennchi
赤鼻	あかばな|あかはな	akabana|akahana
年度	ねんど	nenndo
天下	てんか|あまくだ|でんか|てんげ	tennka|amakuda|dennka|tennge
詩人	しじん	shijinn
月間	げっかん	gekkann
東日	とうにち	tounichi
筆頭	ひっとう|ふでがしら	hittou|fudegashira
今号	こんごう	konngou
風土	ふうど|ふど	fuudo|fudo
心地	ここち|ごこち|しんじ	kokochi|gokochi|shinnji
次号	じごう	jigou
主力	しゅりょく	shuryoku
発案	はつあん	hatsuann
合唱	がっしょう	gasshou
西側	にしがわ	nishigawa
同紙	どうし	doushi
無数	むすう|むしゅ	musuu|mushu
共用	きょうよう	kyouyou
新卒	しんそつ	shinnsotsu
後進	こうしん	koushinn
高配	こうはい	kouhai
実話	じつわ	jitsuwa
給付	きゅうふ	kyuufu
毛頭	もうとう	moutou
入門	にゅうもん	nyuumonn
年金	ねんきん	nennkinn
入歯	いれば	ireba
多幸	たこう	takou
水道	すいどう|みずみち	suidou|mizumichi
花束	はなたば	hanataba
女心	おんなごころ	onnnagokoro
整然	せいぜん	seizenn
速度	そくど	sokudo
転入	てんにゅう	tennnyuu
小屋	こや|ごや|しょうおく	koya|goya|shouoku
南東	なんとう	nanntou
南下	なんか	nannka
信徒	しんと	shinnto
芸人	げいにん	geininn
養育	よういく	youiku
印字	いんじ	innji
先月	せんげつ	senngetsu
別送	べっそう	bessou
正午	しょうご	shougo
消息	しょうそく	shousoku
反日	はんにち	hannnichi
集落	しゅうらく	shuuraku
原本	げんぽん	gennponn
時候	じこう	jikou
面談	めんだん	menndann
開校	かいこう	kaikou
文例	ぶんれい	bunnrei
何色	なにいろ	naniiro
市区	しく	shiku
同会	どうかい	doukai
地番	ちばん	chibann
悪者	わるもの	warumono
強固	きょうこ	kyouko
付帯	ふたい	futai
風来	ふうらい	fuurai
食塩	しょくえん	shokuenn
始発	しはつ	shihatsu
和室	わしつ	washitsu
果物	くだもの	kudamono
気持	きもち	kimochi
交配	こうはい	kouhai
本学	ほんがく	honngaku
区間	くかん	kukann
直進	ちょくしん	tyokushinn
出船	しゅっせん|でふね|でぶね	shussenn|defune|debune
用例	ようれい	yourei
氷山	ひょうざん	hyouzann
新種	しんしゅ	shinnshu
新橋	しんばし	shinnbashi
語学	ごがく|ごがっ	gogaku|gogaxtu
言動	げんどう	genndou
南側	みなみがわ	minamigawa
薬事	やくじ	yakuji
売主	うりぬし	urinushi
名残	なごり	nagori
機体	きたい	kitai
元本	がんぽん	gannponn
通話	つうわ	tsuuwa
通行	つうこう	tsuukou
目頭	めがしら	megashira
本意	ほんい	honni
組立	くみたて	kumitate
通関	つうかん	tsuukann
熱戦	ねっせん	nessenn
口実	こうじつ	koujitsu
外側	そとがわ	sotogawa
結末	けつまつ	ketsumatsu
半生	はんせい|はんしょう|はんなま	hannsei|hannshou|hannnama
他県	たけん	takenn
学院	がくいん	gakuinn
和式	わしき	washiki
石油	せきゆ	sekiyu
太古	たいこ	taiko
海辺	うみべ|かいへん	umibe|kaihenn
同然	どうぜん	douzenn
当科	とうか	touka
空色	そらいろ	sorairo
王子	おうじ	ouji
先決	せんけつ	sennketsu
炭火	すみび	sumibi
中火	ちゅうび	tyuubi
南西	なんせい	nannsei
白馬	しろうま|はくば	shirouma|hakuba
連立	れんりつ	rennritsu
同調	どうちょう	doutyou
赤色	あかいろ|せきしょく	akairo|sekishoku
代物	しろもの|だいぶつ|だいもつ	shiromono|daibutsu|daimotsu
放牧	ほうぼく	houboku
反感	はんかん	hannkann
下水	げすい|したみず	gesui|shitamizu
本部	ほんぶ	honnbu
熱望	ねつぼう	netsubou
下表	かひょう	kahyou
所見	しょけん	shokenn
好物	こうぶつ	koubutsu
節分	せつぶん	setsubunn
足手	あしで	ashide
人前	にんまえ|ひとまえ	ninnmae|hitomae
本会	ほんかい	honnkai
元来	がんらい	gannrai
東側	ひがしがわ	higashigawa
苦言	くげん	kugenn
古典	こてん	kotenn
開場	かいじょう	kaijou
小耳	こみみ	komimi
極道	ごくどう	gokudou
進入	しんにゅう	shinnnyuu
不用	ふよう	fuyou
続発	ぞくはつ	zokuhatsu
多量	たりょう	taryou
手本	てほん|でほん	tehonn|dehonn
組合	くみあい	kumiai
入試	にゅうし	nyuushi
下味	したあじ	shitaaji
加熱	かねつ	kanetsu
愛飲	あいいん	aiinn
近世	きんせい	kinnsei
所管	しょかん	shokann
前期	ぜんき	zennki
口元	くちもと	kuchimoto
言明	げんめい	gennmei
市部	しぶ	shibu
前作	ぜんさく	zennsaku
合図	あいず	aizu
付記	ふき	fuki
命運	めいうん	meiunn
行頭	ぎょうとう	gyoutou
指数	しすう	shisuu
路上	ろじょう	rojou
大体	だいたい	daitai
線引	せんびき	sennbiki
重量	じゅうりょう	juuryou
便所	べんじょ	bennjo
高温	こうおん	kouonn
配列	はいれつ	hairetsu
伝送	でんそう	dennsou
初見	しょけん	shokenn
里山	さとやま	satoyama
正気	しょうき|せいき	shouki|seiki
新子	しんこ	shinnko
配付	はいふ	haifu
線上	せんじょう	sennjou
待受	まちうけ	machiuke
乗船	じょうせん	jousenn
量産	りょうさん	ryousann
流星	ながれぼし|りゅうせい	nagareboshi|ryuusei
直筆	じきひつ|ちょくひつ	jikihitsu|tyokuhitsu
登校	とうこう	toukou
新米	しんまい	shinnmai
売店	ばいてん	baitenn
中日	ちゅうにち|なかび	tyuunichi|nakabi
法的	ほうてき	houteki
同日	どうじつ	doujitsu
心血	しんけつ	shinnketsu
夕飯	ゆうはん|ゆうめし	yuuhann|yuumeshi
散会	さんかい	sannkai
歌手	かしゅ	kashu
試着	しちゃく	shityaku
和英	わえい	waei
落選	らくせん	rakusenn
小人	こども|こびと|しょうにん|しょうじん	kodomo|kobito|shouninn|shoujinn
競合	きょうごう	kyougou
上流	じょうりゅう	jouryuu
全焼	ぜんしょう	zennshou
林立	りんりつ	rinnritsu
後場	ごば	goba
鉄板	てっぱん	teppann
出走	しゅっそう	shussou
地味	じみ|ちみ	jimi|chimi
配管	はいかん	haikann
童話	どうわ	douwa
後手	ごて|うしろで	gote|ushirode
所以	ゆえん	yuenn
風習	ふうしゅう	fuushuu
強風	きょうふう	kyoufuu
答申	とうしん	toushinn
読物	よみもの	yomimono
画材	がざい	gazai
着服	ちゃくふく	tyakufuku
方面	ほうめん	houmenn
外食	がいしょく	gaishoku
無知	むち	muchi
発電	はつでん	hatsudenn
反旗	はんき	hannki
建機	けんき	kennki
香料	こうりょう	kouryou
悪寒	おかん	okann
必読	ひつどく	hitsudoku
協同	きょうどう	kyoudou
外来	がいらい	gairai
新法	しんぽう	shinnpou
不良	ふりょう	furyou
上着	うわぎ	uwagi
音色	おんしょく|ねいろ	onnshoku|neiro
声高	こわだか	kowadaka
牧場	ぼくじょう|まきば	bokujou|makiba
白紙	はくし|しらかみ	hakushi|shirakami
大方	おおかた|たいほう|だいほう	ookata|taihou|daihou
鳥取	とっとり	tottori
下線	かせん	kasenn
湯水	ゆみず	yumizu
日別	ひべつ	hibetsu
必然	ひつぜん	hitsuzenn
不意	ふい	fui
死後	しご	shigo
式典	しきてん	shikitenn
手芸	しゅげい	shugei
時給	じきゅう	jikyuu
悪気	わるぎ	warugi
黄金	おうごん|こがね	ougonn|kogane
理事	りじ	riji
特養	とくよう	tokuyou
単身	たんしん	tannshinn
始動	しどう	shidou
予選	よせん	yosenn
敗北	はいぼく	haiboku
次男	じなん	jinann
行者	ぎょうじゃ	gyouja
内外	ないがい|うちそと	naigai|uchisoto
協定	きょうてい	kyoutei
化石	かせき	kaseki
空手	からて|そらで|くうしゅ	karate|sorade|kuushu
不調	ふちょう|ぶちょう	futyou|butyou
少量	しょうりょう	shouryou
残高	ざんだか	zanndaka
表内	ひょうない	hyounai
酒場	さかば	sakaba
工法	こうほう	kouhou
屋号	やごう	yagou
音頭	おんど	onndo
北西	ほくせい	hokusei
全戸	ぜんこ	zennko
公平	こうへい	kouhei
屋外	おくがい	okugai
落語	らくご	rakugo
連中	れんちゅう|れんじゅう	renntyuu|rennjuu
人参	にんじん	ninnjinn
赤線	あかせん	akasenn
満車	まんしゃ	mannsha
牛肉	ぎゅうにく	gyuuniku
緑色	みどりいろ|りょくしょく	midoriiro|ryokushoku
英日	えいにち	einichi
左上	ひだりうえ	hidariue
祭日	さいじつ	saijitsu
年間	ねんかん	nennkann
下宿	げしゅく	geshuku
民法	みんぽう	minnpou
発赤	はっせき|ほっせき	hasseki|hosseki
目先	めさき	mesaki
血相	けっそう	kessou
害虫	がいちゅう	gaityuu
気心	きごころ	kigokoro
公約	こうやく	kouyaku
風上	かざかみ	kazakami
信教	しんきょう	shinnkyou
出向	しゅっこう|でむけ	shukkou|demuke
昼間	ひるま|ぴるま|ちゅうかん	hiruma|piruma|tyuukann
主文	しゅぶん	shubunn
用命	ようめい	youmei
各駅	かくえき	kakueki
金運	きんうん	kinnunn
方角	ほうがく	hougaku
関知	かんち	kannchi
野鳥	やちょう	yatyou
着陸	ちゃくりく	tyakuriku
通算	つうさん	tsuusann
反戦	はんせん	hannsenn
知見	ちけん	chikenn
薬用	やくよう	yakuyou
何千	なんぜん	nannzenn
府令	ふれい	furei
産声	うぶごえ	ubugoe
室数	しつすう	shitsusuu
試作	しさく	shisaku
国道	こくどう	kokudou
回想	かいそう	kaisou
薬草	やくそう	yakusou
高卒	こうそつ	kousotsu
入園	にゅうえん	nyuuenn
先人	せんじん	sennjinn
知育	ちいく	chiiku
順次	じゅんじ	junnji
光栄	こうえい	kouei
月数	げっすう|つきすう	gessuu|tsukisuu
軽量	けいりょう	keiryou
西部	せいぶ	seibu
初耳	はつみみ	hatsumimi
別表	べっぴょう	beppyou
医薬	いやく	iyaku
公的	こうてき	kouteki
治安	ちあん	chiann
受章	じゅしょう	jushou
生足	なまあし	namaashi
本数	ほんすう	honnsuu
大輪	たいりん|だいりん	tairinn|dairinn
短信	たんしん	tannshinn
期末	きまつ	kimatsu
文明	ぶんめい	bunnmei
土工	どこう	dokou
球場	きゅうじょう	kyuujou
区画	くかく	kukaku
礼節	れいせつ	reisetsu
発火	はっか	hakka
建国	けんこく	kennkoku
屋台	やたい	yatai
先代	せんだい	senndai
後期	こうき	kouki
実印	じついん	jitsuinn
着想	ちゃくそう	tyakusou
名手	めいしゅ	meishu
労力	ろうりょく	rouryoku
南北	なんぼく	nannboku
弱点	じゃくてん	jakutenn
方位	ほうい	houi
夜間	やかん	yakann
器材	きざい	kizai
決死	けっし	kesshi
右図	うず	uzu
同化	どうか	douka
山道	さんどう|やまみち	sanndou|yamamichi
寺伝	じでん	jidenn
司法	しほう	shihou
積雪	せきせつ	sekisetsu
主観	しゅかん	shukann
新宮	しんぐう|しんみや	shinnguu|shinnmiya
白衣	はくい|びゃくえ|びゃくい	hakui|byakue|byakui
機運	きうん	kiunn
発毛	はつもう	hatsumou
空席	くうせき	kuuseki
大台	おおだい	oodai
品番	ひんばん|しなばん	hinnbann|shinabann
味見	あじみ	ajimi
発進	はっしん	hasshinn
試練	しれん	shirenn
死角	しかく	shikaku
配分	はいぶん	haibunn
指先	ゆびさき	yubisaki
緑茶	りょくちゃ	ryokutya
産出	さんしゅつ	sannshutsu
集成	しゅうせい	shuusei
分配	ぶんぱい	bunnpai
主菜	しゅさい	shusai
無礼	ぶれい	burei
細工	さいく|ざいく	saiku|zaiku
古都	こと	koto
足場	あしば	ashiba
入港	にゅうこう	nyuukou
歩道	ほどう	hodou
少子	しょうし	shoushi
自他	じた	jita
予習	よしゅう	yoshuu
民家	みんか	minnka
先物	さきもの	sakimono
機材	きざい	kizai
火星	かせい	kasei
活魚	いけうお|かつぎょ	ikeuo|katsugyo
有様	ありさま	arisama
鼻水	はなみず	hanamizu
祝辞	しゅくじ	shukuji
昔話	むかしばなし	mukashibanashi
着工	ちゃっこう	tyakkou
発熱	はつねつ	hatsunetsu
無用	むよう	muyou
重用	じゅうよう|ちょうよう|じゅいよう	juuyou|tyouyou|juiyou
県下	けんか	kennka
左図	さず	sazu
線香	せんこう	sennkou
次代	じだい	jidai
明細	めいさい	meisai
英文	えいぶん	eibunn
行進	こうしん	koushinn
無休	むきゅう	mukyuu
公然	こうぜん	kouzenn
包帯	ほうたい	houtai
祭神	さいじん	saijinn
家臣	かしん	kashinn
出世	しゅっせ	shusse
首長	しゅちょう	shutyou
里親	さとおや	satooya
中世	ちゅうせい	tyuusei
歩調	ほちょう	hotyou
作中	さくちゅう	sakutyuu
庭園	ていえん	teienn
極力	きょくりょく	kyokuryoku
肉体	にくたい	nikutai
名湯	めいとう	meitou
副菜	ふくさい	fukusai
同省	どうしょう	doushou
悪運	あくうん	akuunn
線路	せんろ	sennro
説教	せっきょう	sekkyou
下火	したび	shitabi
他方	たほう	tahou
雨音	あまおと	amaoto
道標	どうひょう|みちしるべ	douhyou|michishirube
雨雲	あまぐも	amagumo
羽根	はね|ばね	hane|bane
大臣	だいじん|おおおみ|おとど	daijinn|ooomi|otodo
山海	さんかい	sannkai
金星	きんぼし	kinnboshi
季語	きご	kigo
山行	さんこう	sannkou
選別	せんべつ	sennbetsu
弱気	よわき	yowaki
強大	きょうだい	kyoudai
心中	しんじゅう|しんちゅう	shinnjuu|shinntyuu
器具	きぐ	kigu
同定	どうてい	doutei
海岸	かいがん|うみぎし	kaigann|umigishi
左下	ひだりした	hidarishita
未見	みけん	mikenn
対極	たいきょく	taikyoku
低温	ていおん	teionn
発着	はっちゃく	hattyaku
着信	ちゃくしん	tyakushinn
元手	もとで	motode
父母	ちちはは|ふぼ	chichihaha|fubo
平等	びょうどう	byoudou
必定	ひつじょう	hitsujou
庭木	にわき	niwaki
入部	にゅうぶ	nyuubu
衣服	いふく	ifuku
熱唱	ねっしょう	nesshou
死神	しにがみ	shinigami
口数	くちかず|こうすう|くちすう	kuchikazu|kousuu|kuchisuu
特例	とくれい	tokurei
奈落	ならく	naraku
県別	けんべつ	kennbetsu
電流	でんりゅう	dennryuu
社伝	しゃでん	shadenn
敗戦	はいせん	haisenn
品切	しなぎれ	shinagire
定説	ていせつ	teisetsu
金員	きんいん	kinninn
暗号	あんごう	anngou
時差	じさ	jisa
勝敗	しょうはい	shouhai
上空	じょうくう	joukuu
最期	さいご	saigo
寒空	さむぞら	samuzora
急変	きゅうへん	kyuuhenn
出火	しゅっか	shukka
使役	しえき	shieki
家路	いえじ	ieji
末日	まつじつ	matsujitsu
曲目	きょくもく	kyokumoku
同校	どうこう	doukou
親族	しんぞく	shinnzoku
屋内	おくない	okunai
火気	かき	kaki
連帯	れんたい	renntai
転機	てんき	tennki
熱湯	ねっとう|あつゆ	nettou|atsuyu
東洋	とうよう	touyou
首都	しゅと	shuto
民話	みんわ	minnwa
安住	あんじゅう	annjuu
口火	くちび	kuchibi
書庫	しょこ	shoko
点字	てんじ	tennji
出血	しゅっけつ|でち	shukketsu|dechi
発車	はっしゃ	hassha
定期	ていき	teiki
死人	しにん|しびと	shininn|shibito
実習	じっしゅう	jisshuu
月末	げつまつ|つきずえ	getsumatsu|tsukizue
路地	ろじ	roji
果実	かじつ	kajitsu
急登	きゅうとう	kyuutou
白地	しらじ|しろじ	shiraji|shiroji
談話	だんわ	dannwa
大鹿	おおしか	ooshika
時流	じりゅう	jiryuu
氷風	ひょうふう	hyoufuu
法案	ほうあん	houann
期日	きじつ	kijitsu
調教	ちょうきょう	tyoukyou
産直	さんちょく	sanntyoku
茶葉	ちゃば	tyaba
号泣	ごうきゅう	goukyuu
岐路	きろ	kiro
薬指	くすりゆび	kusuriyubi
世帯	しょたい|せたい|じょたい	shotai|setai|jotai
細道	ほそみち	hosomichi
選考	せんこう	sennkou
転写	てんしゃ	tennsha
観月	かんげつ	kanngetsu
次会	じかい	jikai
花茶	はなちゃ	hanatya
急落	きゅうらく	kyuuraku
生死	せいし|しょうし|しょうじ	seishi|shoushi|shouji
具材	ぐざい	guzai
道楽	どうらく	douraku
出馬	しゅつば	shutsuba
滋養	じよう	jiyou
行楽	こうらく	kouraku
大雪	おおゆき|たいせつ	ooyuki|taisetsu
生身	なまみ	namami
教科	きょうか	kyouka
洋風	ようふう	youfuu
新芽	しんめ	shinnme
歯肉	はにく	haniku
年上	としうえ	toshiue
銀色	ぎんいろ|ぎんしょく	ginniro|ginnshoku
山菜	さんさい	sannsai
無残	むざん	muzann
森林	しんりん	shinnrinn
新店	しんみせ	shinnmise
筆順	ひつじゅん	hitsujunn
用具	ようぐ	yougu
首席	しゅせき	shuseki
面会	めんかい	mennkai
医科	いか	ika
上図	じょうず	jouzu
太字	ふとじ	futoji
育毛	いくもう	ikumou
辞表	じひょう	jihyou
中小	ちゅうしょう	tyuushou
合同	ごうどう	goudou
人手	ひとで	hitode
欠席	けっせき	kesseki
定住	ていじゅう	teijuu
学年	がくねん	gakunenn
有害	ゆうがい	yuugai
天命	てんめい	tennmei
新語	しんご	shinngo
清流	せいりゅう	seiryuu
天文	てんもん	tennmonn
利口	りこう	rikou
例会	れいかい	reikai
対岸	たいがん	taigann
初物	はつもの	hatsumono
交点	こうてん	koutenn
文頭	ぶんとう	bunntou
植林	しょくりん	shokurinn
今来	こんらい	konnrai
必着	ひっちゃく	hittyaku
来校	らいこう	raikou
苦虫	にがむし	nigamushi
男湯	おとこゆ	otokoyu
別紙	べっし	besshi
月給	げっきゅう	gekkyuu
仕草	しぐさ	shigusa
植毛	しょくもう	shokumou
少林	しょうりん	shourinn
薬店	やくてん	yakutenn
重体	じゅうたい	juutai
口車	くちぐるま	kuchiguruma
伝来	でんらい	dennrai
街角	まちかど	machikado
例文	れいぶん	reibunn
小首	こくび	kokubi
世相	せそう	sesou
下町	したまち	shitamachi
有数	ゆうすう	yuusuu
局面	きょくめん	kyokumenn
発出	はっしゅつ	hasshutsu
洋室	ようしつ	youshitsu
他国	たこく	takoku
浴用	よくよう	yokuyou
里田	さとだ	satoda
丁度	ちょうど	tyoudo
借景	しゃっけい	shakkei
子分	こぶん	kobunn
良貨	りょうか	ryouka
糸目	いとめ	itome
王道	おうどう	oudou
兆候	ちょうこう	tyoukou
冬季	とうき	touki
夏期	かき	kaki
手引	てびき	tebiki
転記	てんき	tennki
置物	おきもの	okimono
買上	かいあげ	kaiage
中庭	なかにわ	nakaniwa
入庫	にゅうこ	nyuuko
飲茶	やむちゃ|いんさ	yamutya|innsa
生体	せいたい	seitai
愛国	あいこく	aikoku
着地	ちゃくち	tyakuchi
全駅	ぜんえき	zenneki
白熱	はくねつ	hakunetsu
挙手	きょしゅ	kyoshu
両側	りょうがわ|りょうそく	ryougawa|ryousoku
同市	どうし	doushi
商店	しょうてん	shoutenn
城主	じょうしゅ	joushu
同作	どうさく	dousaku
白雪	しらゆき|はくせつ	shirayuki|hakusetsu
西洋	せいよう	seiyou
外伝	がいでん	gaidenn
放火	ほうか	houka
遊学	ゆうがく	yuugaku
農村	のうそん	nousonn
福北	ふくほく	fukuhoku
階数	かいすう	kaisuu
名勝	めいしょう	meishou
参道	さんどう	sanndou
手形	てがた	tegata
王手	おうて	oute
母子	ぼし|ははこ	boshi|hahako
外字	がいじ	gaiji
塩分	えんぶん	ennbunn
運気	うんき	unnki
和歌	わか	waka
大気	たいき	taiki
整地	せいち	seichi
商号	しょうごう	shougou
目深	まぶか	mabuka
下位	かい	kai
通説	つうせつ	tsuusetsu
産生	さんせい	sannsei
前節	ぜんせつ	zennsetsu
良心	りょうしん	ryoushinn
新春	しんしゅん	shinnshunn
白菜	はくさい|しろな	hakusai|shirona
不通	ふつう	futsuu
頭角	とうかく	toukaku
役所	やくしょ|やくどとろ|やくどころ	yakusho|yakudotoro|yakudokoro
急所	きゅうしょ	kyuusho
浴場	よくじょう	yokujou
手塩	てしお	teshio
丁重	ていちょう	teityou
出鼻	でっぱな|でばな	deppana|debana
悲願	ひがん	higann
動転	どうてん	doutenn
表中	ひょうちゅう	hyoutyuu
少数	しょうすう	shousuu
今季	こんき	konnki
冷水	ひやみず|れいすい	hiyamizu|reisui
血管	けっかん	kekkann
平静	へいせい	heisei
健食	けんしょく	kennshoku
車内	しゃない	shanai
力強	ちからづよ	chikaraduyo
農地	のうち	nouchi
立木	たちき|りゅうぼく	tachiki|ryuuboku
主夫	しゅふ	shufu
民度	みんど	minndo
類語	るいご	ruigo
出生	しゅっしょう|しゅっせい	shusshou|shussei
身元	みもと	mimoto
気功	きこう	kikou
島式	しましき	shimashiki
発光	はっこう	hakkou
無力	むりょく	muryoku
希求	ききゅう|けく|けぐ	kikyuu|keku|kegu
要所	ようしょ	yousho
車道	しゃどう	shadou
今風	いまふう	imafuu
美食	びしょく	bishoku
汽車	きしゃ|ぎしゃ	kisha|gisha
県名	けんめい	kennmei
湯船	ゆぶね	yubune
終売	しゅうばい	shuubai
学長	がくちょう	gakutyou
文体	ぶんたい	bunntai
横顔	よこがお	yokogao
酒店	さけてん|しゅてん	saketenn|shutenn
木材	もくざい	mokuzai
温湯	おんとう|ぬるゆ	onntou|nuruyu
国別	くにべつ	kunibetsu
時分	じぶん	jibunn
力量	りきりょう	rikiryou
仕入	しいれ	shiire
国旗	こっき	kokki
門出	かどで	kadode
校長	こうちょう	koutyou
流水	りゅうすい	ryuusui
特売	とくばい	tokubai
乗客	じょうきゃく	joukyaku
花輪	はなわ	hanawa
水虫	みずむし	mizumushi
各校	かくこう|かっこう	kakukou|kakkou
苦心	くしん	kushinn
法要	ほうよう	houyou
縄文	じょうもん	joumonn
弱者	じゃくしゃ	jakusha
大陸	たいりく	tairiku
文人	ぶんじん	bunnjinn
登用	とうよう	touyou
大空	おおぞら	oozora
法相	ほうしょう|ほっそう	houshou|hossou
列記	れっき	rekki
後学	こうがく	kougaku
未練	みれん	mirenn
人民	じんみん	jinnminn
明暗	めいあん	meiann
失意	しつい	shitsui
初級	しょきゅう	shokyuu
半日	はんにち|はんじつ	hannnichi|hannjitsu
村長	そんちょう|むらおさ	sonntyou|muraosa
底力	そこぢから	sokodikara
養生	ようじょう	youjou
品名	ひんめい	hinnmei
決戦	けっせん	kessenn
満員	まんいん	manninn
美男	びなん	binann
食道	しょくどう	shokudou
申立	もうしたて	moushitate
青字	あおじ	aoji
残金	ざんきん	zannkinn
車輪	しゃりん	sharinn
共産	きょうさん	kyousann
小生	しょうせい	shousei
童心	どうしん	doushinn
官位	かんい	kanni
本機	ほんき	honnki
英字	えいじ	eiji
神主	かんぬし	kannnushi
室長	しつちょう	shitsutyou
親元	おやもと	oyamoto
続投	ぞくとう	zokutou
軍隊	ぐんたい	gunntai
美化	びか	bika
目上	めうえ	meue
熱愛	ねつあい	netsuai
進言	しんげん	shinngenn
改悪	かいあく	kaiaku
乗用	じょうよう	jouyou
公算	こうさん	kousann
年式	ねんしき	nennshiki
試乗	しじょう	shijou
空路	くうろ	kuuro
思う	おもう	omou
言う	いう|ゆう	iu|yuu
行く	いく|ゆく	iku|yuku
思い	おもい	omoi
良い	いい|よい	ii|yoi
書く	かく|がく	kaku|gaku
入る	いる|はいる|いれる	iru|hairu|ireru
使う	つかう|つこう	tsukau|tsukou
見る	みる	miru
感じ	かんじ	kannji
知る	しる	shiru
持つ	もつ	motsu
考え	かんがえ	kanngae
読む	よむ	yomu
下さる	くださる	kudasaru
聞く	きく|ぎく	kiku|giku
無い	ない	nai
食べる	たべる	taberu
問い合わせ	といあわせ	toiawase
同じ	おなじ|どうじ|おんなじ	onaji|douji|onnnaji
買う	かう|こう	kau|kou
好き	すき|こうき|よき|ずき	suki|kouki|yoki|zuki
多い	おおい	ooi
作る	つくる|づくる	tsukuru|dukuru
その他	そのた	sonota
入れる	いれる|はいれる	ireru|haireru
受ける	うける	ukeru
行う	おこなう|おこのう	okonau|okonou
高い	たかい|こうい|だかい	takai|koui|dakai
お願い	おねがい	onegai
多く	おおく	ooku
少し	すこし|しょうし|すくなし	sukoshi|shoushi|sukunashi
続く	つづく	tsuduku
出す	だす|いだす	dasu|idasu
分かる	わかる	wakaru
大きい	おおきい	ookii
悪い	わるい|わりい|わろい	warui|warii|waroi
楽しい	たのしい	tanoshii
帰る	かえる|がえる	kaeru|gaeru
取る	とる|どる	toru|doru
終わる	おわる	owaru
変わる	かわる	kawaru
本当に	ほんとうに	honntouni
強い	つよい|しい|こわい|じい|づよい	tsuyoi|shii|kowai|jii|duyoi
お客様	おきゃくさま	okyakusama
新しい	あたらしい	atarashii
向け	むけ	muke
教え	おしえ	oshie
初めて	はじめて	hajimete
飲む	のむ	nomu
早い	はやい|ばやい	hayai|bayai
特に	とくに	tokuni
大きな	おおきな	ookina
一つ	ひとつ	hitotsu
続ける	つづける	tsudukeru
見え	みえ|まみえ	mie|mamie
通り	とおり|どおり	toori|doori
言える	いえる|ゆえる	ieru|yueru
始め	はじめ	hajime
全て	すべて	subete
楽しみ	たのしみ	tanoshimi
近く	ちかく|じかく	chikaku|jikaku
少ない	すくない|ずくない	sukunai|zukunai
気持ち	きもち	kimochi
求める	もとめる	motomeru
その後	そのご|そのあと	sonogo|sonoato
送る	おくる	okuru
子ども	こども	kodomo
生きる	いきる	ikiru
考える	かんがえる	kanngaeru
話す	はなす|ばなす	hanasu|banasu
お知らせ	おしらせ	oshirase
長い	ながい	nagai
面白い	おもしろい	omoshiroi
出来る	できる	dekiru
来る	きたる|くる	kitaru|kuru
流れ	ながれ|ながれれ	nagare|nagarere
出る	でる|いでる|いづる	deru|ideru|iduru
使い	つかい|づかい|つかわい	tsukai|dukai|tsukawai
選ぶ	えらぶ	erabu
置く	おく	oku
待つ	まつ	matsu
向かう	むかう	mukau
乗る	のる	noru
進む	すすむ	susumu
語る	かたる|がたる	kataru|gataru
お気に入り	おきにいり	okiniiri
お前	おまえ	omae
付け	つけ|づけ	tsuke|duke
売る	うる	uru
残る	のこる	nokoru
付き	つき|づき	tsuki|duki
美しい	うつくしい	utsukushii
死ぬ	しぬ|じぬ	shinu|jinu
歩く	あるく|ありく	aruku|ariku
合わせる	あわせる	awaseru
美味しい	おいしい	oishii
全く	まったく	mattaku
目指す	めざす	mezasu
走る	はしる|ばしる|ぱしる	hashiru|bashiru|pashiru
作り	つくり|づくり	tsukuri|dukuri
実は	じつは	jitsuha
開く	あく|ひらく|びらく|ぴらく	aku|hiraku|biraku|piraku
会う	あう|おう	au|ou
必ず	かならず	kanarazu
変える	かえる	kaeru
生まれ	うまれ	umare
見せる	みせる	miseru
見える	まみえる|みえる	mamieru|mieru
大好き	だいすき	daisuki
小さい	ちいさい|こさい	chiisai|kosai
始まる	はじまる	hajimaru
近い	ちかい	chikai
行い	おこない|こうい|ゆい	okonai|koui|yui
安い	やすい|やしい	yasui|yashii
名無し	ななし	nanashi
出会い	であい	deai
覚える	おぼえる	oboeru
住む	すむ	sumu
合う	あう|おう	au|ou
小さな	ちいさな	chiisana
上げ	あげ	age
見つける	みつける	mitsukeru
起きる	おきる	okiru
立つ	たつ|だつ	tatsu|datsu
有る	ある|はべる	aru|haberu
打つ	うつ|ぶつ	utsu|butsu
加える	くわえる	kuwaeru
上がる	あがる	agaru
答え	こたえ|いらえ|ごたえ	kotae|irae|gotae
決め	きめ|ぎめ	kime|gime
決まる	きまる	kimaru
用いる	もちいる	mochiiru
付く	つく|づく	tsuku|duku
残す	のこす	nokosu
新た	あらた	arata
守る	まもる|もる	mamoru|moru
深い	ふかい|ぶかい|しんい	fukai|bukai|shinni
動き	うごき	ugoki
落ち	おち	ochi
お金	おかね	okane
幸せ	しあわせ	shiawase
調べ	しらべ	shirabe
負け	まけ	make
進める	すすめる	susumeru
明らか	あきらか	akiraka
遊び	あそび|すさび	asobi|susabi
広い	ひろい	hiroi
最も	もっとも|いとも	mottomo|itomo
楽しめる	たのしめる	tanoshimeru
祭り	まつり	matsuri
思い出す	おもいだす	omoidasu
動く	うごく	ugoku
願う	ねがう|ねごう	negau|negou
切る	きる|ぎる	kiru|giru
お話	おはなし	ohanashi
感じる	かんじる	kannjiru
信じる	しんじる	shinnjiru
低い	ひくい|ひきい	hikui|hikii
働く	はたらく|ばたらく	hataraku|bataraku
同時に	どうじに	doujini
笑う	わらう|わろう	warau|warou
歌う	うたう|うとう	utau|utou
休み	やすみ	yasumi
周り	まわり	mawari
学ぶ	まなぶ|まねぶ	manabu|manebu
問合せ	といあわせ	toiawase
勝つ	かつ|がつ|まさつ	katsu|gatsu|masatsu
見つかる	みつかる	mitsukaru
起こる	おこる	okoru
食う	くう|ぐう	kuu|guu
買い物	かいもの	kaimono
立て	たて|だて	tate|date
例えば	たとえば	tatoeba
消える	きえる|ぎえる	kieru|gieru
香り	かおり	kaori
知れる	しれる	shireru
軽い	かるい|けいい|かりい	karui|keii|karii
伝え	つたえ|づたえ	tsutae|dutae
止め	とどめ|とめ|やめ|どめ	todome|tome|yame|dome
通る	とおる	tooru
遊ぶ	あそぶ|すさぶ	asobu|susabu
飛ぶ	とぶ	tobu
役立つ	やくだつ	yakudatsu
自ら	みずから|じら	mizukara|jira
見れる	みれる	mireru
白い	しろい|じろい	shiroi|jiroi
流す	ながす	nagasu
一戸建て	いっこだて	ikkodate
住まい	すまい|ずまい	sumai|zumai
連れ	つれ|づれ	tsure|dure
焼き	やき|たき	yaki|taki
気づく	きづく	kiduku
女の子	おんなのこ	onnnanoko
集め	あつめ	atsume
試し	ためし|だめし	tameshi|dameshi
明るい	あかるい	akarui
落とす	おとす	otosu
お待ち	おまち	omachi
申し上げる	もうしあげる	moushiageru
寒い	さむい|さぶい|さみい|さびい	samui|sabui|samii|sabii
古い	ふるい|ふりい	furui|furii
開ける	あける|ひらける|はだける	akeru|hirakeru|hadakeru
集まる	あつまる	atsumaru
起こす	おこす	okosu
選び	えらび	erabi
借りる	かりる|がりる	kariru|gariru
聞こえる	きこえる	kikoeru
お客	おきゃく	okyaku
次に	つぎに	tsugini
当たる	あたる	ataru
正しい	ただしい|まさしい	tadashii|masashii
歩き	あるき|ありき	aruki|ariki
使える	つかえる	tsukaeru
始まり	はじまり	hajimari
切れ	きれ|ぎれ	kire|gire
育てる	そだてる	sodateru
止まる	とまる|どまる|とどまる	tomaru|domaru|todomaru
別に	べつに	betsuni
失う	うしなう|うしのう|のう	ushinau|ushinou|nou
残り	のこり	nokori
後ろ	うしろ	ushiro
ご飯	ごはん	gohann
楽しむ	たのしむ	tanoshimu
図る	はかる	hakaru
戦い	たたかい|おののい|そよい	tatakai|ononoi|soyoi
暑い	あつい|あちい	atsui|achii
赤い	あかい	akai
引く	ひく|びく|ぴく	hiku|biku|piku
使い方	つかいかた	tsukaikata
熱い	あつい|あちい	atsui|achii
生じる	しょうじる	shoujiru
建てる	たてる|だてる	tateru|dateru
引き	ひき|びき|ぴき	hiki|biki|piki
もう少し	もうすこし	mousukoshi
弱い	よわい	yowai
関わる	かかわる	kakawaru
子育て	こそだて	kosodate
短い	みじかい	mijikai
静か	しずか	shizuka
考え方	かんがえかた	kanngaekata
好み	このみ|ごのみ	konomi|gonomi
広がる	ひろがる	hirogaru
返す	かえす|がえす	kaesu|gaesu
立ち	たち|だち	tachi|dachi
回る	まわる|めぐる	mawaru|meguru
分ける	わける	wakeru
始める	はじめる	hajimeru
決して	けっして|けして	kesshite|keshite
何とか	なんとか	nanntoka
重い	おもい	omoi
伝わる	つたわる	tsutawaru
お茶	おちゃ	otya
勝ち	かち|がち	kachi|gachi
定める	さだめる	sadameru
当たり	あたり	atari
係る	かかる|かかわる	kakaru|kakawaru
二つ	ふたつ	futatsu
出会う	であう|でおう	deau|deou
登る	のぼる	noboru
手続き	てつづき	tetsuduki
取り組み	とりくみ	torikumi
足る	たる	taru
問う	とう	tou
取り組む	とりくむ	torikumu
思い出	おもいで|おもいいづ	omoide|omoiidu
分の	ぶんの	bunnno
泣く	なく	naku
行なう	おこなう	okonau
落ち着く	おちつく	ochitsuku
投げる	なげる	nageru
終える	おえる	oeru
辺り	あたり	atari
上手い	うまい	umai
代わり	かわり|がわり	kawari|gawari
笑い	わらい	warai
お世話	おせわ	osewa
追う	おう	ou
気に入る	きにいる	kiniiru
乗り	のり	nori
働き	はたらき|ばたらき	hataraki|bataraki
手作り	てづくり	tedukuri
挙げる	あげる	ageru
当たり前	あたりまえ	atarimae
切り	きり|ぎり	kiri|giri
助け	たすけ|すけ|だすけ	tasuke|suke|dasuke
初め	はじめ|そめ|ぞめ	hajime|some|zome
遠く	とおく|どおく	tooku|dooku
出かける	でかける	dekakeru
待ち	まち	machi
戦う	たたかう|たたこう	tatakau|tatakou
望む	のぞむ	nozomu
売れ	うれ	ure
目立つ	めだつ	medatsu
一気に	いっきに	ikkini
悲しい	かなしい|がなしい	kanashii|ganashii
走り	はしり|ばしり|ぱしり	hashiri|bashiri|pashiri
世の中	よのなか	yononaka
近づく	ちかづく	chikaduku
死ねる	しねる	shineru
細かい	こまかい	komakai
改めて	あらためて	aratamete
夏休み	なつやすみ	natsuyasumi
動かす	うごかす	ugokasu
運ぶ	はこぶ	hakobu
お母さん	おかあさん	okaasann
黒い	くろい|こくい|ぐろい	kuroi|kokui|guroi
気付く	きづく	kiduku
赤ちゃん	あかちゃん	akatyann
思わず	おもわず	omowazu
幸い	さいわい|ざいわい	saiwai|zaiwai
役に立つ	やくにたつ	yakunitatsu
もう一度	もういちど	mouichido
負う	おう|おぶう	ou|obuu
別れ	わかれ	wakare
美味い	うまい	umai
愛しい	いとしい	itoshii
組み合わせ	くみあわせ	kumiawase
生かす	いかす	ikasu
調べる	しらべる	shiraberu
定め	さだめ	sadame
相変わらず	あいかわらず	aikawarazu
少なくとも	すくなくとも	sukunakutomo
表す	あらわす|ひょうす	arawasu|hyousu
下り	くだり|さがり|おり	kudari|sagari|ori
開き	ひらき|びらき|あき|ぴらき	hiraki|biraki|aki|piraki
早め	はやめ	hayame
下がる	さがる	sagaru
向こう	むこう	mukou
何で	なんで	nannde
結ぶ	むすぶ	musubu
見直し	みなおし	minaoshi
上げる	あげる	ageru
暗い	くらい|ぐらい	kurai|gurai
晴れ	はれ|はれれ|ばれ	hare|harere|bare
仕上げ	しあげ	shiage
お送り	おおくり	ookuri
育つ	そだつ	sodatsu
冷たい	つめたい|つべたい	tsumetai|tsubetai
教える	おしえる	oshieru
重ね	かさね|がさね	kasane|gasane
果たす	はたす	hatasu
外す	はずす|ぱずす	hazusu|pazusu
去る	さる|ざる	saru|zaru
想い	おもい	omoi
出せる	だせる	daseru
上がり	あがり	agari
同じく	おなじく	onajiku
青い	あおい	aoi
向き	むき	muki
放つ	はなつ	hanatsu
お伝え	おつたえ	otsutae
見つめる	みつめる	mitsumeru
受け取る	うけとる	uketoru
学び	まなび|まねび	manabi|manebi
味わう	あじわう	ajiwau
食べ物	たべもの	tabemono
遠い	とおい|どおい	tooi|dooi
書ける	かける	kakeru
実に	じつに|まことに|げに	jitsuni|makotoni|geni
単に	たんに	tannni
明け	あけ	ake
受け入れ	うけいれ	ukeire
乗せる	のせる	noseru
努める	つとめる	tsutomeru
有する	ゆうする	yuusuru
広げる	ひろげる|ぴろげる	hirogeru|pirogeru
無くなる	なくなる	nakunaru
下げ	さげ	sage
辞める	やめる	yameru
本当は	ほんとうは	honntouha
植える	うえる	ueru
取り上げ	とりあげ	toriage
回り	まわり|めぐり	mawari|meguri
仕組み	しくみ	shikumi
向い	むかい|むい	mukai|mui
伝える	つたえる	tsutaeru
焼く	やく|たく	yaku|taku
組む	くむ|ぐむ	kumu|gumu
見かけ	みかけ	mikake
折る	おる	oru
味わい	あじわい	ajiwai
流れる	ながれる	nagareru
飛ばす	とばす	tobasu
包む	つつむ|くるむ	tsutsumu|kurumu
入り口	いりくち|いりぐち|はいりぐち	irikuchi|iriguchi|hairiguchi
泣き	なき	naki
受け付け	うけつけ	uketsuke
引き続き	ひきつづき	hikitsuduki
付ける	つける|づける	tsukeru|dukeru
見た目	みため	mitame
着い	ちゃくい|つい	tyakui|tsui
速い	はやい|ばやい	hayai|bayai
細い	こまかい|ほそい|ぼそい|こまい	komakai|hosoi|bosoi|komai
拾う	ひろう|びろう	hirou|birou
当て	あて	ate
着く	つく	tsuku
お出かけ	おでかけ	odekake
直し	なおし	naoshi
整う	ととのう	totonou
決める	きめる|ぎめる	kimeru|gimeru
お父さん	おとうさん	otousann
申す	もうす	mousu
参る	まいる	mairu
高め	たかめ	takame
意外と	いがいと	igaito
登り	のぼり	nobori
日帰り	ひがえり	higaeri
休む	やすむ	yasumu
活かす	いかす	ikasu
選べる	えらべる	eraberu
知り合い	しりあい	shiriai
正しく	ただしく|まさしく	tadashiku|masashiku
思える	おもえる	omoeru
お昼	おひる	ohiru
予め	あらかじめ	arakajime
積む	つむ|づむ	tsumu|dumu
急ぐ	いそぐ	isogu
下る	くだる|おりる|さがる	kudaru|oriru|sagaru
極めて	きわめて	kiwamete
満たす	みたす	mitasu
空く	あく|すく|むなしく	aku|suku|munashiku
落ちる	おちる	ochiru
守り	もり|まもり	mori|mamori
消し	けし	keshi
共に	ともに	tomoni
やる気	やるき	yaruki
回し	まわし	mawashi
取り付け	とりつけ	toritsuke
お答え	おこたえ	okotae
間に合う	まにあう|まにおう	maniau|maniou
付き合い	つきあい|づきあい	tsukiai|dukiai
治る	なおる|おさまる	naoru|osamaru
やり方	やりかた	yarikata
温かい	あたたかい	atatakai
記す	しるす|きす	shirusu|kisu
単なる	たんなる	tannnaru
真ん中	まんなか	mannnaka
聞ける	きける	kikeru
上る	のぼる|あがる|あげる	noboru|agaru|ageru
男の子	おとこのこ	otokonoko
付き合う	つきあう|つきおう	tsukiau|tsukiou
お子様	おこさま	okosama
成る	なる	naru
通し	とおし|どおし	tooshi|dooshi
通じ	つうじ	tsuuji
助かる	たすかる	tasukaru
生き物	いきもの	ikimono
苦しい	くるしい|ぐるしい	kurushii|gurushii
お礼	おれい	orei
光る	ひかる	hikaru
仲良く	なかよく	nakayoku
見積もり	みつもり	mitsumori
集まり	あつまり	atsumari
行ける	いける|ゆける	ikeru|yukeru
生き方	いきかた	ikikata
愛する	あいする	aisuru
生み出す	うみだす	umidasu
古く	ふるく	furuku
問い合せる	といあわせる	toiawaseru
引き出す	ひきだす	hikidasu
見守る	みまもる	mimamoru
色んな	いろんな	ironnna
加わる	くわわる	kuwawaru
お湯	おゆ	oyu
外れ	はずれ	hazure
試み	こころみ	kokoromi
生える	はえる|ばえる	haeru|baeru
愛す	あいす	aisu
お笑い	おわらい	owarai
出来上がる	できあがる	dekiagaru
分かれ	わかれ	wakare
達す	たっす	tassu
間取り	まどり	madori
浴びる	あびる	abiru
上り	あがり|のぼり	agari|nobori
お祝い	おいわい	oiwai
生まれる	うまれる	umareru
広がり	ひろがり	hirogari
姉さん	あねさん|ねえさん	anesann|neesann
っ子	っこ	kko
作り方	つくりかた	tsukurikata
この間	このあいだ|このかん	konoaida|konokann
見通し	みとおし	mitooshi
後で	あとで|うしろで	atode|ushirode
取り入れ	とりいれ	toriire
笑える	わらえる	waraeru
持てる	もてる	moteru
手入れ	ていれ	teire
満ちる	みちる	michiru
高める	たかめる	takameru
何より	なにより	naniyori
見積り	みつもり	mitsumori
答える	こたえる|ごたえる	kotaeru|gotaeru
何だか	なんだか	nanndaka
重なる	かさなる	kasanaru
深める	ふかめる	fukameru
この世	このよ	konoyo
固い	かたい	katai
その間	そのかん	sonokann
高まる	たかまる	takamaru
仕入れ	しいれ|しいれれ	shiire|shiirere
大いに	おおいに	ooini
お手伝い	おてつだい	otetsudai
数える	かぞえる	kazoeru
曲がる	まがる	magaru
読み取る	よみとる	yomitoru
三つ	みっつ	mittsu
あり方	ありかた	arikata
立てる	たてる|だてる	tateru|dateru
祝い	いわい|ほがい|ほい	iwai|hogai|hoi
返る	かえる|がえる	kaeru|gaeru
上回る	うわまわる	uwamawaru
数多い	かずおおい	kazuooi
心から	こころから	kokorokara
止める	とどめる|とめる|やめる|どめる	todomeru|tomeru|yameru|domeru
配る	くばる	kubaru
争い	あらそい|あらがい	arasoi|aragai
書き方	かきかた	kakikata
見上げる	みあげる	miageru
果たして	はたして	hatashite
要る	いる	iru
飛び出す	とびだす	tobidasu
通う	かよう|がよう	kayou|gayou
お寺	おてら	otera
立ち上がる	たちあがる	tachiagaru
下ろす	おろす	orosu
反する	はんする	hannsuru
何らかの	なんらかの	nannrakano
太る	ふとる|ぶとる	futoru|butoru
手伝い	てつだい	tetsudai
言い方	いいかた	iikata
思いつく	おもいつく	omoitsuku
か月	かげつ	kagetsu
注ぐ	そそぐ|つぐ	sosogu|tsugu
取れる	とれる	toreru
兄ちゃん	にいちゃん	niityann
半ば	なかば	nakaba
買える	かえる	kaeru
観る	みる	miru
兄さん	にいさん	niisann
笑み	えみ	emi
消す	けす	kesu
流行る	はやる	hayaru
あっという間に	あっというまに	attoiumani
例える	たとえる	tatoeru
要するに	ようするに	yousuruni
いつの間にか	いつのまにか	itsunomanika
問い	とい|どい	toi|doi
固め	かため|がため	katame|gatame
取り出し	とりだし	toridashi
習う	ならう|なろう	narau|narou
見出し	みだし|みいだし	midashi|miidashi
必ずしも	かならずしも	kanarazushimo
未だに	いまだに	imadani
追いかける	おいかける	oikakeru
丸い	まるい|まりい	marui|marii
散る	ちる|あかる	chiru|akaru
写る	うつる	utsuru
未だ	いまだ|まだ	imada|mada
育ち	そだち	sodachi
苦しむ	くるしむ	kurushimu
負ける	まける	makeru
泳ぐ	およぐ	oyogu
建つ	たつ|だつ	tatsu|datsu
心がけ	こころがけ	kokorogake
次第に	しだいに	shidaini
太い	ふとい|ぶとい	futoi|butoi
思いっきり	おもいっきり	omoikkiri
何となく	なんとなく	nanntonaku
打ち合わせ	うちあわせ	uchiawase
有す	ゆうす	yuusu
照らす	てらす	terasu
治す	なおす|しろす	naosu|shirosu
何とも	なんとも	nanntomo
組み	くみ|ぐみ	kumi|gumi
受け止める	うけとめる	uketomeru
空き	あき|くうき|すき|むなしき	aki|kuuki|suki|munashiki
心地よい	ここちよい	kokochiyoi
浅い	あさい	asai
仕立て	したて|じたて	shitate|jitate
利く	きく	kiku
要する	ようする	yousuru
固まる	かたまる	katamaru
今や	いまや|こんや	imaya|konnya
気持ちよい	きもちよい	kimochiyoi
直す	なおす	naosu
読める	よめる	yomeru
果て	はて	hate
好む	このむ	konomu
前向き	まえむき	maemuki
黄色い	きいろい	kiiroi
鳴る	なる	naru
お好み焼き	おこのみやき	okonomiyaki
真っ赤	まっか	makka
仕上がり	しあがり	shiagari
目覚め	めざめ	mezame
覚める	さめる|ざめる	sameru|zameru
代わる	かわる|がわる	kawaru|gawaru
飲み物	のみもの	nomimono
成り立つ	なりたつ	naritatsu
冷え	ひえ|びえ|つめてえ|つべてえ	hie|bie|tsumetee|tsubetee
手伝う	てつだう|てつどう	tetsudau|tetsudou
何と	なんと	nannto
名乗る	なのる	nanoru
金持ち	かねもち|がねもち	kanemochi|ganemochi
相次ぐ	あいつぐ	aitsugu
悲しみ	かなしみ	kanashimi
見よい	みよい	miyoi
二度と	にどと	nidoto
買い上げ	かいあげ	kaiage
遊べる	あそべる	asoberu
苦しみ	くるしみ	kurushimi
話しかける	はなしかける	hanashikakeru
お話し	おはなし	ohanashi
打ち上げる	うちあげる	uchiageru
唱える	となえる	tonaeru
売れる	うれる	ureru
運び	はこび	hakobi
お子さん	おこさん	okosann
関わり	かかわり	kakawari
お正月	おしょうがつ	oshougatsu
作れる	つくれる	tsukureru
差し	さし|ざし	sashi|zashi
冷やす	ひやす	hiyasu
田んぼ	たんぼ	tannbo
直ぐ	すぐ	sugu
話し合い	はなしあい	hanashiai
売り上げ	うりあげ	uriage
受け取り	うけとり	uketori
友だち	ともだち	tomodachi
指し	さし|ざし	sashi|zashi
お手数	おてかず|おてすう	otekazu|otesuu
やって来る	やってくる	yattekuru
勝てる	かてる	kateru
天ぷら	てんぷら	tennpura
時に	ときに	tokini
説く	とく	toku
大した	たいした	taishita
わが国	わがくに	wagakuni
引き上げ	ひきあげ	hikiage
気持ちいい	きもちいい	kimochiii
指す	さす|ざす	sasu|zasu
鳴らす	ならす	narasu
学べる	まなべる	manaberu
通す	とおす|どおす	toosu|doosu
売り切れ	うりきれ	urikire
回す	まわす	mawasu
結び	むすび|けつび	musubi|ketsubi
引き起こす	ひきおこす	hikiokosu
集める	あつめる	atsumeru
切ない	せつない	setsunai
動ける	うごける	ugokeru
群れ	むれ|むらがれ	mure|muragare
打てる	うてる	uteru
望み	のぞみ	nozomi
力強い	ちからづよい	chikaraduyoi
作り出す	つくりだす	tsukuridasu
着る	きる	kiru
写し	うつし	utsushi
通い	かよい|がよい	kayoi|gayoi
姉ちゃん	ねえちゃん	neetyann
命じる	めいじる	meijiru
思ふ	おもふ	omofu
選び方	えらびかた	erabikata
お家	おいえ|おうち	oie|ouchi
交わす	かわす	kawasu
欠け	かけ	kake
目当て	めあて	meate
歩ける	あるける	arukeru
手がける	てがける	tegakeru
歩む	あゆむ	ayumu
面す	めんす	mennsu
お気	おき	oki
味付け	あじつけ	ajitsuke
泣ける	なける	nakeru
持ち主	もちぬし	mochinushi
下がり	さがり	sagari
交える	まじえる	majieru
下げる	さげる	sageru
着ける	つける|づける	tsukeru|dukeru
曲げる	まげる	mageru
発す	はっす	hassu
足す	たす	tasu
直ちに	ただちに	tadachini
持ち帰り	もちかえり	mochikaeri
万が一	まんがいち	manngaichi
話し合う	はなしあう|はなしおう	hanashiau|hanashiou
見かける	みかける	mikakeru
追いつく	おいつく	oitsuku
産む	うむ	umu
歩み	あゆみ	ayumi
焼け	やけ	yake
日焼け	ひやけ	hiyake
転がる	ころがる	korogaru
作り上げる	つくりあげる	tsukuriageru
下す	くだす|おろす	kudasu|orosu
申し出	もうしで	moushide
切れる	きれる|ぎれる	kireru|gireru
来れる	これる	koreru
先ず	まず	mazu
会える	あえる	aeru
真っ白	まっしろ	masshiro
改め	あらため	aratame
組み立て	くみたて	kumitate
温める	あたためる|ぬくめる	atatameru|nukumeru
たどり着く	たどりつく	tadoritsuku
鳴く	なく	naku
知らせ	しらせ	shirase
敗れる	やぶれる	yabureru
向き合う	むきあう|むきおう	mukiau|mukiou
色合い	いろあい	iroai
通じる	つうじる	tsuujiru
望ましい	のぞましい	nozomashii
便り	たより|だより	tayori|dayori
等しい	ひとしい	hitoshii
明かす	あかす	akasu
育む	はぐくむ	hagukumu
葉っぱ	はっぱ	happa
何かと	なにかと	nanikato
生る	なる	naru
うつ病	うつびょう	utsubyou
苦い	にがい	nigai
落ち着き	おちつき	ochitsuki
気まま	きまま	kimama
見直す	みなおす	minaosu
急ぎ	いそぎ	isogi
読み方	よみかた	yomikata
持ち上げる	もちあげる	mochiageru
やり取り	やりとり	yaritori
問い合わせる	といあわせる	toiawaseru
立ち読み	たちよみ	tachiyomi
出入り	でいり|ではいり	deiri|dehairi
要は	ようは	youha
親しい	したしい	shitashii
位置づけ	いちづけ	ichiduke
役立てる	やくだてる	yakudateru
間もなく	まもなく	mamonaku
生き残る	いきのこる	ikinokoru
速やか	すみやか	sumiyaka
強める	つよめる	tsuyomeru
時には	ときには	tokiniha
争う	あらそう|あらがう|あらごう	arasou|aragau|aragou
習い事	ならいごと	naraigoto
分る	わかる|わける	wakaru|wakeru
助ける	すける|たすける|だすける	sukeru|tasukeru|dasukeru
引っかかる	ひっかかる	hikkakaru
化す	かす	kasu
積もる	つもる	tsumoru
売り場	うりば	uriba
中でも	なかでも	nakademo
受かる	うかる	ukaru
向ける	むける	mukeru
好ましい	このましい	konomashii
発する	はっする	hassuru
富む	とむ	tomu
思い切る	おもいきる	omoikiru
冷める	さめる|ざめる	sameru|zameru
受け入れる	うけいれる	ukeireru
日差し	ひざし	hizashi
取り消し	とりけし	torikeshi
焼き鳥	やきとり	yakitori
味わえる	あじわえる	ajiwaeru
見送る	みおくる	miokuru
引き取る	ひきとる	hikitoru
ため息	ためいき	tameiki
題す	だいす	daisu
待ち合わせ	まちあわせ	machiawase
向う	むかう|むこう	mukau|mukou
仲良し	なかよし	nakayoshi
帯びる	おびる	obiru
想う	おもう	omou
差し上げる	さしあげる	sashiageru
養う	やしなう|やしのう	yashinau|yashinou
包み	つつみ|くるみ|づつみ|ぐるみ|ずつみ	tsutsumi|kurumi|dutsumi|gurumi|zutsumi
集い	つどい|すだい	tsudoi|sudai
ご苦労	ごくろう	gokurou
無理やり	むりやり	muriyari
一人ひとり	ひとりひとり	hitorihitori
気持ち良い	きもちよい	kimochiyoi
気まぐれ	きまぐれ	kimagure
大きめ	おおきめ	ookime
言い出す	いいだす	iidasu
早起き	はやおき	hayaoki
教わる	おそわる	osowaru
取組む	とりくむ	torikumu
置き場	おきば	okiba
物足りない	ものたりない	monotarinai
昔ながら	むかしながら	mukashinagara
食らう	くらう	kurau
結びつく	むすびつく	musubitsuku
祝う	いわう|いおう	iwau|iou
知り合う	しりあう|しりおう	shiriau|shiriou
終る	おわる	owaru
引け	ひけ|びけ|ぴけ	hike|bike|pike
乗り物	のりもの	norimono
区切る	くぎる	kugiru
試す	ためす	tamesu
仕上がる	しあがる	shiagaru
折り返し	おりかえし	orikaeshi
近づける	ちかづける	chikadukeru
お参り	おまいり	omairi
立ち上がり	たちあがり	tachiagari
積み重ね	つみかさね	tsumikasane
見下ろす	みおろす	miorosu
手持ち	てもち	temochi
直る	なおる	naoru
何やら	なにやら	naniyara
競う	きそう|きおう	kisou|kiou
夜明け	よあけ	yoake
四つ	よっつ|よつ	yottsu|yotsu
何気ない	なにげない	nanigenai
何ら	なんら	nannra
着せる	きせる	kiseru
お守り	おもり|おまもり	omori|omamori
高まり	たかまり	takamari
動き出す	うごきだす	ugokidasu
名付け	なづけ	naduke
手のひら	てのひら	tenohira
働ける	はたらける	hatarakeru
帰り道	かえりみち	kaerimichi
追って	おって	otte
重ねる	かさねる	kasaneru
達する	たっする	tassuru
たこ焼き	たこやき	takoyaki
引きずる	ひきずる	hikizuru
花びら	はなびら	hanabira
多め	おおめ	oome
化け	ばけ	bake
日の出	ひので	hinode
当てはまる	あてはまる	atehamaru
仕分け	しわけ	shiwake
欠く	かく	kaku
数少ない	かずすくない	kazusukunai
入れ歯	いれば	ireba
使い勝手	つかいがって	tsukaigatte
先ほど	さきほど	sakihodo
転ぶ	ころぶ|まろぶ	korobu|marobu
いち早い	いちはやい	ichihayai
和む	なごむ	nagomu
手書き	てがき|てかき	tegaki|tekaki
飲める	のめる	nomeru
見送り	みおくり	miokuri
当てる	あてる	ateru
品切れ	しなぎれ	shinagire
要す	ようす	yousu
気合い	きあい	kiai
焼きそば	やきそば	yakisoba
仕える	つかえる|づかえる	tsukaeru|dukaeru
思いやり	おもいやり	omoiyari
お返し	おかえし	okaeshi
手打ち	てうち	teuchi
菜の花	なのはな	nanohana
追い出す	おいだす	oidasu
休める	やすめる	yasumeru
変る	かわる	kawaru
真に	しんに|まことに	shinnni|makotoni
大人しい	おとなしい	otonashii
見合い	みあい	miai
強まる	つよまる	tsuyomaru
広まる	ひろまる	hiromaru
期す	きす	kisu
細か	こまか|さいか	komaka|saika
真っ直ぐ	まっすぐ	massugu
当り	あたり	atari
母さん	かあさん	kaasann
深まる	ふかまる	fukamaru
差し出す	さしだす|さしいだす	sashidasu|sashiidasu
成す	なす	nasu
練り	ねり	neri
引き受け	ひきうけ	hikiuke
落書き	らくがき	rakugaki
無くす	なくす	nakusu
何だ	なんだ	nannda
聞き取る	ききとる	kikitoru
見受ける	みうける	miukeru
乗り切る	のりきる	norikiru
広め	ひろめ	hirome
消せる	けせる	keseru
転じる	てんじる	tennjiru
次ぐ	つぐ	tsugu
文字通り	もじどおり	mojidoori
案の定	あんのじょう	annnojou
空ける	あける|うつける	akeru|utsukeru
出会える	であえる	deaeru
問いかける	といかける	toikakeru
道のり	みちのり	michinori
親しみ	したしみ	shitashimi
明かり	あかり	akari
生む	うむ	umu
買い求める	かいもとめる	kaimotomeru
読み返す	よみかえす	yomikaesu
石けん	せっけん|いしけん	sekkenn|ishikenn
計る	はかる	hakaru
向く	むく	muku
栄え	はえ|さかえ|ばえ	hae|sakae|bae
覚ます	さます	samasu
持ち帰る	もちかえる	mochikaeru
整える	ととのえる	totonoeru
行える	おこなえる	okonaeru
強み	つよみ	tsuyomi
表れ	あらわれ	araware
昼休み	ひるやすみ	hiruyasumi
見当たる	みあたる	miataru
知らせる	しらせる	shiraseru
言うまでもない	いうまでもない	iumademonai
重み	おもみ	omomi
物語る	ものがたる	monogataru
持ち出し	もちだし	mochidashi
手づくり	てづくり	tedukuri
次いで	ついで	tsuide
乗り出す	のりだす	noridasu
下し	おろし|くだし	oroshi|kudashi
持ち歩く	もちあるく	mochiaruku
走り回る	はしりまわる	hashirimawaru
手当て	てあて	teate
友の会	とものかい	tomonokai
生まれ変わる	うまれかわる	umarekawaru
望める	のぞめる	nozomeru
真っ暗	まっくら	makkura
田植え	たうえ	taue
立ち止まる	たちどまる	tachidomaru
察し	さっし	sasshi
下回る	したまわる	shitamawaru
練る	ねる	neru
玉ねぎ	たまねぎ	tamanegi
欠ける	かける	kakeru
読み取り	よみとり	yomitori
出回る	でまわる	demawaru
何もかも	なにもかも	nanimokamo
返せる	かえせる	kaeseru
今さら	いまさら	imasara
語り合う	かたりあう|かたりおう	katariau|katariou
立ち向かう	たちむかう	tachimukau
見どころ	みどころ	midokoro
着付け	きつけ	kitsuke
聞かす	きかす	kikasu
取り出す	とりだす	toridasu
父さん	とうさん	tousann
合える	あえる	aeru
極め	きめ|きわめ|ぎめ	kime|kiwame|gime
満つ	みつ	mitsu
正に	まさに	masani
弱る	よわる	yowaru
鳴き声	なきごえ	nakigoe
付す	ふす	fusu
出向く	でむく	demuku
送り出す	おくりだす	okuridasu
車いす	くるまいす	kurumaisu
食する	しょくする	shokusuru
大さじ	おおさじ	oosaji
生き生き	いきいき	ikiiki
いた事	いたこと	itakoto
深み	ふかみ	fukami
主として	しゅとして	shutoshite
真っ	まっ	maxtu
真っ黒	まっくろ	makkuro
泳ぎ	およぎ	oyogi
取り外し	とりはずし	torihazushi
名づける	なづける	nadukeru
使い分け	つかいわけ	tsukaiwake
大して	たいして	taishite
夕焼け	ゆうやけ	yuuyake
見分け	みわけ	miwake
想い出	おもいで	omoide
思い切り	おもいきり	omoikiri
生ずる	しょうずる	shouzuru
思いつき	おもいつき	omoitsuki
鳴り	なり	nari
先立つ	さきだつ	sakidatsu
集う	つどう	tsudou
付け加える	つけくわえる	tsukekuwaeru
産まれる	うまれる	umareru
戦える	たたかえる	tatakaeru
長生き	ながいき	nagaiki
真っ先	まっさき	massaki
やり直し	やりなおし	yarinaoshi
働きかけ	はたらきかけ	hatarakikake
折りたたみ	おりたたみ	oritatami
天下り	あまくだり	amakudari
香ばしい	こうばしい	koubashii
話せる	はなせる	hanaseru
お方	おかた	okata
丸ごと	まるごと	marugoto
意味合い	いみあい	imiai
日の丸	ひのまる	hinomaru
待ち時間	まちじかん	machijikann
老い	おい	oi
大通り	おおどおり	oodoori
太もも	ふともも	futomomo
分かれる	わかれる	wakareru
区切り	くぎり	kugiri
見極め	みきわめ	mikiwame
丸出し	まるだし	marudashi
取り消す	とりけす	torikesu
飛べる	とべる	toberu
灯り	ともり|あかり	tomori|akari
重たい	おもたい	omotai
夕べ	ゆうべ	yuube
結びつける	むすびつける	musubitsukeru
まとめ買い	まとめがい	matomegai
絵かき	えかき	ekaki
引き下げ	ひきさげ	hikisage
一向に	いっこうに	ikkouni
待ち受ける	まちうける	machiukeru
省く	はぶく	habuku
思い入れ	おもいいれ	omoiire
品書き	しながき	shinagaki
乗り場	のりば	noriba
身の回り	みのまわり	minomawari
帰す	かえす|きす	kaesu|kisu
見合う	みあう|みおう	miau|miou
通れる	とおれる	tooreru
見習う	みならう|みなろう	minarau|minarou
打ち出し	うちだし	uchidashi
早くから	はやくから	hayakukara
お便り	おたより	otayori
見失う	みうしなう|みうしのう	miushinau|miushinou
人びと	ひとびと	hitobito
ほうれん草	ほうれんそう	hourennsou
代え	かえ|がえ	kae|gae
安らぎ	やすらぎ	yasuragi
感じ取る	かんじとる	kannjitoru
投じる	とうじる	toujiru
買い取り	かいとり	kaitori
度合い	どあい	doai
課す	かす	kasu
お母様	おかあさま	okaasama
旅立つ	たびだつ	tabidatsu
置ける	おける	okeru
日ごろ	ひごろ	higoro
引き分け	ひきわけ	hikiwake
何しろ	なにしろ	nanishiro
当る	あたる|あてる	ataru|ateru
焼き肉	やきにく	yakiniku
大げさ	おおげさ	oogesa
主たる	しゅたる	shutaru
走り出す	はしりだす	hashiridasu
少なめ	すくなめ	sukuname
利回り	りまわり	rimawari
病む	やむ	yamu
散らし	ちらし	chirashi
止む	やむ	yamu
飛び交う	とびかう|とびこう	tobikau|tobikou
終り	おわり	owari
照れ	てれ	tere
読み上げる	よみあげる	yomiageru
放す	はなす|ほかす|ばなす|ぱなす	hanasu|hokasu|banasu|panasu
宿る	やどる	yadoru
助け合う	たすけあう|たすけおう	tasukeau|tasukeou
愛らしい	あいらしい	airashii
積み上げ	つみあげ	tsumiage
順に	じゅんに	junnni
乗れる	のれる	noreru
何時も	いつも	itsumo
買取る	かいとる	kaitoru
君たち	きみたち	kimitachi
取り合う	とりあう|とりおう	toriau|toriou
山歩き	やまあるき	yamaaruki
和える	あえる	aeru
行き先	いきさき|ゆきさき	ikisaki|yukisaki
生み	うみ|なまみ	umi|namami
苦しめる	くるしめる	kurushimeru
乗じる	じょうじる	joujiru
位置付け	いちづけ	ichiduke
わが家	わがや	wagaya
切り取る	きりとる	kiritoru
近付く	ちかづく	chikaduku
鳴き	なき	naki
活きる	いきる	ikiru
見習い	みならい	minarai
子連れ	こづれ	kodure
手助け	てだすけ	tedasuke
好い	よい|こうい|すい|いい	yoi|koui|sui|ii
日当たり	ひあたり	hiatari
組合せ	くみあわせ	kumiawase
使いこなす	つかいこなす	tsukaikonasu
持ち物	もちもの	mochimono
手すり	てすり	tesuri
差し入れ	さしいれ	sashiire
あっという間	あっというま	attoiuma
落ち着ける	おちつける	ochitsukeru
通行止め	つうこうどめ	tsuukoudome
欠かす	かかす	kakasu
起き上がる	おきあがる	okiagaru
手引き	てびき	tebiki
対す	たいす	taisu
心強い	こころづよい	kokoroduyoi
思い立つ	おもいたつ	omoitatsu
取り上げる	とりあげる	toriageru
待ち遠しい	まちどおしい	machidooshii
乗っ取る	のっとる	nottoru
残せる	のこせる	nokoseru
温まる	あたたまる|ぬくまる	atatamaru|nukumaru
旅立ち	たびだち	tabidachi
別れる	わかれる	wakareru
小さめ	ちいさめ	chiisame
定か	さだか	sadaka
色づく	いろづく	iroduku
乗り入れ	のりいれ	noriire
打合せ	うちあわせ	uchiawase
切り口	きりくち	kirikuchi
知らす	しらす	shirasu
飲み屋	のみや	nomiya
見やすい	みやすい	miyasui
ただ今	ただいま	tadaima
日にち	ひにち	hinichi
言い聞かせる	いいきかせる	iikikaseru
読み物	よみもの	yomimono
取り付ける	とりつける	toritsukeru
細長い	ほそながい	hosonagai
見落とす	みおとす	miotosu
進め方	すすめかた	susumekata
話し方	はなしかた	hanashikata
長持ち	ながもち	nagamochi
打ち切り	うちきり	uchikiri
決め手	きめて	kimete
仕切り	しきり|じきり	shikiri|jikiri
目覚まし	めざまし	mezamashi
申し入れ	もうしいれ	moushiire
仕出し	しだし	shidashi
仕切る	しきる	shikiru
開き直る	ひらきなおる	hirakinaoru
きめ細かい	きめこまかい	kimekomakai
産み	うみ	umi
横たわる	よこたわる	yokotawaru
すき焼き	すきやき	sukiyaki
見回す	みまわす	mimawasu
見知らぬ	みしらぬ	mishiranu
改める	あらためる	aratameru
委ねる	ゆだねる	yudaneru
好く	すく|よく	suku|yoku
ひっくり返す	ひっくりかえす	hikkurikaesu
生き残り	いきのこり	ikinokori
見出す	みいだす	miidasu
大いなる	おおいなる	ooinaru
連なる	つらなる	tsuranaru
年明け	としあけ|ねんあけ	toshiake|nennake
合せ	あわせ|がっせ	awase|gasse
見なす	みなす	minasu
受取る	うけとる	uketoru
止る	とまる|やめる|とめる|どまる|とどまる	tomaru|yameru|tomeru|domaru|todomaru
大笑い	おおわらい	oowarai
落ち葉	おちば	ochiba
気が付く	きがつく	kigatsuku
五つ	いつつ	itsutsu
言い分	いいぶん	iibunn
健やか	すこやか	sukoyaka
分かつ	わかつ	wakatsu
持ち合わせ	もちあわせ	mochiawase
不味い	まずい|まじい	mazui|majii
長引く	ながびく	nagabiku
横切る	よこぎる	yokogiru
平ら	たいら|だいら	taira|daira
細やか	こまやか|ささやか|ほそやか	komayaka|sasayaka|hosoyaka
遠ざかる	とおざかる	toozakaru
立ち去る	たちさる	tachisaru
名乗り	なのり	nanori
温もり	ぬくもり	nukumori
風合い	ふうあい	fuuai
使い道	つかいみち	tsukaimichi
語りかける	かたりかける	katarikakeru
戸建て	こだて	kodate
内祝い	うちいわい	uchiiwai
計り	はかり|ばかり	hakari|bakari
細め	ほそめ	hosome
低め	ひくめ	hikume
行き来	いきき|ゆきき	ikiki|yukiki
気さく	きさく	kisaku
今にも	いまにも	imanimo
兆し	きざし	kizashi
立ち入り	たちいり	tachiiri
丸める	まるめる	marumeru
落とせる	おとせる	otoseru
見下す	みくだす	mikudasu
長め	ながめ	nagame
山登り	やまのぼり	yamanobori
笑い声	わらいごえ	waraigoe
申し立て	もうしたて	moushitate
仕上げる	しあげる	shiageru
治まる	おさまる	osamaru
外せる	はずせる	hazuseru
外れる	はずれる	hazureru
組み合わせる	くみあわせる	kumiawaseru
係わる	かかわる	kakawaru
神さま	かみさま	kamisama
春休み	はるやすみ	haruyasumi
通りすがり	とおりすがり	toorisugari
書き下ろす	かきおろす	kakiorosu
根強い	ねづよい	neduyoi
勝る	まさる	masaru
当の	とうの	touno
折り紙	おりがみ	origami
取付け	とりつけ	toritsuke
生きがい	いきがい	ikigai
願い事	ねがいごと	negaigoto
転がす	ころがす	korogasu
走れる	はしれる	hashireru
目の当たり	まのあたり|めのあたり	manoatari|menoatari
世に	よに	yoni
手がかり	てがかり	tegakari
軽やか	かろやか|かるやか	karoyaka|karuyaka
歩き回る	あるきまわる	arukimawaru
取り入れる	とりいれる	toriireru
実る	みのる	minoru
追っかけ	おっかけ	okkake
取り直す	とりなおす	torinaosu
生かせる	いかせる	ikaseru
課する	かする	kasuru
差す	さす	sasu
切り開く	きりひらく	kirihiraku
実り	みのり	minori
親しむ	したしむ	shitashimu
差し引く	さしひく	sashihiku
仲間入り	なかまいり	nakamairi
付け根	つけね	tsukene
あだ名	あだな	adana
伝う	つたう|つとう	tsutau|tsutou
見立て	みたて	mitate
試みる	こころみる	kokoromiru
投げ出す	なげだす	nagedasu
後ほど	のちほど	nochihodo
着こなし	きこなし	kikonashi
取消し	とりけし	torikeshi
極める	きわめる|きめる	kiwameru|kimeru
塩焼き	しおやき	shioyaki
取りあえず	とりあえず	toriaezu
何れ	いずれ|どれ	izure|dore
歯ごたえ	はごたえ	hagotae
連ね	つらね	tsurane
引き上げる	ひきあげる	hikiageru
人差し指	ひとさしゆび	hitosashiyubi
色とりどり	いろとりどり	irotoridori
焼き上げる	やきあげる	yakiageru
八つ	やっつ|やつ	yattsu|yatsu
お化け	おばけ	obake
入ろう	にゅうろう|いろう|はいろう	nyuurou|irou|hairou
博す	はくす	hakusu
直に	じかに|じきに	jikani|jikini
待たす	またす	matasu
香る	かおる	kaoru
生れ	うまれ|なれ	umare|nare
取り残す	とりのこす	torinokosu
母ちゃん	かあちゃん	kaatyann
目覚める	めざめる	mezameru
切り上げ	きりあげ	kiriage
売り出し	うりだし	uridashi
勝ち取る	かちとる	kachitoru
見せつける	みせつける	misetsukeru
万引き	まんびき	mannbiki
覚せい	かくせい	kakusei
飛び立つ	とびたつ	tobitatsu
大当たり	おおあたり	ooatari
祭る	まつる	matsuru
手ごろ	てごろ	tegoro
冬休み	ふゆやすみ	fuyuyasumi
見苦しい	みぐるしい	migurushii
見合わせ	みあわせ	miawase
大まか	おおまか	oomaka
買い取る	かいとる	kaitoru
持ち運び	もちはこび	mochihakobi
定まる	さだまる	sadamaru
引き返し	ひきかえし	hikikaeshi
見入る	みいる	miiru
いつの間に	いつのまに	itsunomani
泣かせる	なかせる	nakaseru
申し付ける	もうしつける	moushitsukeru
名高い	なだかい	nadakai
台無し	だいなし	dainashi
男らしい	おとこらしい	otokorashii
投げかける	なげかける	nagekakeru
住める	すめる	sumeru
手放し	てばなし	tebanashi
上乗せ	うわのせ	uwanose
笑わせる	わらわせる	warawaseru
生まれ変わり	うまれかわり	umarekawari
晴れる	はれる	hareru
取りまとめ	とりまとめ	torimatome
今ひとつ	いまひとつ	imahitotsu
明け方	あけがた	akegata
表わす	あらわす	arawasu
お年	おとし	otoshi
お子さま	おこさま	okosama
清める	きよめる	kiyomeru
命ずる	めいずる	meizuru
色っぽい	いろっぽい	iroppoi
立ち直る	たちなおる	tachinaoru
切れ味	きれあじ	kireaji
治める	おさめる	osameru
化け物	ばけもの	bakemono
書き出し	かきだし	kakidashi
手ぬぐい	てぬぐい	tenugui
お札	おさつ|おふだ	osatsu|ofuda
持ち出す	もちだす	mochidasu
お決まり	おきまり	okimari
点く	つく|づく	tsuku|duku
足取り	あしとり|あしどり	ashitori|ashidori
先行き	さきゆき	sakiyuki
持ち味	もちあじ	mochiaji
何せ	なにせ|なんせ	nanise|nannse
顔立ち	かおだち	kaodachi
先取り	さきどり	sakidori
下りる	おりる	oriru
落し	おとし	otoshi
先送り	さきおくり	sakiokuri
果てしない	はてしない	hateshinai
みじん切り	みじんぎり	mijinngiri
晴らす	はらす|ばらす	harasu|barasu
散らす	ちらす	chirasu
四角い	しかくい|しかきい	shikakui|shikakii
あの世	あのよ	anoyo
根っこ	ねっこ	nekko
気付け	きつけ|きづけ	kitsuke|kiduke
配し	はいし	haishi
七つ	ななつ	nanatsu
何一つ	なにひとつ	nanihitotsu
一休み	ひとやすみ	hitoyasumi
植え付け	うえつけ	uetsuke
動き回る	うごきまわる	ugokimawaru
果たせる	はたせる	hataseru
挙がる	あがる	agaru
使い切る	つかいきる	tsukaikiru
苦笑い	にがわらい|わらい	nigawarai|warai
長らく	ながらく	nagaraku
思いこむ	おもいこむ	omoikomu
空き地	あきち	akichi
晴れ間	はれま	harema
投げつける	なげつける	nagetsukeru
前もって	まえもって	maemotte
成り立ち	なりたち	naritachi
切り出し	きりだし	kiridashi
かき氷	かきごおり	kakigoori
言い回し	いいまわし	iimawashi
研ぐ	とぐ	togu
写り	うつり	utsuri
浴びせる	あびせる	abiseru
口当たり	くちあたり	kuchiatari
負け犬	まけいぬ	makeinu
焼き物	やきもの	yakimono
求む	もとむ|とむ	motomu|tomu
聞き入る	ききいる	kikiiru
木の実	このみ|きのみ	konomi|kinomi
遊び心	あそびごころ	asobigokoro
分り	わかり	wakari
遊び場	あそびば	asobiba
極まりない	きわまりない	kiwamarinai
同い年	おないどし	onaidoshi
取り返し	とりかえし	torikaeshi
和やか	なごやか|にこやか	nagoyaka|nikoyaka
お手本	おてほん	otehonn
飛びつく	とびつく	tobitsuku
交じる	まじる	majiru
出だし	でだし|いだし	dedashi|idashi
気配り	きくばり	kikubari
選りすぐる	えりすぐる|よりすぐる	erisuguru|yorisuguru
見返し	みかえし	mikaeshi
売上げ	うりあげ	uriage
梅雨入り	つゆいり	tsuyuiri
絵の具	えのぐ	enogu
出くわす	でくわす	dekuwasu
茶色い	ちゃいろい	tyairoi
親知らず	おやしらず	oyashirazu
思い起こす	おもいおこす	omoiokosu
清い	きよい	kiyoi
飛び回る	とびまわる	tobimawaru
芽生え	めばえ	mebae
真っ最中	まっさいちゅう	massaityuu
受付ける	うけつける	uketsukeru
固める	かためる|がためる	katameru|gatameru
失せる	うせる	useru
身動き	みうごき	miugoki
起る	おこる	okoru
作り直す	つくりなおす	tsukurinaosu
写す	うつす	utsusu
生き返る	いきかえる	ikikaeru
根ざす	ねざす	nezasu
お花畑	おはなばたけ	ohanabatake
対する	たいする	taisuru
合わす	あわす	awasu
気取る	きどる|けどる	kidoru|kedoru
帰れる	かえれる	kaereru
聞き流す	ききながす	kikinagasu
和らげる	やわらげる	yawarageru
見切り	みきり	mikiri
見返り	みかえり	mikaeri
群がる	むらがる	muragaru
お年玉	おとしだま	otoshidama
直せる	なおせる	naoseru
まつ毛	まつげ	matsuge
里帰り	さとがえり	satogaeri
追いやる	おいやる	oiyaru
気まずい	きまずい	kimazui
食い物	くいもの	kuimono
重んじる	おもんじる	omonnjiru
ぶら下がる	ぶらさがる	burasagaru
言い放つ	いいはなつ	iihanatsu
指さす	ゆびさす	yubisasu
思い通り	おもいどおり	omoidoori
うろ覚え	うろおぼえ	urooboe
切り落とす	きりおとす	kiriotosu
見晴らし	みはらし	miharashi
見栄え	みばえ	mibae
言い伝え	いいつたえ	iitsutae
働かせる	はたらかせる	hatarakaseru
顔つき	かおつき	kaotsuki
改ざん	かいざん	kaizann
見せかけ	みせかけ	misekake
生ける	いける	ikeru
安っぽい	やすっぽい	yasuppoi
見覚え	みおぼえ	mioboe
はみ出す	はみだす	hamidasu
教え子	おしえご	oshiego
味わい深い	あじわいぶかい	ajiwaibukai
手放す	てばなす	tebanasu
散らばる	ちらばる	chirabaru
交わる	まじわる	majiwaru
飛び散る	とびちる	tobichiru
死す	しす	shisu
後回し	あとまわし	atomawashi
向かい合う	むかいあう|むかいおう	mukaiau|mukaiou
泳げる	およげる	oyogeru
真っ青	まっさお	massao
係り	かかり|かかわり|がかり	kakari|kakawari|gakari
老ける	ふける	fukeru
見開く	みひらく	mihiraku
思い当たる	おもいあたる	omoiataru
食える	くえる	kueru
小さじ	こさじ	kosaji
見いだす	みいだす	miidasu
生い立ち	おいたち	oitachi
風通し	かざとおし|かぜとおし	kazatooshi|kazetooshi
間合い	まあい	maai
心当たり	こころあたり	kokoroatari
引き金	ひきがね	hikigane
冷える	ひえる|びえる	hieru|bieru
乗っかる	のっかる	nokkaru
遠回り	とおまわり	toomawari
助っ人	すけっと	suketto
類する	るいする	ruisuru
木の葉	このは	konoha
ひと言	ひとこと	hitokoto
平然と	へいぜんと	heizennto
お気づき	おきづき	okiduki
放る	ほうる|ひる|ぽる	houru|hiru|poru
見極める	みきわめる	mikiwameru
考え直す	かんがえなおす	kanngaenaosu
使いこなせる	つかいこなせる	tsukaikonaseru
箱入り	はこいり	hakoiri
組める	くめる	kumeru
打ち明ける	うちあける	uchiakeru
決めつける	きめつける	kimetsukeru
折れる	おれる	oreru
思いやる	おもいやる	omoiyaru
根付く	ねつく|ねづく	netsuku|neduku
ごま油	ごまあぶら	gomaabura
見とれる	みとれる	mitoreru
顔ぶれ	かおぶれ	kaobure
思い返す	おもいかえす	omoikaesu
極み	きわみ	kiwami
静けさ	しずけさ	shizukesa
打ち切る	うちきる	uchikiru
生きもの	いきもの	ikimono
安らか	やすらか	yasuraka
申し分	もうしぶん	moushibunn
司る	つかさどる	tsukasadoru
行きつけ	いきつけ|ゆきつけ	ikitsuke|yukitsuke
清らか	きよらか	kiyoraka
小ぶり	こぶり	koburi
歯止め	はどめ	hadome
前売り	まえうり	maeuri
小高い	こだかい	kodakai
空しい	むなしい	munashii
つき合う	つきあう|つきおう	tsukiau|tsukiou
祝い金	いわいきん	iwaikinn
父ちゃん	とうちゃん	toutyann
雨上がり	あめあがり	ameagari
雪だるま	ゆきだるま	yukidaruma
受けとめる	うけとめる	uketomeru
食いつく	くいつく	kuitsuku
読み直す	よみなおす	yominaosu
立て続け	たてつづけ	tatetsuduke
お産	おさん	osann
前置き	まえおき	maeoki
人見知り	ひとみしり	hitomishiri
折りたたむ	おりたたむ	oritatamu
全う	まっとう	mattou
口ずさむ	くちずさむ	kuchizusamu
引き立て	ひきたて	hikitate
売り物	うりもの	urimono
当てはめる	あてはめる	atehameru
置き去り	おきざり|おきさり	okizari|okisari
線引き	せんひき|せんびき	sennhiki|sennbiki
長続き	ながつづき	nagatsuduki
行き着く	いきつく|ゆきつく	ikitsuku|yukitsuku
手っ取り早い	てっとりばやい	tettoribayai
気取り	きどり|けどり	kidori|kedori
見せ場	みせば	miseba
不向き	ふむき	fumuki
放り出す	ほうりだす|ひりだす	houridasu|hiridasu
照り	てり|でり	teri|deri
丸見え	まるみえ	marumie
たった今	たったいま	tattaima
天の川	あまのがわ	amanogawa
売れ行き	うれゆき	ureyuki
語らう	かたらう	katarau
安売り	やすうり	yasuuri
白っぽい	しろっぽい	shiroppoi
千切り	せんぎり|ちぎり	senngiri|chigiri
思い知らす	おもいしらす	omoishirasu
つま先	つまさき	tsumasaki
わが子	わがこ	wagako
申しあげる	もうしあげる	moushiageru
お作り	おつくり	otsukuri
切に	せつに	setsuni
送れる	おくれる	okureru
集る	たかる|だかる|あつまる	takaru|dakaru|atsumaru
切り札	きりふだ	kirifuda
成り行き	なりゆき	nariyuki
消え去る	きえさる	kiesaru
引き合い	ひきあい	hikiai
種まき	たねまき	tanemaki
お立ち	おたち	otachi
水遊び	みずあそび	mizuasobi
見つけ出す	みつけだす	mitsukedasu
切らす	きらす	kirasu
息苦しい	いきぐるしい	ikigurushii
表向き	おもてむき	omotemuki
害する	がいする	gaisuru
羽ばたく	はばたく	habataku
見開き	みひらき	mihiraki
引き返す	ひきかえす	hikikaesu
泣かす	なかす	nakasu
弱まる	よわまる	yowamaru
立ち会う	たちあう|たちおう	tachiau|tachiou
追い求める	おいもとめる	oimotomeru
上書き	うわがき	uwagaki
ついて行く	ついていく|ついてゆく	tsuiteiku|tsuiteyuku
買い付け	かいつけ	kaitsuke
読み書き	よみかき	yomikaki
山積み	やまづみ	yamadumi
日に日に	ひにひに	hinihini
打ち出す	うちだす	uchidasu
立て直し	たてなおし	tatenaoshi
むき出し	むきだし	mukidashi
子持ち	こもち	komochi
借り入れ	かりいれ	kariire
手取り	てどり|てとり|てっとり	tedori|tetori|tettori
ひっくり返る	ひっくりかえる	hikkurikaeru
耳鳴り	みみなり	miminari
書き上げる	かきあげる	kakiageru
飛び出る	とびでる	tobideru
心温まる	こころあたたまる	kokoroatatamaru
受け皿	うけざら	ukezara
ひな祭り	ひなまつり	hinamatsuri
出し入れ	だしいれ	dashiire
冷ます	さます	samasu
歌える	うたえる	utaeru
まな板	まないた	manaita
相まって	あいまって	aimatte
広める	ひろめる	hiromeru
ぶら下げる	ぶらさげる	burasageru
秋祭り	あきまつり	akimatsuri
皮切り	かわきり	kawakiri
言い合う	いいあう|いいおう	iiau|iiou
追い風	おいかぜ	oikaze
引き続く	ひきつづく	hikitsuduku
お目にかかる	おめにかかる	omenikakaru
読み手	よみて	yomite
思いがけない	おもいがけない	omoigakenai
遠のく	とおのく	toonoku
見付け	みつけ	mitsuke
引き受ける	ひきうける	hikiukeru
取り調べる	とりしらべる	torishiraberu
空っぽ	からっぽ	karappo
肉まん	にくまん	nikumann
この上ない	このうえない	konouenai
正す	ただす	tadasu
起し	おこし|きし	okoshi|kishi
足りる	たりる	tariru
注意深い	ちゅういぶかい	tyuuibukai
刷り	すり|ずり	suri|zuri
赤み	あかみ	akami
給う	たまう|たもう	tamau|tamou
使い物	つかいもの	tsukaimono
行き交う	いきかう|ゆきかう|いきこう|ゆきこう	ikikau|yukikau|ikikou|yukikou
長ける	たける	takeru
見積もる	みつもる	mitsumoru
短め	みじかめ	mijikame
下らない	くだらない	kudaranai
ぬるま湯	ぬるまゆ	nurumayu
茶の間	ちゃのま	tyanoma
上向き	うわむき	uwamuki
命がけ	いのちがけ	inochigake
人間らしい	にんげんらしい	ninngennrashii
どん底	どんぞこ	donnzoko
息づく	いきづく	ikiduku
身代わり	みがわり	migawari
下取り	したどり	shitadori
買い方	かいかた	kaikata
買い手	かいて	kaite
出入り口	でいりぐち	deiriguchi
交ぜる	まぜる	mazeru
何だかんだ	なんだかんだ	nanndakannda
左利き	ひだりきき	hidarikiki
連れ出す	つれだす	tsuredasu
切れ目	きれめ	kireme
流れ星	ながれぼし	nagareboshi
お初	おはつ	ohatsu
思い思い	おもいおもい	omoiomoi
丸み	まるみ	marumi
引き立つ	ひきたつ	hikitatsu
手早い	てばやい	tebayai
立たす	たたす	tatasu
弱める	よわめる	yowameru
書き手	かきて	kakite
害す	がいす	gaisu
草の根	くさのね	kusanone
心待ち	こころまち	kokoromachi
後ろ向き	うしろむき	ushiromuki
木の下	このした|このもと	konoshita|konomoto
温かみ	あたたかみ	atatakami
出し合う	だしあう|だしおう	dashiau|dashiou
立会う	たちあう|たちおう	tachiau|tachiou
ご時世	ごじせい	gojisei
持ちかける	もちかける	mochikakeru
生き残れる	いきのこれる	ikinokoreru
書き直し	かきなおし	kakinaoshi
回せる	まわせる	mawaseru
色あせる	いろあせる	iroaseru
決す	けっす	kessu
気にいる	きにいる	kiniiru
競い合う	きそいあう|きそいおう	kisoiau|kisoiou
焼ける	やける	yakeru
お山	おやま	oyama
出直し	でなおし	denaoshi
住まう	すまう|ずまう	sumau|zumau
合わさる	あわさる	awasaru
見ごたえ	みごたえ	migotae
取り合い	とりあい	toriai
早まる	はやまる	hayamaru
昼下がり	ひるさがり	hirusagari
束ね	たばね|つかね	tabane|tsukane
和らぐ	やわらぐ	yawaragu
気がかり	きがかり	kigakari
変わり目	かわりめ	kawarime
通ずる	つうずる	tsuuzuru
真っ向	まっこう	makkou
引き出物	ひきでもの	hikidemono
漁る	あさる|すなどる	asaru|sunadoru
聞える	きこえる	kikoeru
手放せる	てばなせる	tebanaseru
取っ手	とって	totte
手直し	てなおし	tenaoshi
悲しむ	かなしむ	kanashimu
つ折り	つおり	tsuori
人通り	ひとどおり	hitodoori
見分ける	みわける	miwakeru
弱み	よわみ	yowami
行く末	ゆくすえ	yukusue
遊び方	あそびかた	asobikata
受入れ	うけいれ	ukeire
持ち上がる	もちあがる	mochiagaru
買上げ	かいあげ	kaiage
見計らう	みはからう	mihakarau
信ずる	しんずる	shinnzuru
息切れ	いきぎれ	ikigire
追いつめる	おいつめる	oitsumeru
下り坂	くだりざか	kudarizaka
取り引き	とりひき	torihiki
取り立て	とりたて	toritate
待ち望む	まちのぞむ	machinozomu
見にくい	みにくい	minikui
空売り	からうり	karauri
そよ風	そよかぜ	soyokaze
宮参り	みやまいり	miyamairi
食い止める	くいとめる	kuitomeru
手の平	てのひら	tenohira
つかの間	つかのま	tsukanoma
物言い	ものいい|ものゆい	monoii|monoyui
感ずる	かんずる	kannzuru
今どき	いまどき	imadoki
顔出し	かおだし	kaodashi
聞き手	ききて	kikite
黒っぽい	くろっぽい	kuroppoi
立ちはだかる	たちはだかる	tachihadakaru
立ち回り	たちまわり	tachimawari
末っ子	すえっこ	suekko
思しい	おぼしい	oboshii
悪しい	あしい	ashii
交わり	まじわり	majiwari
大根おろし	だいこんおろし	daikonnoroshi
太め	ふとめ	futome
目新しい	めあたらしい	meatarashii
守れる	まもれる	mamoreru
秋晴れ	あきばれ	akibare
組み立てる	くみたてる	kumitateru
言い返す	いいかえす	iikaesu
束の間	つかのま	tsukanoma
曲る	まがる	magaru
初日の出	はつひので	hatsuhinode
宿す	しゅくす|やどす	shukusu|yadosu
流れ出る	ながれでる	nagarederu
生まれつき	うまれつき	umaretsuki
勝ち負け	かちまけ	kachimake
肉じゃが	にくじゃが	nikujaga
売り出す	うりだす	uridasu
発つ	たつ	tatsu
画す	かくす	kakusu
立ち入る	たちいる	tachiiru
平たい	ひらたい	hiratai
目の下	めのした	menoshita
練り歩く	ねりあるく	neriaruku
顔合わせ	かおあわせ	kaoawase
変り	かわり|がわり	kawari|gawari
時間切れ	じかんぎれ	jikanngire
か国	かこく	kakoku
時として	ときとして	tokitoshite
会す	かいす|くわす	kaisu|kuwasu
下書き	したがき	shitagaki
買出し	かいだし	kaidashi
然し	しかし	shikashi
世にも	よにも	yonimo
取り組める	とりくめる	torikumeru
語り口	かたりくち	katarikuchi
取り付く	とりつく	toritsuku
と同時に	とどうじに	todoujini
見づらい	みづらい	midurai
手間取る	てまどる	temadoru
重ね合う	かさねあう|かさねおう	kasaneau|kasaneou
商い	あきない	akinai
古び	ふるび	furubi
仲直り	なかなおり	nakanaori
連れ去る	つれさる	tsuresaru
追いつける	おいつける	oitsukeru
見せ付ける	みせつける	misetsukeru
度重なる	たびかさなる	tabikasanaru
心がける	こころがける	kokorogakeru
見出せる	みだせる|みいだせる	midaseru|miidaseru
たどり着ける	たどりつける	tadoritsukeru
数え切れる	かぞえきれる	kazoekireru
ひと味	ひとあじ	hitoaji
辞す	じす	jisu
思い知る	おもいしる	omoishiru
竹の子	たけのこ	takenoko
買いもの	かいもの	kaimono
ひき肉	ひきにく	hikiniku
買い出し	かいだし	kaidashi
強がる	つよがる	tsuyogaru
泣く泣く	なくなく	nakunaku
来す	きたす	kitasu
こぼれ話	こぼればなし	koborebanashi
働きかける	はたらきかける	hatarakikakeru
乗り切れる	のりきれる	norikireru
青白い	あおじろい	aojiroi
関す	かんす	kannsu
お次	おつぎ	otsugi
泣き声	なきごえ	nakigoe
こみ上げる	こみあげる	komiageru
草むら	くさむら	kusamura
馬鹿馬鹿しい	ばかばかしい	bakabakashii
見あたる	みあたる	miataru
走り去る	はしりさる	hashirisaru
聞き返す	ききかえす	kikikaesu
やり直す	やりなおす	yarinaosu
持ち直す	もちなおす	mochinaosu
念入り	ねんいり	nenniri
差し歯	さしば	sashiba
折り合い	おりあい	oriai
愛せる	あいせる	aiseru
遠ざける	とおざける	toozakeru
語れる	かたれる	katareru
別売り	べつうり	betsuuri
取り置く	とりおく	torioku
見やる	みやる	miyaru
引ける	ひける|びける	hikeru|bikeru
聞き出す	ききだす	kikidasu
お力	おちから	ochikara
飛び乗る	とびのる	tobinoru
見放す	みはなす	mihanasu
地すべり	じすべり	jisuberi
日当り	ひあたり	hiatari
引き落とし	ひきおとし	hikiotoshi
お目見え	おめみえ	omemie
黄ばむ	きばむ	kibamu
言い切る	いいきる	iikiru
空回り	からまわり	karamawari
信ぴょう	しんぴょう	shinnpyou
炭焼き	すみやき	sumiyaki
お開き	おひらき	ohiraki
顔見知り	かおみしり	kaomishiri
反り	そり|ぞり	sori|zori
波乗り	なみのり	naminori
使い手	つかいて	tsukaite
朝焼け	あさやけ	asayake
高らか	たからか	takaraka
飛び入り	とびいり	tobiiri
お日様	おひさま	ohisama
使い分ける	つかいわける	tsukaiwakeru
仕打ち	しうち	shiuchi
目玉焼き	めだまやき	medamayaki
六つ	むっつ|むつ	muttsu|mutsu
愛し合う	あいしあう|あいしおう	aishiau|aishiou
住み着く	すみつく	sumitsuku
打ち消す	うちけす	uchikesu
動じる	どうじる	doujiru
散りばめる	ちりばめる	chiribameru
見向く	みむく	mimuku
空き家	あきや	akiya
心ゆく	こころゆく	kokoroyuku
切り返し	きりかえし	kirikaeshi
安上がり	やすあがり	yasuagari
かみ合う	かみあう|かみおう	kamiau|kamiou
考え出す	かんがえだす	kanngaedasu
酒飲み	さけのみ	sakenomi
取り決め	とりきめ	torikime
出合う	であう|でおう	deau|deou
足止め	あしどめ	ashidome
組立て	くみたて	kumitate
横ばい	よこばい	yokobai
ひと月	ひとつき	hitotsuki
あっと言う間に	あっというまに	attoiumani
輪切り	わぎり	wagiri
残り少ない	のこりすくない	nokorisukunai
水切り	みずきり	mizukiri
ほど遠い	ほどとおい	hodotooi
運べる	はこべる	hakoberu
生やす	はやす	hayasu
お仕置き	おしおき	oshioki
元通り	もとどおり	motodoori
人ごみ	ひとごみ	hitogomi
形作る	かたちづくる	katachidukuru
お茶屋	おちゃや	otyaya
草取り	くさとり	kusatori
起こせる	おこせる	okoseru
結び付ける	むすびつける	musubitsukeru
黒ずみ	くろずみ	kurozumi
打ち合う	うちあう|うちおう	uchiau|uchiou
山の幸	やまのさち	yamanosachi
出し切る	だしきる	dashikiru
的外れ	まとはずれ	matohazure
かみ合わせ	かみあわせ	kamiawase
面白み	おもしろみ	omoshiromi
思いがける	おもいがける	omoigakeru
真っ当	まっとう	mattou
通り道	とおりみち	toorimichi
代り	かわり|がわり	kawari|gawari
言い残す	いいのこす	iinokosu
灯す	ともす	tomosu
すき間	すきま	sukima
茶の湯	ちゃのゆ	tyanoyu
言わす	いわす	iwasu
散らかす	ちらかす	chirakasu
省ける	はぶける	habukeru
年老いる	としおいる	toshioiru
お受け取り	おうけとり	ouketori
切り分け	きりわけ	kiriwake
愛でる	めでる	mederu
治せる	なおせる	naoseru
ため池	ためいけ	tameike
競り	せり|ぜり	seri|zeri
道しるべ	みちしるべ	michishirube
流れ出す	ながれだす	nagaredasu
手ぶら	てぶら	tebura
仕返し	しかえし	shikaeshi
仕組む	しくむ	shikumu
面持ち	おももち	omomochi
女らしい	おんならしい	onnnarashii
人だかり	ひとだかり	hitodakari
むし歯	むしば	mushiba
落ちつく	おちつく	ochitsuku
受け持つ	うけもつ	ukemotsu
湯たんぽ	ゆたんぽ	yutannpo
仕入れる	しいれる	shiireru
積み立て	つみたて	tsumitate
自ずと	おのずと	onozuto
明ける	あける	akeru
利上げ	りあげ	riage
取り返す	とりかえす	torikaesu
力む	りきむ	rikimu
落す	おとす	otosu
共働き	ともばたらき	tomobataraki
念じる	ねんじる	nennjiru
言わば	いわば|ゆわば	iwaba|yuwaba
くり返し	くりかえし	kurikaeshi
積める	つめる	tsumeru
心残り	こころのこり	kokoronokori
思い付く	おもいつく	omoitsuku
科す	かす	kasu
川遊び	かわあそび	kawaasobi
勇ましい	いさましい	isamashii
言いなり	いいなり	iinari
高み	たかみ	takami
生す	なす|むす	nasu|musu
月明かり	つきあかり	tsukiakari
中る	あたる	ataru
安らぐ	やすらぐ	yasuragu
追い上げ	おいあげ	oiage
向かい側	むかいがわ	mukaigawa
食べもの	たべもの	tabemono
登れる	のぼれる	noboreru
雪かき	ゆきかき	yukikaki
小分け	こわけ	kowake
付け足す	つけたす	tsuketasu
底上げ	そこあげ	sokoage
真新しい	まあたらしい	maatarashii
暑苦しい	あつくるしい	atsukurushii
向き直る	むきなおる	mukinaoru
小回り	こまわり	komawari
笑い話	わらいばなし	waraibanashi
今一つ	いまひとつ	imahitotsu
焼き魚	やきざかな	yakizakana
一番乗り	いちばんのり	ichibannnori
持ち前	もちまえ	mochimae
っ放し	っぱなし	ppanashi
乗っける	のっける	nokkeru
案じ	あんじ	annji
付け方	つけかた	tsukekata
申し受ける	もうしうける	moushiukeru
受け付ける	うけつける	uketsukeru
横向き	よこむき	yokomuki
切り取り	きりとり	kiritori
名指し	なざし	nazashi
売り手	うりて	urite
取調べ	とりしらべ	torishirabe
不意打ち	ふいうち	fuiuchi
取りかかる	とりかかる	torikakaru
取り下げ	とりさげ	torisage
にじみ出る	にじみでる	nijimideru
決する	けっする	kessuru
飲ます	のます	nomasu
口出し	くちだし	kuchidashi
落ちこぼれ	おちこぼれ	ochikobore
馬鹿げる	ばかげる	bakageru
散らかる	ちらかる	chirakaru
切り身	きりみ	kirimi
聞き分け	ききわけ	kikiwake
何でもかんでも	なんでもかんでも	nanndemokanndemo
打ち勝つ	うちかつ	uchikatsu
引っ	ひっ	hixtu
組み入れる	くみいれる	kumiireru
風向き	かざむき|かぜむき	kazamuki|kazemuki
思いきり	おもいきり	omoikiri
はみ出る	はみでる	hamideru
売り子	うりこ	uriko
何もの	なにもの	nanimono
省みる	かえりみる	kaerimiru
口説く	くどく	kudoku
でっち上げ	でっちあげ	decchiage
後ろめたい	うしろめたい	ushirometai
心細い	こころぼそい	kokorobosoi
さらけ出す	さらけだす	sarakedasu
急きょ	きゅうきょ	kyuukyo
面する	めんする	mennsuru
結う	ゆう|むすう	yuu|musuu
間仕切り	まじきり	majikiri
受け取れる	うけとれる	uketoreru
外回り	そとまわり	sotomawari
通せる	とおせる	tooseru
顔負け	かおまけ	kaomake
多少なりとも	たしょうなりとも	tashounaritomo
題する	だいする	daisuru
見切る	みきる	mikiru
空き巣	あきす	akisu
出来栄え	できばえ	dekibae
行き止まり	いきどまり|ゆきどまり	ikidomari|yukidomari
お孫さん	おまごさん	omagosann
照れくさい	てれくさい	terekusai
極まる	きわまる|きまる	kiwamaru|kimaru
起す	おこす|きす	okosu|kisu
送り火	おくりび	okuribi
追い付く	おいつく	oitsuku
使い果たす	つかいはたす	tsukaihatasu
平らげる	たいらげる	tairageru
ぶっ飛ばす	ぶっとばす	buttobasu
下調べ	したしらべ	shitashirabe
泳がせる	およがせる	oyogaseru
下向き	したむき	shitamuki
売切れる	うりきれる	urikireru
手つき	てつき	tetsuki
皮ふ	ひふ	hifu
出し物	だしもの	dashimono
必ずや	かならずや	kanarazuya
折り曲げる	おりまげる	orimageru
活ける	いける	ikeru
生まれながら	うまれながら	umarenagara
相成る	あいなる	ainaru
冷す	ひやす	hiyasu
手ごたえ	てごたえ	tegotae
刷る	する|ずる	suru|zuru
大急ぎ	おおいそぎ	ooisogi
お早う	おはよう	ohayou
取りやめ	とりやめ	toriyame
何ぞ	なぞ	nazo
聞きつける	ききつける	kikitsukeru
引き戸	ひきど	hikido
建て直す	たてなおす	tatenaosu
重苦しい	おもくるしい	omokurushii
生け花	いけばな	ikebana
通える	かよえる	kayoeru
申しわけ	もうしわけ	moushiwake
拾い上げる	ひろいあげる	hiroiageru
大き目	おおきめ	ookime
わが身	わがみ	wagami
出合い	であい	deai
小売り	こうり	kouri
重なり合う	かさなりあう|かさなりおう	kasanariau|kasanariou
名ばかり	なばかり	nabakari
朝っぱら	あさっぱら	asappara
山の神	やまのかみ	yamanokami
二の丸	にのまる	ninomaru
見聞き	みきき	mikiki
もんじゃ焼き	もんじゃやき	monnjayaki
転び	ころび|まろび	korobi|marobi
思わす	おもわす	omowasu
利食い	りぐい	rigui
お上	おかみ	okami
まかり通る	まかりとおる	makaritooru
冷やかす	ひやかす	hiyakasu
入れ物	いれもの	iremono
引っぱる	ひっぱる	hipparu
火入れ	ひいれ	hiire
引き付ける	ひきつける	hikitsukeru
立て直す	たてなおす	tatenaosu
差し止め	さしとめ|さしどめ	sashitome|sashidome
来たす	きたす	kitasu
けが人	けがにん	keganinn
様変わり	さまがわり	samagawari
飛び上がる	とびあがる	tobiagaru
見回り	みまわり	mimawari
指せる	させる	saseru
先走る	さきばしる	sakibashiru
横取り	よこどり	yokodori
冷ややか	ひややか	hiyayaka
ほうじ茶	ほうじちゃ	houjitya
語り手	かたりて	katarite
絵はがき	えはがき	ehagaki
行き場	いきば|ゆきば	ikiba|yukiba
ほろ苦い	ほろにがい	horonigai
受け身	うけみ	ukemi
引出し	ひきだし	hikidashi
かき集める	かきあつめる	kakiatsumeru
入り組む	いりくむ	irikumu
色分け	いろわけ	irowake
牛耳る	ぎゅうじる	gyuujiru
下手くそ	へたくそ	hetakuso
野放し	のばなし	nobanashi
見もの	みもの	mimono
仲良い	なかよい	nakayoi
数の子	かずのこ	kazunoko
取り去る	とりさる	torisaru
お手上げ	おてあげ	oteage
すっ飛ぶ	すっとぶ	suttobu
根こそぎ	ねこそぎ	nekosogi
出歩く	であるく	dearuku
見かねる	みかねる	mikaneru
よもやま話	よもやまばなし	yomoyamabanashi
本立て	ほんたて|ほんだて	honntate|honndate
少い	しょうい|すくない|わかい	shoui|sukunai|wakai
人となり	ひととなり	hitotonari
休まる	やすまる	yasumaru
待ちかねる	まちかねる	machikaneru
勇気づける	ゆうきづける	yuukidukeru
身の上	みのうえ	minoue
表れる	あらわれる	arawareru
切り出す	きりだす	kiridasu
夜な夜な	よなよな	yonayona
身だしなみ	みだしなみ	midashinami
日持ち	ひもち	himochi
心苦しい	こころぐるしい	kokorogurushii
さり気	さりげ	sarige
年取る	としとる	toshitoru
残れる	のこれる	nokoreru
巣立つ	すだつ	sudatsu
売り買い	うりかい	urikai
ふき取る	ふきとる	fukitoru
かつお節	かつおぶし	katsuobushi
歯切れ	はぎれ	hagire
表せる	あらわせる	arawaseru
うま味	うまみ	umami
結び方	むすびかた	musubikata
花き	かき	kaki
死にかける	しにかける	shinikakeru
受け手	うけて	ukete
目利き	めきき	mekiki
取り出せる	とりだせる	toridaseru
買付け	かいつけ	kaitsuke
受け流す	うけながす	ukenagasu
湯けむり	ゆけむり	yukemuri
口付け	くちづけ	kuchiduke
付きまとう	つきまとう	tsukimatou
見て取る	みてとる	mitetoru
根っから	ねっから	nekkara
量る	はかる	hakaru
暗に	あんに	annni
口走る	くちばしる	kuchibashiru
反る	そる|ぞる	soru|zoru
歌い手	うたいて	utaite
夜遊び	よあそび	yoasobi
静まり返る	しずまりかえる	shizumarikaeru
細切り	こまぎり|ほそぎり	komagiri|hosogiri
立ち会い	たちあい	tachiai
青ざめる	あおざめる	aozameru
三つ葉	みつば	mitsuba
向かい風	むかいかぜ	mukaikaze
連ねる	つらねる	tsuraneru
お幸せ	おしあわせ	oshiawase
一人っ子	ひとりっこ	hitorikko
最たる	さいたる	saitaru
受け売り	うけうり	ukeuri
歯ぐき	はぐき	haguki
かけ声	かけごえ	kakegoe
大金持ち	おおがねもち	ooganemochi
負かす	まかす	makasu
ひな人形	ひなにんぎょう	hinaninngyou
積み木	つみき	tsumiki
待ちわびる	まちわびる	machiwabiru
間引き	まびき	mabiki
お祭	おまつり	omatsuri
手始め	てはじめ	tehajime
波打つ	なみうつ	namiutsu
米ぬか	こめぬか	komenuka
組み立る	くみたてる	kumitateru
知ったかぶり	しったかぶり	shittakaburi
かもし出す	かもしだす	kamoshidasu
事欠く	ことかく	kotokaku
石ころ	いしころ	ishikoro
取り外す	とりはずす	torihazusu
見ず知らず	みずしらず	mizushirazu
焼き付け	やきつけ	yakitsuke
活き活き	いきいき	ikiiki
立ち見	たちみ	tachimi
大引け	おおびけ	oobike
水たまり	みずたまり	mizutamari
苦み	にがみ	nigami
強いる	しいる|じいる	shiiru|jiiru
しょう油	しょうゆ	shouyu
曲がり角	まがりかど	magarikado
下ごしらえ	したごしらえ	shitagoshirae
試せる	ためせる	tameseru
売れっ子	うれっこ	urekko
二の次	にのつぎ	ninotsugi
書き残す	かきのこす	kakinokosu
立ち返る	たちかえる	tachikaeru
よじ登る	よじのぼる	yojinoboru
引き止める	ひきとめる	hikitomeru
読み取れる	よみとれる	yomitoreru
手強い	てごわい|てづよい	tegowai|teduyoi
紙おむつ	かみおむつ	kamiomutsu
心持ち	こころもち	kokoromochi
思い出深い	おもいでぶかい	omoidebukai
道連れ	みちづれ	michidure
関する	かんする	kannsuru
出ろ	しゅつろ|でろ|いでろ	shutsuro|dero|idero
引っかける	ひっかける	hikkakeru
行く手	ゆくて	yukute
水はけ	みずはけ	mizuhake
落つ	おつ	otsu
配す	はいす	haisu
くじ引き	くじびき	kujibiki
積み重なる	つみかさなる	tsumikasanaru
利下げ	りさげ	risage
成り下がる	なりさがる	narisagaru
道行く	みちゆく	michiyuku
整然と	せいぜんと	seizennto
売りつける	うりつける	uritsukeru
もも肉	ももにく	momoniku
血まみれ	ちまみれ	chimamire
発がん	はつがん	hatsugann
覚え書き	おぼえがき	oboegaki
手立て	てだて	tedate
取り急ぎ	とりいそぎ	toriisogi
浅はか	あさはか	asahaka
お先に	おさきに	osakini
受け答え	うけこたえ	ukekotae
船乗り	ふなのり	funanori
育て上げる	そだてあげる	sodateageru
太刀打ち	たちうち	tachiuchi
灯る	ともる	tomoru
売れ残る	うれのこる	urenokoru
明るみ	あかるみ	akarumi
紙切れ	かみきれ	kamikire
泣き虫	なきむし	nakimushi
問いただす	といただす	toitadasu
一回り	ひとまわり	hitomawari
生みだす	うみだす	umidasu
乗り気	のりき	noriki
耳かき	みみかき	mimikaki
打ち付ける	うちつける	uchitsukeru
ごった返す	ごったがえす	gottagaesu
立ち上る	たちのぼる	tachinoboru
歌い上げる	うたいあげる	utaiageru
化ける	ばける	bakeru
売れ残り	うれのこり	urenokori
勝ち残る	かちのこる	kachinokoru
果す	はたす	hatasu
馬鹿らしい	ばからしい	bakarashii
湯の花	ゆのはな	yunohana
飲み食い	のみくい	nomikui
感じとる	かんじとる	kannjitoru
雨宿り	あまやどり	amayadori
送り先	おくりさき	okurisaki
勇む	いさむ	isamu
考え事	かんがえごと	kanngaegoto
赤とんぼ	あかとんぼ	akatonnbo
夜泣き	よなき	yonaki
食わす	くわす	kuwasu
祝い事	いわいごと	iwaigoto
かき消す	かきけす	kakikesu
お宮	おみや	omiya
ふる里	ふるさと	furusato
ごみ箱	ごみばこ	gomibako
読み出し	よみだし	yomidashi
和気あいあい	わきあいあい	wakiaiai
産める	うめる	umeru
心配り	こころくばり	kokorokubari
足もと	あしもと	ashimoto
上がれる	あがれる	agareru
位置決め	いちぎめ	ichigime
落ちぶれる	おちぶれる	ochibureru
天引き	てんびき	tennbiki
然るべき	しかるべき	shikarubeki
赤らめる	あからめる	akarameru
聞き覚え	ききおぼえ	kikioboe
力持ち	ちからもち	chikaramochi
借入れ	かりいれ	kariire
引き立てる	ひきたてる	hikitateru
小走り	こばしり	kobashiri
明い	あい	ai
気高い	けだかい	kedakai
温い	ぬくい|ぬるい|ぬきい|ぬりい	nukui|nurui|nukii|nurii
運び出す	はこびだす	hakobidasu
歯みがき	はみがき	hamigaki
落ち度	おちど	ochido
取り合わせ	とりあわせ	toriawase
申し出る	もうしでる	moushideru
引き下げる	ひきさげる	hikisageru
満たせる	みたせる	mitaseru
水浴び	みずあび	mizuabi
買わす	かわす	kawasu
身なり	みなり	minari
引き下がる	ひきさがる	hikisagaru
香典返し	こうでんがえし	koudenngaeshi
は種	はしゅ	hashu
持ちこたえる	もちこたえる	mochikotaeru
足し算	たしざん	tashizann
かき回す	かきまわす	kakimawasu
悪しからず	あしからず	ashikarazu
愛くるしい	あいくるしい	aikurushii
雲行き	くもゆき	kumoyuki
照る	てる	teru
火照る	ほてる	hoteru
作り話	つくりばなし	tsukuribanashi
人付き合い	ひとづきあい	hitodukiai
ほど近い	ほどちかい	hodochikai
思いきる	おもいきる	omoikiru
下回り	したまわり	shitamawari
折り返す	おりかえす	orikaesu
照れる	てれる	tereru
残り物	のこりもの	nokorimono
人知れず	ひとしれず	hitoshirezu
引上げ	ひきあげ	hikiage
当り前	あたりまえ	atarimae
気休め	きやすめ	kiyasume
冷や	ひや	hiya
当て字	あてじ	ateji
駅前通り	えきまえどおり	ekimaedoori
ちゃぶ台	ちゃぶだい	tyabudai
もぎ取る	もぎとる	mogitoru
おとぎ話	おとぎばなし	otogibanashi
色付く	いろづく	iroduku
木の芽	きのめ|このめ	kinome|konome
一人ぼっち	ひとりぼっち	hitoribocchi
食いしばる	くいしばる	kuishibaru
言いがかり	いいがかり	iigakari
けん引	けんいん	kenninn
ご用	ごよう	goyou
取り次ぎ	とりつぎ	toritsugi
思い直す	おもいなおす	omoinaosu
丸まる	まるまる	marumaru
極めつけ	きわめつけ	kiwametsuke
高ぶる	たかぶる	takaburu
手出し	てだし	tedashi
言わずもがな	いわずもがな	iwazumogana
練り上げる	ねりあげる	neriageru
送り返す	おくりかえす	okurikaesu
血の気	ちのけ	chinoke
晴れやか	はれやか	hareyaka
気晴らし	きばらし	kibarashi
湯のみ	ゆのみ	yunomi
安め	やすめ	yasume
後ろ足	うしろあし	ushiroashi
分け合う	わけあう|わけおう	wakeau|wakeou
名残り	なごり	nagori
そびえ立つ	そびえたつ	sobietatsu
三の丸	さんのまる	sannnomaru
お出で	おいで	oide
道すがら	みちすがら	michisugara
山開き	やまびらき	yamabiraki
結び目	むすびめ	musubime
持たす	もたす	motasu
立ち話	たちばなし	tachibanashi
目まぐるしい	めまぐるしい	memagurushii
水しぶき	みずしぶき	mizushibuki
追い返す	おいかえす	oikaesu
おすそ分け	おすそわけ	osusowake
酒好き	さけずき	sakezuki
行く先	ゆくさき	yukusaki
巣立ち	すだち	sudachi
飛び道具	とびどうぐ	tobidougu
話し相手	はなしあいて	hanashiaite
ほ場	ほじょう	hojou
い草	いぐさ	igusa
静まる	しずまる	shizumaru
先回り	さきまわり	sakimawari
すり身	すりみ	surimi
暗がり	くらがり	kuragari
守り神	まもりがみ	mamorigami
昔ばなし	むかしばなし	mukashibanashi
読み切り	よみきり	yomikiri
打ち立てる	うちたてる	uchitateru
行き帰り	いきかえり|ゆきかえり	ikikaeri|yukikaeri
高鳴る	たかなる	takanaru
石積み	いしつみ|いしづみ	ishitsumi|ishidumi
新入り	しんいり	shinniri
火消し	ひけし|びけし	hikeshi|bikeshi
書き記す	かきしるす	kakishirusu
作付け	さくづけ|つくりつけ|さくつけ	sakuduke|tsukuritsuke|sakutsuke
焼き付く	やきつく	yakitsuku
位置づける	いちづける	ichidukeru
図れる	はかれる	hakareru
早わかり	はやわかり	hayawakari
だまし取る	だましとる	damashitoru
真っ白い	まっしろい	masshiroi
打ちのめす	うちのめす|ぶちのめす	uchinomesu|buchinomesu
変わり者	かわりもの	kawarimono
行き方	いきかた|ゆきかた|ゆきがた	ikikata|yukikata|yukigata
役どころ	やくどとろ|やくどころ	yakudotoro|yakudokoro
力いっぱい	ちからいっぱい	chikaraippai
立ち直り	たちなおり	tachinaori
熱っぽい	ねつっぽい	netsuppoi
和え物	あえもの	aemono
物入れ	ものいれ	monoire
思へる	おもへる	omoheru
お玉	おたま	otama
山あい	やまあい	yamaai
草分け	くさわけ	kusawake
大人びる	おとなびる	otonabiru
連なり	つらなり	tsuranari
勝ち進む	かちすすむ	kachisusumu
とり方	とりかた	torikata
焼きうどん	やきうどん	yakiudonn
流れ落ちる	ながれおちる	nagareochiru
組み上げる	くみあげる	kumiageru
落っこちる	おっこちる	okkochiru
日めくり	ひめくり	himekuri
調う	ととのう	totonou
取りつける	とりつける	toritsukeru
代える	かえる	kaeru
楽ちん	らくちん	rakuchinn
間借り	まがり	magari
引受け	ひきうけ	hikiuke
果ては	はては	hateha
お通し	おとおし	otooshi
後ずさる	あとずさる	atozusaru
言い争う	いいあらそう	iiarasou
大はしゃぎ	おおはしゃぎ	oohashagi
北の方	きたのかた	kitanokata
今に	いまに	imani
秒読み	びょうよみ	byouyomi
目出度い	めでたい	medetai
のし紙	のしがみ	noshigami
先読み	さきよみ	sakiyomi
投げやり	なげやり	nageyari
動きだす	うごきだす	ugokidasu
笑いかける	わらいかける	waraikakeru
持ち家	もちいえ|もちや	mochiie|mochiya
書き出す	かきだす	kakidasu
下ろせる	おろせる	oroseru
心して	こころして	kokoroshite
横書き	よこがき	yokogaki
物書き	ものかき	monokaki
へき地	へきち	hekichi
上向く	うわむく	uwamuku
歯がゆい	はがゆい	hagayui
流れ着く	ながれつく	nagaretsuku
改まる	あらたまる	aratamaru
考えつく	かんがえつく	kanngaetsuku
察する	さっする	sassuru
沖合い	おきあい	okiai
勝ち星	かちぼし	kachiboshi
夏みかん	なつみかん	natsumikann
起つ	たつ|だつ|おこつ	tatsu|datsu|okotsu
遊び人	あそびにん	asobininn
使い古す	つかいふるす	tsukaifurusu
立ちあがる	たちあがる	tachiagaru
打上げる	うちあげる	uchiageru
どんでん返し	どんでんがえし	donndenngaeshi
物差し	ものさし	monosashi
打ち上げ花火	うちあげはなび	uchiagehanabi
黒ずむ	くろずむ	kurozumu
か弱い	かよわい	kayowai
帰りがけ	かえりがけ	kaerigake
言いよう	いいよう	iiyou
出っ歯	でっぱ	deppa
つまみ食い	つまみぐい	tsumamigui
回れる	まわれる|めぐれる	mawareru|megureru
泣きつく	なきつく	nakitsuku
ただ中	ただなか	tadanaka
速める	はやめる	hayameru
代る	かわる|がわる	kawaru|gawaru
文字どおり	もじどおり	mojidoori
照りつける	てりつける	teritsukeru
手ほどき	てほどき	tehodoki
何時の間にか	いつのまにか	itsunomanika
気付かす	きづかす	kidukasu
打ち水	うちみず	uchimizu
目と	もくと	mokuto
見て取れる	みてとれる	mitetoreru
仕送り	しおくり	shiokuri
茶化す	ちゃかす	tyakasu
働き者	はたらきもの	hatarakimono
口説き	くどき	kudoki
有り様	ありさま|ありよう	arisama|ariyou
ひと目	ひとめ	hitome
乗り上げる	のりあげる	noriageru
日向ぼっこ	ひなたぼっこ	hinatabokko
物好き	ものずき	monozuki
物申す	ものもうす	monomousu
切り立つ	きりたつ	kiritatsu
平が	へいが|たいらが	heiga|tairaga
もみ合う	もみあう|もみおう	momiau|momiou
取り分け	とりわけ	toriwake
近しい	ちかしい	chikashii
こき使う	こきつかう|こきつこう	kokitsukau|kokitsukou
手の内	てのうち	tenouchi
火の玉	ひのたま	hinotama
書き直す	かきなおす	kakinaosu
労う	ねぎらう|ねぎろう	negirau|negirou
知らん顔	しらんかお	shirannkao
飛び起きる	とびおきる	tobiokiru
平泳ぎ	ひらおよぎ	hiraoyogi
ぶった切る	ぶったぎる	buttagiru
お人好し	おひとよし	ohitoyoshi
言いつける	いいつける	iitsukeru
打ち止め	うちどめ|うちとめ	uchidome|uchitome
体つき	からだつき	karadatsuki
関連づける	かんれんづける	kannrenndukeru
根回し	ねまわし	nemawashi
麦わら	むぎわら	mugiwara
立てこもる	たてこもる	tatekomoru
首切り	くびきり	kubikiri
区分け	くわけ	kuwake
にごり酒	にごりざけ	nigorizake
転げ落ちる	ころげおちる	korogeochiru
お母ちゃん	おかあちゃん	okaatyann
結べる	むすべる	musuberu
皮肉る	ひにくる	hinikuru
折り目	おりめ	orime
入れ直す	いれなおす	irenaosu
作りだす	つくりだす	tsukuridasu
小出し	こだし	kodashi
口づけ	くちづけ	kuchiduke
香の物	こうのもの	kounomono
生ぬるい	なまぬるい	namanurui
手付かず	てつかず	tetsukazu
水っぽい	みずっぽい	mizuppoi
飛び火	とびひ	tobihi
足がかり	あしがかり	ashigakari
問える	とえる	toeru
借り物	かりもの	karimono
命取り	いのちとり	inochitori
引下げ	ひきさげ	hikisage
客引き	きゃくひき	kyakuhiki
しめ縄	しめなわ	shimenawa
歯ぎしり	はぎしり	hagishiri
話し声	はなしごえ	hanashigoe
真っすぐ	まっすぐ	massugu
急かす	せかす	sekasu
早める	はやめる	hayameru
果てる	はてる	hateru
お母さま	おかあさま	okaasama
売り切れる	うりきれる	urikireru
引きずり出す	ひきずりだす	hikizuridasu
差し置く	さしおく	sashioku
付する	ふする	fusuru
三つ子	みつご	mitsugo
研く	みがく	migaku
通りかかる	とおりかかる	toorikakaru
行かす	いかす	ikasu
見せびらかす	みせびらかす	misebirakasu
まん丸	まんまる	mannmaru
書き写す	かきうつす	kakiutsusu
起きあがる	おきあがる	okiagaru
風変わり	ふうがわり	fuugawari
日の目	ひのめ	hinome
何たる	なんたる	nanntaru
大当り	おおあたり	ooatari
持ち去る	もちさる	mochisaru
虫食い	むしくい	mushikui
手ごわい	てごわい	tegowai
ならず者	ならずもの	narazumono
成りすます	なりすます	narisumasu
あて先	あてさき	atesaki
人さま	ひとさま	hitosama
作りあげる	つくりあげる	tsukuriageru
ろう者	ろうしゃ	rousha
耳打ち	みみうち	mimiuchi
あの手この手	あのてこのて	anotekonote
思い出せる	おもいだせる	omoidaseru
そら豆	そらまめ	soramame
鼻くそ	はなくそ	hanakuso
ふ頭	ふとう	futou
願い出る	ねがいでる	negaideru
切り花	きりばな	kiribana
近付ける	ちかづける	chikadukeru
真後ろ	まうしろ	maushiro
物静か	ものしずか	monoshizuka
究める	きわめる	kiwameru
投げ入れ	なげいれ	nageire
草むしり	くさむしり	kusamushiri
道ばた	みちばた	michibata
物知り	ものしり	monoshiri
親ばか	おやばか	oyabaka
時の間	ときのま	tokinoma
取り仕切る	とりしきる	torishikiru
こじ開ける	こじあける	kojiakeru
地べた	じべた	jibeta
表書き	おもてがき	omotegaki
漁り	いさり|あさり|すなどり	isari|asari|sunadori
家作り	やづくり|いえづくり	yadukuri|iedukuri
お先	おさき	osaki
指折り	ゆびおり	yubiori
思い上がる	おもいあがる	omoiagaru
泣きじゃくる	なきじゃくる	nakijakuru
期する	きする|ごする	kisuru|gosuru
よそ者	よそもの	yosomono
湯上り	ゆあがり	yuagari
すべり台	すべりだい	suberidai
早送り	はやおくり	hayaokuri
起き出す	おきだす	okidasu
耳たぶ	みみたぶ	mimitabu
手だて	てだて	tedate
助け出す	たすけだす	tasukedasu
受けとる	うけとる	uketoru
差し引き	さしひき	sashihiki
見いだせる	みいだせる	miidaseru
事なき	ことなき	kotonaki
女好き	おんなずき	onnnazuki
頭打ち	あたまうち|ずうち	atamauchi|zuuchi
言い様	いいよう	iiyou
ふ化	ふか	fuka
季節外れ	きせつはずれ	kisetsuhazure
取り付き	とりつき	toritsuki
丸焼き	まるやき	maruyaki
夜通し	よどおし	yodooshi
大回り	おおまわり	oomawari
お立ち台	おたちだい	otachidai
取りそろえる	とりそろえる	torisoroeru
消え失せる	きえうせる	kieuseru
引っかく	ひっかく	hikkaku
上げ下げ	あげさげ	agesage
名乗り出る	なのりでる	nanorideru
成り上がる	なりあがる	nariagaru
泣き顔	なきがお	nakigao
見付かる	みつかる	mitsukaru
前のめり	まえのめり	maenomeri
王さま	おうさま	ousama
持ち時間	もちじかん	mochijikann
取りあげる	とりあげる	toriageru
取りこぼす	とりこぼす	torikobosu
分かれ道	わかれみち	wakaremichi
働かす	はたらかす	hatarakasu
服す	ふくす	fukusu
重り	おもり|かさなり	omori|kasanari
読みで	よみで	yomide
心無い	こころない	kokoronai
立ち合う	たちあう|たちおう	tachiau|tachiou
開け放つ	あけはなつ	akehanatsu
引き算	ひきざん	hikizann
流し台	ながしだい	nagashidai
取立て	とりたて	toritate
見てくれ	みてくれ	mitekure
暗む	くらむ|ぐらむ	kuramu|guramu
決め方	きめかた	kimekata
追い打ち	おいうち	oiuchi
借り手	かりて	karite
申し合わせ	もうしあわせ	moushiawase
くせ毛	くせげ	kusege
かき分ける	かきわける	kakiwakeru
落ち目	おちめ	ochime
打ち取る	うちとる	uchitoru
物悲しい	ものがなしい	monoganashii
野焼き	のやき	noyaki
反らす	そらす|ぞらす	sorasu|zorasu
やり直せる	やりなおせる	yarinaoseru
引き出せる	ひきだせる	hikidaseru
まん中	まんなか	mannnaka
面食らう	めんくらう	mennkurau
つり橋	つりばし	tsuribashi
祝す	しゅくす	shukusu
曲がりくねる	まがりくねる	magarikuneru
ひと休み	ひとやすみ	hitoyasumi
取り回す	とりまわす	torimawasu
言の葉	ことのは	kotonoha
読みとる	よみとる	yomitoru
面取り	めんとり	menntori
取次ぐ	とりつぐ	toritsugu
選び出す	えらびだす	erabidasu
回り道	まわりみち	mawarimichi
連れ帰る	つれかえる	tsurekaeru
思い付き	おもいつき	omoitsuki
合い言葉	あいことば	aikotoba
お父ちゃん	おとうちゃん	otoutyann
引きつけ	ひきつけ	hikitsuke
ひ弱	ひよわ	hiyowa
話し出す	はなしだす	hanashidasu
少な目	すくなめ	sukuname
表する	ひょうする	hyousuru
湯飲み	ゆのみ	yunomi
栄える	さかえる|はえる|ばえる	sakaeru|haeru|baeru
ご苦労さん	ごくろうさん	gokurousann
古めかしい	ふるめかしい	furumekashii
送り主	おくりぬし	okurinushi
言い表せる	いいあらわせる	iiarawaseru
乗り回す	のりまわす	norimawasu
立てかける	たてかける	tatekakeru
お出まし	おでまし	odemashi
落ち合う	おちあう|おちおう	ochiau|ochiou
上積み	うわづみ	uwadumi
底なし	そこなし	sokonashi
引続き	ひきつづき	hikitsuduki
車止め	くるまどめ	kurumadome
赤黒い	あかぐろい	akaguroi
積み重ねる	つみかさねる	tsumikasaneru
生きざま	いきざま	ikizama
果して	はたして	hatashite
切りつける	きりつける	kiritsukeru
入れ子	いれこ	ireko
青のり	あおのり	aonori
地合い	じあい	jiai
時たま	ときたま	tokitama
高じる	こうじる	koujiru
泣き言	なきごと	nakigoto
ご苦労さま	ごくろうさま	gokurousama
お手玉	おてだま	otedama
持ち運ぶ	もちはこぶ	mochihakobu
笑い飛ばす	わらいとばす	waraitobasu
赤ら顔	あからがお	akaragao
体たらく	ていたらく	teitaraku
早変わり	はやがわり	hayagawari
火付け	ひつけ	hitsuke
細切れ	こまぎれ	komagire
思いの外	おもいのほか	omoinohoka
役回り	やくまわり	yakumawari
最果て	さいはて	saihate
食い入る	くいいる	kuiiru
か細い	かぼそい	kabosoi
ご来光	ごらいこう	goraikou
ほくそ笑む	ほくそえむ	hokusoemu
名だたる	なだたる	nadataru
見せしめ	みせしめ	miseshime
満ち足りる	みちたりる	michitariru
間にあう	まにあう	maniau
焼き立て	やきたて	yakitate
引き合う	ひきあう|ひきおう	hikiau|hikiou
感極まる	かんきわまる	kannkiwamaru
一区切り	ひとくぎり	hitokugiri
大がかり	おおがかり	oogakari
見知る	みしる	mishiru
中休み	なかやすみ	nakayasumi
生まれたて	うまれたて	umaretate
切り下げ	きりさげ	kirisage
先ごろ	さきごろ	sakigoro
作り物	つくりもの	tsukurimono
打ち合い	うちあい	uchiai
植わる	うわる	uwaru
病みつき	やみつき	yamitsuki
季節はずれ	きせつはずれ	kisetsuhazure
住みつく	すみつく	sumitsuku
言い出せる	いいだせる	iidaseru
色直し	いろなおし	ironaoshi
結び付く	むすびつく	musubitsuku
まき散らす	まきちらす	makichirasu
お引き受け	おひきうけ	ohikiuke
言い当てる	いいあてる	iiateru
どす黒い	どすぐろい	dosuguroi
手こずる	てこずる	tekozuru
ぶり返す	ぶりかえす	burikaesu
分かれ目	わかれめ	wakareme
大の字	だいのじ	dainoji
心もとない	こころもとない	kokoromotonai
物思い	ものおもい	monoomoi
然るに	しかるに	shikaruni
耳鼻いんこう	じびいんこう	jibiinnkou
気味が悪い	きみがわるい	kimigawarui
真直ぐ	まっすぐ	massugu
通りがかり	とおりがかり	toorigakari
原っぱ	はらっぱ	harappa
帳消し	ちょうけし	tyoukeshi
号する	ごうする	gousuru
元気づける	げんきづける	gennkidukeru
たまり場	たまりば	tamariba
見返す	みかえす	mikaesu
乗り入れる	のりいれる	noriireru
仕向け	しむけ	shimuke
高笑い	たかわらい	takawarai
言い表す	いいあらわす	iiarawasu
近ごろ	ちかごろ	chikagoro
打ちつける	うちつける	uchitsukeru
聞き耳	ききみみ	kikimimi
晴れ晴れ	はればれ	harebare
売り飛ばす	うりとばす	uritobasu
負わす	おわす	owasu
転げる	ころげる	korogeru
起り	おこり	okori
思いとどまる	おもいとどまる	omoitodomaru
お下がり	おさがり	osagari
後書き	あとがき	atogaki
先だって	せんだって	senndatte
見い出す	みいだす	miidasu
物言う	ものいう	monoiu
見合わせる	みあわせる	miawaseru
笑む	えむ	emu
見通す	みとおす	mitoosu
宿り	やどり	yadori
話し言葉	はなしことば	hanashikotoba
花開く	はなひらく	hanahiraku
大人げ	おとなげ	otonage
打つ手	うつて	utsute
流せる	ながせる	nagaseru
名付け親	なづけおや	nadukeoya
目覚しい	めざましい	mezamashii
打ち返す	うちかえす	uchikaesu
乗り合わせる	のりあわせる	noriawaseru
食べごろ	たべごろ	tabegoro
表立つ	おもてだつ	omotedatsu
地の利	ちのり	chinori
出そろう	でそろう	desorou
横たえる	よこたえる	yokotaeru
食い下がる	くいさがる	kuisagaru
本通り	ほんどおり	honndoori
病み上がり	やみあがり	yamiagari
直ぐに	すぐに	suguni
反り返る	そりかえる	sorikaeru
一心に	いっしんに	isshinnni
思わせぶり	おもわせぶり	omowaseburi
手つかず	てつかず	tetsukazu
後の祭り	あとのまつり	atonomatsuri
感じ取れる	かんじとれる	kannjitoreru
食む	はむ	hamu
九つ	ここのつ	kokonotsu
明り	あかり	akari
束ねる	たばねる|つかねる	tabaneru|tsukaneru
連れ合い	つれあい	tsureai
半そで	はんそで	hannsode
近付き	ちかづき	chikaduki
思い起こせる	おもいおこせる	omoiokoseru
後ろ手	うしろで	ushirode
お歌	おうた	outa
相乗り	あいのり	ainori
借り上げ	かりあげ	kariage
量り売り	はかりうり	hakariuri
着こなす	きこなす	kikonasu
目くじら	めくじら	mekujira
写せる	うつせる	utsuseru
入りこむ	はいりこむ	hairikomu
関が原	せきがはら	sekigahara
口直し	くちなおし	kuchinaoshi
飛び石	とびいし	tobiishi
追っ手	おって	otte
白ける	しらける	shirakeru
切り売り	きりうり	kiriuri
借り受ける	かりうける	kariukeru
法る	のっとる	nottoru
不治の病	ふじのやまい	fujinoyamai
追い回す	おいまわす	oimawasu
三が日	さんがにち	sannganichi
静める	しずめる	shizumeru
止す	よす|さす	yosu|sasu
世直し	よなおし	yonaoshi
取上げる	とりあげる	toriageru
風当たり	かぜあたり	kazeatari
引きつける	ひきつける	hikitsukeru
物まね	ものまね	monomane
生み出せる	うみだせる	umidaseru
ねじ曲げる	ねじまげる	nejimageru
関の山	せきのやま	sekinoyama
気味悪い	きみわるい	kimiwarui
打って出る	うってでる	uttederu
相手取る	あいてどる	aitedoru
つや消し	つやけし	tsuyakeshi
手遊び	てあそび|てすさび	teasobi|tesusabi
悪あがき	わるあがき	waruagaki
口止め	くちどめ	kuchidome
身売り	みうり	miuri
ひと安心	ひとあんしん	hitoannshinn
野ばら	のばら	nobara
立て札	たてふだ	tatefuda
話合い	はなしあい	hanashiai
切っ先	きっさき	kissaki
引き入れる	ひきいれる	hikiireru
根深い	ねぶかい	nebukai
がま口	がまぐち	gamaguchi
回りくどい	まわりくどい	mawarikudoi
気負う	きおう	kiou
受け持ち	うけもち	ukemochi
入り交じる	いりまじる	irimajiru
は虫類	はちゅうるい	hatyuurui
表通り	おもてどおり	omotedoori
乗り合い	のりあい	noriai
何ごと	なにごと	nanigoto
投げ飛ばす	なげとばす	nagetobasu
付き合える	つきあえる	tsukiaeru
切り上げる	きりあげる	kiriageru
立ち回る	たちまわる	tachimawaru
折れ曲がる	おれまがる	oremagaru
飛びかかる	とびかかる	tobikakaru
売りさばく	うりさばく	urisabaku
やり場	やりば	yariba
毛深い	けぶかい	kebukai
芽生える	めばえる	mebaeru
取外し	とりはずし	torihazushi
深入り	ふかいり	fukairi
せき止める	せきとめる	sekitomeru
付け合せ	つけあわせ	tsukeawase
味つけ	あじつけ	ajitsuke
やり手	やりて	yarite
ひと息	ひといき	hitoiki
本読み	ほんよみ	honnyomi
見定め	みさだめ	misadame
事細か	ことこまか	kotokomaka
取りだす	とりだす	toridasu
持ち回り	もちまわり	mochimawari
気だるい	けだるい	kedarui
春めく	はるめく	harumeku
二の足	にのあし	ninoashi
鏡開き	かがみびらき	kagamibiraki
利き手	ききて	kikite
雪の下	ゆきのした	yukinoshita
半開き	はんびらき	hannbiraki
組み合わす	くみあわす	kumiawasu
平に	ひらに	hirani
小太り	こぶとり	kobutori
立ちふさがる	たちふさがる	tachifusagaru
大ぶり	おおぶり	ooburi
家の子	いえのこ	ienoko
色付け	いろづけ	iroduke
積り	つもり|づもり	tsumori|dumori
口うるさい	くちうるさい	kuchiurusai
花しょうぶ	はなしょうぶ	hanashoubu
通り名	とおりな	toorina
分ち	わかち	wakachi
細る	ほそる|ぼそる	hosoru|bosoru
さざ波	さざなみ	sazanami
心置き	こころおき	kokorooki
日取り	ひどり	hidori
馬乗り	うまのり	umanori
打ち直す	うちなおす	uchinaosu
気負い	きおい	kioi
引きちぎる	ひきちぎる	hikichigiru
図太い	ずぶとい	zubutoi
見通せる	みとおせる	mitooseru
足かせ	あしかせ	ashikase
拾える	ひろえる	hiroeru
明るむ	あかるむ	akarumu
買い置き	かいおき	kaioki
組み方	くみかた	kumikata
形づくる	かたちづくる	katachidukuru
取りざた	とりざた	torizata
見取り図	みとりず	mitorizu
か年	かねん	kanenn
深追い	ふかおい	fukaoi
競り合い	せりあい|ぜりあい	seriai|zeriai
言いふらす	いいふらす	iifurasu
あぜ道	あぜみち	azemichi
両さん	りょうさん	ryousann
ぶつ切り	ぶつぎり	butsugiri
悪ふざけ	わるふざけ	warufuzake
決定づける	けっていづける	ketteidukeru
晴れ着	はれぎ	haregi
画く	えがく	egaku
笑わす	わらわす	warawasu
用心深い	ようじんぶかい	youjinnbukai
連れ立つ	つれだつ|つれたつ	tsuredatsu|tsuretatsu
思わしくない	おもわしくない	omowashikunai
つくり出す	つくりだす	tsukuridasu
真ん前	まんまえ	mannmae
毛頭ない	もうとうない	moutounai
気安い	きやすい|きやしい	kiyasui|kiyashii
仕立てる	したてる	shitateru
手伝える	てつだえる	tetsudaeru
失す	しっす|うす	shissu|usu
急ぎ足	いそぎあし	isogiashi
打ちっぱなし	うちっぱなし	uchippanashi
青み	あおみ	aomi
あざ笑う	あざわらう|あざわろう	azawarau|azawarou
感じ入る	かんじいる	kannjiiru
水飲み	みずのみ	mizunomi
積み上げる	つみあげる	tsumiageru
品ぞろえ	しなぞろえ	shinazoroe
川流れ	かわながれ	kawanagare
ぶどう酒	ぶどうしゅ	budoushu
うな重	うなじゅう	unajuu
折しも	おりしも	orishimo
かき立てる	かきたてる	kakitateru
手分け	てわけ	tewake
青じそ	あおじそ	aojiso
古くさい	ふるくさい	furukusai
初乗り	はつのり	hatsunori
音読み	おんよみ	onnyomi
うめき声	うめきごえ	umekigoe
品定め	しなさだめ	shinasadame
小競り合い	こぜりあい	kozeriai
完ぺき	かんぺき	kannpeki
横流し	よこながし	yokonagashi
笑い転げる	わらいころげる	waraikorogeru
重ね重ね	かさねがさね	kasanegasane
先んじる	さきんじる	sakinnjiru
息づかい	いきづかい	ikidukai
負い目	おいめ	oime
またの名	またのな	matanona
たき火	たきび	takibi
みやげ物	みやげもの	miyagemono
力ずく	ちからずく	chikarazuku
飛び地	とびち	tobichi
遠まわし	とおまわし	toomawashi
気づかう	きづかう	kidukau
目覚ましい	めざましい	mezamashii
きき酒	ききざけ	kikizake
言い返せる	いいかえせる	iikaeseru
そそり立つ	そそりたつ	sosoritatsu
落し物	おとしもの	otoshimono
かがり火	かがりび	kagaribi
追い立てる	おいたてる	oitateru
立ちすくむ	たちすくむ	tachisukumu
着こなせる	きこなせる	kikonaseru
根づく	ねづく	neduku
紙くず	かみくず	kamikuzu
仲間はずれ	なかまはずれ	nakamahazure
話し手	はなして	hanashite
付き物	つきもの	tsukimono
取り止める	とりとめる|とりやめる	toritomeru|toriyameru
つけ加える	つけくわえる	tsukekuwaeru
受け口	うけぐち|うけくち	ukeguchi|ukekuchi
無理強い	むりじい|むりつよい	murijii|muritsuyoi
頭でっかち	あたまでっかち	atamadekkachi
口利き	くちきき	kuchikiki
早とちり	はやとちり	hayatochiri
円い	まるい|まりい	marui|marii
のし上がる	のしあがる	noshiagaru
聞き書き	ききがき	kikigaki
開けっ放し	あけっぱなし	akeppanashi
たたき台	たたきだい	tatakidai
黒光り	くろびかり	kurobikari
木の間	このま	konoma
下せる	くだせる	kudaseru
活気づく	かっきづく	kakkiduku
決る	きまる|ぎまる	kimaru|gimaru
五月晴れ	さつきばれ	satsukibare
遠回し	とおまわし	toomawashi
役だつ	やくだつ	yakudatsu
受けつける	うけつける	uketsukeru
書き取る	かきとる	kakitoru
つり具	つりぐ	tsurigu
食らいつく	くらいつく	kuraitsuku
いで湯	いでゆ	ideyu
交す	かわす|くわす	kawasu|kuwasu
上と下	うえとした	uetoshita
事足りる	ことたりる	kototariru
仲よく	なかよく	nakayoku
仕上り	しあがり	shiagari
思いだす	おもいだす	omoidasu
悪びれる	わるびれる	warubireru
向こう岸	むこうぎし	mukougishi
持ちこむ	もちこむ	mochikomu
別れ話	わかればなし	wakarebanashi
聞き取れる	ききとれる	kikitoreru
花祭り	はなまつり	hanamatsuri
集り	あつまり|たかり|だかり	atsumari|takari|dakari
折れ線	おれせん	oresenn
合し	ごうし|あわし|がっし	goushi|awashi|gasshi
やり口	やりくち	yarikuchi
けん玉	けんだま	kenndama
つかみ取り	つかみどり|つかみとり	tsukamidori|tsukamitori
丸っこい	まるっこい	marukkoi
申し子	もうしご	moushigo
日の入り	ひのいり	hinoiri
拾い読み	ひろいよみ	hiroiyomi
終わらす	おわらす	owarasu
読みきり	よみきり	yomikiri
街なか	まちなか	machinaka
病み付き	やみつき	yamitsuki
立ちこめる	たちこめる	tachikomeru
真っ黒い	まっくろい	makkuroi
小口切り	こぐちきり	koguchikiri
口ぶり	くちぶり	kuchiburi
巣食う	すくう	sukuu
目ざす	めざす	mezasu
清清しい	すがすがしい	sugasugashii
持ち歩ける	もちあるける	mochiarukeru
選る	よる|えらべる|える	yoru|eraberu|eru
戦ふ	たたかふ|たたこふ	tatakafu|tatakofu
考え付く	かんがえつく	kanngaetsuku
取り分	とりぶん	toribunn
後れ	おくれ	okure
案ずる	あんずる	annzuru
かけ算	かけざん	kakezann
だだっ広い	だだっぴろい	dadappiroi
つ折	つおり	tsuori
取り持つ	とりもつ	torimotsu
回し者	まわしもの	mawashimono
前書き	まえがき	maegaki
走らす	はしらす	hashirasu
日照り	ひでり	hideri
手回し	てまわし	temawashi
中通り	なかどおり	nakadoori
しゃしゃり出る	しゃしゃりでる	shasharideru
持ち運べる	もちはこべる	mochihakoberu
出で立ち	いでたち	idetachi
でき上がる	できあがる	dekiagaru
買い入れ	かいいれ	kaiire
食い初め	くいぞめ	kuizome
作りたて	つくりたて	tsukuritate
細める	ほそめる	hosomeru
作り出せる	つくりだせる	tsukuridaseru
焼け野原	やけのはら	yakenohara
手間ひま	てまひま	temahima
取り入る	とりいる	toriiru
庭付き	にわつき	niwatsuki
朝帰り	あさがえり	asagaeri
人助け	ひとだすけ	hitodasuke
登りつめる	のぼりつめる	noboritsumeru
茶わん	ちゃわん|じゃわん	tyawann|jawann
切り返す	きりかえす	kirikaesu
やり返す	やりかえす	yarikaesu
泣き笑い	なきわらい	nakiwarai
組み付ける	くみつける	kumitsukeru
麦打ち	むぎうち	mugiuchi
たたき出す	たたきだす	tatakidasu
ご法度	ごはっと	gohatto
お節	おせち	osechi
上の空	うわのそら	uwanosora
静まりかえる	しずまりかえる	shizumarikaeru
習わし	ならわし	narawashi
白む	しらむ	shiramu
言い草	いいぐさ	iigusa
買いあさる	かいあさる	kaiasaru
浅ましい	あさましい	asamashii
持ち場	もちば	mochiba
願いごと	ねがいごと	negaigoto
植え付ける	うえつける	uetsukeru
買いだめ	かいだめ	kaidame
申し立てる	もうしたてる	moushitateru
目やに	めやに	meyani
思いつめる	おもいつめる	omoitsumeru
つくり上げる	つくりあげる	tsukuriageru
物売り	ものうり	monouri
顔なじみ	かおなじみ	kaonajimi
魚の目	うおのめ	uonome
売出し	うりだし	uridashi
鳴り出す	なりだす	naridasu
参じる	さんじる	sannjiru
定まり	さだまり	sadamari
と金	ときん	tokinn
笑いもの	わらいもの	waraimono
読みふける	よみふける	yomifukeru
場当たり	ばあたり	baatari
語りあう	かたりあう	katariau
付き人	つきびと	tsukibito
相打ち	あいうち	aiuchi
人当たり	ひとあたり	hitoatari
共食い	ともぐい	tomogui
花だより	はなだより	hanadayori
お新香	おしんこ	oshinnko
焼入れ	やきいれ	yakiire
美しくも	いしくも	ishikumo
よそ見	よそみ	yosomi
引き当て	ひきあて	hikiate
老いる	おいる	oiru
お天道様	おてんとさま	otenntosama
書きとめる	かきとめる	kakitomeru
計らう	はからう	hakarau
にわか雨	にわかあめ	niwakaame
受け方	うけかた	ukekata
感づく	かんづく	kannduku
福の神	ふくのかみ	fukunokami
弱き	よわき	yowaki
落とし物	おとしもの	otoshimono
くみ上げる	くみあげる	kumiageru
小気味よい	こきみよい	kokimiyoi
死する	しする	shisuru
祭り上げる	まつりあげる	matsuriageru
乗りこむ	のりこむ	norikomu
湯通し	ゆどおし	yudooshi
地上げ	じあげ	jiage
行きつく	いきつく|ゆきつく	ikitsuku|yukitsuku
言葉づかい	ことばづかい	kotobadukai
足せる	たせる	taseru
休み休み	やすみやすみ	yasumiyasumi
秋まつり	あきまつり	akimatsuri
もらい泣き	もらいなき	morainaki
群れる	むれる	mureru
取付ける	とりつける	toritsukeru
進み出る	すすみでる	susumideru
変わり果てる	かわりはてる	kawarihateru
お家芸	おいえげい	oiegei
生れる	うまれる	umareru
竹とんぼ	たけとんぼ	taketonnbo
取り交わす	とりかわす	torikawasu
当たり年	あたりどし	ataridoshi
遊ばす	あそばす	asobasu
輪っか	わっか	wakka
約す	やくす	yakusu
一つ覚え	ひとつおぼえ	hitotsuoboe
じゃじゃ馬	じゃじゃうま	jajauma
夏ばて	なつばて	natsubate
待ちかまえる	まちかまえる	machikamaeru
店じまい	みせじまい	misejimai
鳥かご	とりかご	torikago
書き物	かきもの	kakimono
何とぞ	なにとぞ	nanitozo
下積み	したづみ	shitadumi
仕切り直し	しきりなおし	shikirinaoshi
服する	ふくする	fukusuru
つり上げ	つりあげ	tsuriage
湯上がり	ゆあがり	yuagari
前かがみ	まえかがみ	maekagami
古ぼける	ふるぼける	furubokeru
住みかえる	すみかえる	sumikaeru
差し向ける	さしむける	sashimukeru
待てる	まてる	materu
息の根	いきのね	ikinone
へし折る	へしおる	heshioru
種明かし	たねあかし	taneakashi
手合わせ	てあわせ	teawase
こき下ろす	こきおろす	kokiorosu
買い漁る	かいあさる	kaiasaru
打ちまくる	うちまくる	uchimakuru
手広い	てびろい	tebiroi
竹やぶ	たけやぶ	takeyabu
切れ間	きれま	kirema
見回る	みまわる	mimawaru
板の間	いたのま	itanoma
食いつぶす	くいつぶす	kuitsubusu
当せん	とうせん	tousenn
書き初め	かきぞめ	kakizome
平手打ち	ひらてうち	hirateuchi
うるち米	うるちまい	uruchimai
血みどろ	ちみどろ	chimidoro
がぶ飲み	がぶのみ	gabunomi
気後れ	きおくれ	kiokure
木こり	きこり	kikori
手合い	てあい	teai
はじき出す	はじきだす	hajikidasu
合いの手	あいのて	ainote
手習い	てならい	tenarai
打ち身	うちみ	uchimi
お神酒	おみき	omiki
言いだす	いいだす	iidasu
放れる	はなれる	hanareru
大みそか	おおみそか	oomisoka
取り外せる	とりはずせる	torihazuseru
分つ	わかつ	wakatsu
変じる	へんじる	hennjiru
野太い	のぶとい	nobutoi
しっぺ返し	しっぺがえし	shippegaeshi
小じわ	こじわ	kojiwa
点る	ともる|とぼる	tomoru|toboru
点てる	たてる	tateru
立ちつくす	たちつくす	tachitsukusu
見直せる	みなおせる	minaoseru
折り重なる	おりかさなる	orikasanaru
子守り	こもり	komori
引き回し	ひきまわし	hikimawashi
せん切り	せんぎり	senngiri
手まり	てまり|でまり	temari|demari
笑い事	わらいごと	waraigoto
訓読み	くんよみ	kunnyomi
お達し	おたっし	otasshi
焼け石	やけいし	yakeishi
待ちくたびれる	まちくたびれる	machikutabireru
横付け	よこづけ	yokoduke
目配り	めくばり	mekubari
いがみ合う	いがみあう|いがみおう	igamiau|igamiou
自ずから	おのずから	onozukara
有終の美	ゆうしゅうのび	yuushuunobi
むち打つ	むちうつ	muchiutsu
身じろぐ	みじろぐ	mijirogu
今しがた	いましがた	imashigata
灯ろう	とうろう|ともろう|どうろう	tourou|tomorou|dourou
ひ孫	ひまご	himago
書きなぐる	かきなぐる	kakinaguru
かいま見る	かいまみる	kaimamiru
練り直す	ねりなおす	nerinaosu
冷え冷え	ひえびえ	hiebie
伝え聞く	つたえきく	tsutaekiku
問い返す	といかえす	toikaesu
虫けら	むしけら	mushikera
言い終わる	いいおわる	iiowaru
切れ長	きれなが	kirenaga
とり入れる	とりいれる	toriireru
位置付ける	いちづける	ichidukeru
口ごもる	くちごもる	kuchigomoru
取り返せる	とりかえせる	torikaeseru
もみ消し	もみけし	momikeshi
お里	おさと	osato
見知り	みしり	mishiri
身の毛	みのけ	minoke
量り	はかり	hakari
見まね	みまね	mimane
乗りこなす	のりこなす	norikonasu
内回り	うちまわり	uchimawari
つなぎ目	つなぎめ	tsunagime
夕やけ	ゆうやけ	yuuyake
輪投げ	わなげ	wanage
お引き立て	おひきたて	ohikitate
西向き	にしむき	nishimuki
水あめ	みずあめ	mizuame
不幸せ	ふしあわせ	fushiawase
まくし立てる	まくしたてる	makushitateru
古る	ふる	furu
大入り	おおいり	ooiri
波立つ	なみだつ	namidatsu
間引く	まびく	mabiku
植付け	うえつけ	uetsuke
時おり	ときおり	tokiori
心変わり	こころがわり	kokorogawari
例へば	たとへば	tatoheba
お古	おふる	ofuru
出直す	でなおす	denaosu
ご多分	ごたぶん	gotabunn
米どころ	こめどころ	komedokoro
いぶし銀	いぶしぎん	ibushiginn
楽に	らくに	rakuni
上し	じょうし|のぼし	joushi|noboshi
知らんぷり	しらんぷり	shirannpuri
頭ごなし	あたまごなし	atamagonashi
問いつめる	といつめる	toitsumeru
血走る	ちばしる	chibashiru
上っ面	うわっつら	uwattsura
仕立て屋	したてや	shitateya
おろし金	おろしがね	oroshigane
油っこい	あぶらっこい	aburakkoi
はけ口	はけぐち	hakeguchi
消え入る	きえいる	kieiru
見つけだす	みつけだす	mitsukedasu
暑がり	あつがり	atsugari
見せかける	みせかける	misekakeru
かっ飛ばす	かっとばす	kattobasu
折り合う	おりあう|おりおう	oriau|oriou
待ちぼうけ	まちぼうけ	machibouke
かん水	かんすい	kannsui
病める	やめる	yameru
ふんぞり返る	ふんぞりかえる	funnzorikaeru
弱弱しい	よわよわしい	yowayowashii
曲がりなりにも	まがりなりにも	magarinarinimo
出しゃばる	でしゃばる	deshabaru
飛びこむ	とびこむ	tobikomu
陸続き	りくつづき	rikutsuduki
化けの皮	ばけのかわ	bakenokawa
にらみ合う	にらみあう|にらみおう	niramiau|niramiou
目配せ	めくばせ	mekubase
うっ血	うっけつ	ukketsu
競り勝つ	せりかつ	serikatsu
立ち行く	たちゆく|たちいく	tachiyuku|tachiiku
読み切る	よみきる	yomikiru
中ごろ	なかごろ	nakagoro
水差し	みずさし	mizusashi
くじ運	くじうん	kujiunn
肉付き	にくづき|ししつき	nikuduki|shishitsuki
折返し	おりかえし	orikaeshi
照れ笑い	てれわらい	terewarai
満ち欠け	みちかけ	michikake
立ち消え	たちぎえ	tachigie
練り物	ねりもの	nerimono
付け合わせる	つけあわせる	tsukeawaseru
川べり	かわべり	kawaberi
船着き場	ふなつきば	funatsukiba
思い残す	おもいのこす	omoinokosu
立ち木	たちぎ|たちき	tachigi|tachiki
鳴り物	なりもの	narimono
人受け	ひとうけ	hitouke
好き好む	すきこのむ	sukikonomu
続けざま	つづけざま	tsudukezama
松ぼっくり	まつぼっくり	matsubokkuri
浅黒い	あさぐろい	asaguroi
残り香	のこりが|のこりか	nokoriga|nokorika
書き散らす	かきちらす	kakichirasu
数え年	かぞえどし	kazoedoshi
白和え	しらあえ	shiraae
石組み	いしぐみ	ishigumi
手付き	てつき	tetsuki
花やしき	はなやしき	hanayashiki
連れ子	つれこ	tsureko
風の子	かぜのこ	kazenoko
根差す	ねざす	nezasu
流し入れる	ながしいれる	nagashiireru
お住い	おすまい	osumai
木くず	きくず	kikuzu
調える	ととのえる	totonoeru
申しつける	もうしつける	moushitsukeru
立入る	たちいる	tachiiru
差止め	さしどめ|さしとめ	sashidome|sashitome
食い意地	くいいじ	kuiiji
青っぽい	あおっぽい	aoppoi
考えもの	かんがえもの	kanngaemono
一先ず	ひとまず	hitomazu
切りかえる	きりかえる	kirikaeru
二つ返事	ふたつへんじ	futatsuhennji
気落ち	きおち	kiochi
目ざとい	めざとい	mezatoi
申入れ	もうしいれ	moushiire
食らわす	くらわす	kurawasu
書き入れ	かきいれ	kakiire
終に	ついに	tsuini
火の車	ひのくるま	hinokuruma
生温い	なまぬるい|なまぬりい	namanurui|namanurii
大ざっぱ	おおざっぱ	oozappa
巣くう	すくう	sukuu
交う	かう|こう	kau|kou
別ける	わける	wakeru
思わしい	おもわしい	omowashii
目付き	めつき	metsuki
乗り手	のりて	norite
花便り	はなだより	hanadayori
夜回り	よまわり	yomawari
ねばり強い	ねばりづよい	nebariduyoi
写し出す	うつしだす	utsushidasu
競り合う	せりあう|せりおう	seriau|seriou
然しながら	しかしながら	shikashinagara
流る	ながれる|ながる	nagareru|nagaru
注げる	そそげる|つげる	sosogeru|tsugeru
聞きかじる	ききかじる	kikikajiru
やり合う	やりあう|やりおう	yariau|yariou
持ち合い	もちあい	mochiai
組み直す	くみなおす	kuminaosu
事始め	ことはじめ	kotohajime
もの悲しい	ものがなしい	monoganashii
言い直す	いいなおす	iinaosu
街かど	まちかど	machikado
高利回り	こうりまわり	kourimawari
山分け	やまわけ	yamawake
火遊び	ひあそび	hiasobi
出来合い	できあい	dekiai
食い気	くいけ	kuike
消し飛ぶ	けしとぶ	keshitobu
高望み	たかのぞみ	takanozomi
化かす	ばかす	bakasu
負け戦	まけいくさ	makeikusa
由る	よる	yoru
花冷え	はなびえ	hanabie
お礼参り	おれいまいり	oreimairi
列する	れっする	ressuru
取出し	とりだし	toridashi
向かえる	むかえる	mukaeru
書下ろし	かきおろし	kakioroshi
持ちきる	もちきる	mochikiru
転ずる	てんずる	tennzuru
思いっ切り	おもいっきり	omoikkiri
血祭り	ちまつり	chimatsuri
野ざらし	のざらし	nozarashi
真向かい	まむかい	mamukai
せり出し	せりだし	seridashi
水入らず	みずいらず	mizuirazu
案じる	あんじる	annjiru
雪下ろし	ゆきおろし	yukioroshi
強か	したたか|きょうか	shitataka|kyouka
土のう	どのう	donou
待受ける	まちうける	machiukeru
引き落とす	ひきおとす	hikiotosu
気乗り	きのり	kinori
いきり立つ	いきりたつ	ikiritatsu
追っかける	おっかける	okkakeru
湯浴み	ゆあみ	yuami
放せる	はなせる	hanaseru
目通り	めどおり	medoori
覚ませる	さませる	samaseru
投げ売り	なげうり	nageuri
地続き	じつづき	jitsuduki
切通し	きりどおし	kiridooshi
島流し	しまながし	shimanagashi
切り通し	きりどおし	kiridooshi
身ごもる	みごもる	migomoru
男勝り	おとこまさり	otokomasari
流し目	ながしめ	nagashime
札入れ	さついれ	satsuire
光らせる	ひからせる	hikaraseru
焼き飯	やきめし	yakimeshi
引っ付く	ひっつく	hittsuku
見せ物	みせもの	misemono
見きわめる	みきわめる	mikiwameru
乗りきる	のりきる	norikiru
落ちこむ	おちこむ	ochikomu
見おろす	みおろす	miorosu
手植え	てうえ	teue
変わり種	かわりだね	kawaridane
底入れ	そこいれ	sokoire
取り続ける	とりつづける	toritsudukeru
白あん	しろあん	shiroann
ひと足早い	ひとあしはやい	hitoashihayai
負けん気	まけんき	makennki
考へる	かんがへる|かんがえる	kanngaheru|kanngaeru
相づち	あいづち	aiduchi
利かす	きかす	kikasu
仕る	つかまつる|する	tsukamatsuru|suru
心行く	こころゆく	kokoroyuku
産す	むす	musu
神がかり	かみがかり	kamigakari
分け前	わけまえ	wakemae
心地好い	ここちよい	kokochiyoi
親しめる	したしめる	shitashimeru
食あたり	しょくあたり	shokuatari
命からがら	いのちからがら	inochikaragara
お上手	おじょうず	ojouzu
お多福	おたふく	otafuku
付合い	つきあい|づきあい	tsukiai|dukiai
書き言葉	かきことば	kakikotoba
両開き	りょうびらき	ryoubiraki
晴れ上がる	はれあがる	hareagaru
切り分ける	きりわける	kiriwakeru
拾い物	ひろいもの	hiroimono
未練がましい	みれんがましい	mirenngamashii
やっつけ仕事	やっつけしごと	yattsukeshigoto
火まつり	ひまつり	himatsuri
名付ける	なづける	nadukeru
産み落とす	うみおとす	umiotosu
手向け	たむけ	tamuke
変り種	かわりだね	kawaridane
乗り組む	のりくむ	norikumu
点す	さす|ともす|とぼす	sasu|tomosu|tobosu
読みかける	よみかける	yomikakeru
中だるみ	なかだるみ	nakadarumi
聞き上手	ききじょうず	kikijouzu
長らえる	ながらえる	nagaraeru
置いてきぼり	おいてきぼり	oitekibori
年がら年中	ねんがらねんじゅう	nenngaranennjuu
鳴り物入り	なりものいり	narimonoiri
気もち	きもち	kimochi
上がったり	あがったり	agattari
次の間	つぎのま	tsuginoma
底冷え	そこびえ	sokobie
根付け	ねつけ|ねづけ	netsuke|neduke
くつ下	くつした	kutsushita
色あい	いろあい	iroai
すそ野	すその	susono
わきの下	わきのした	wakinoshita
利する	りする	risuru
冷や冷や	ひやひや	hiyahiya
積み残す	つみのこす	tsuminokosu
集まれる	あつまれる	atsumareru
結び付き	むすびつき	musubitsuki
命拾い	いのちびろい	inochibiroi
お点前	おてまえ	otemae
目がける	めがける	megakeru
写し取る	うつしとる	utsushitoru
首根っこ	くびねっこ	kubinekko
置き時計	おきどけい	okidokei
湯冷め	ゆざめ	yuzame
ひしめき合う	ひしめきあう|ひしめきおう	hishimekiau|hishimekiou
地鳴り	じなり	jinari
引っさげる	ひっさげる	hissageru
買入れる	かいいれる	kaiireru
飛び上がり	とびあがり	tobiagari
着流し	きながし	kinagashi
放ったらかし	ほったらかし	hottarakashi
言いくるめる	いいくるめる	iikurumeru
かち合う	かちあう|かちおう	kachiau|kachiou
塩もみ	しおもみ	shiomomi
すり合わせ	すりあわせ	suriawase
四つんばい	よつんばい	yotsunnbai
申し入れる	もうしいれる	moushiireru
先細り	さきぼそり|さきほそり	sakibosori|sakihosori
見初める	みそめる	misomeru
走り書き	はしりがき	hashirigaki
生きのびる	いきのびる	ikinobiru
血なまぐさい	ちなまぐさい	chinamagusai
言い出しっぺ	いいだしっぺ	iidashippe
飛び出せる	とびだせる	tobidaseru
取りまとめる	とりまとめる	torimatomeru
候う	そうろう|そうらう	sourou|sourau
引き返せる	ひきかえせる	hikikaeseru
むかし話	むかしばなし	mukashibanashi
成さん	せいさん	seisann
住い	すまい|ずまい	sumai|zumai
言いまくる	いいまくる	iimakuru
お松	おまつ	omatsu
かくし芸	かくしげい	kakushigei
毛羽立つ	けばだつ	kebadatsu
願わくは	ねがわくは	negawakuha
木組み	きぐみ	kigumi
筆まめ	ふでまめ	fudemame
真白い	まっしろい|ましろい	masshiroi|mashiroi
消えうせる	きえうせる	kieuseru
手もと	てもと	temoto
日だまり	ひだまり	hidamari
乗り付ける	のりつける	noritsukeru
真っ昼間	まっぴるま	mappiruma
打ちこむ	うちこむ	uchikomu
水切れ	みずぎれ	mizugire
唱う	うたう|うとう	utau|utou
茶目っ気	ちゃめっけ	tyamekke
さん付け	さんづけ	sannduke
借金取り	しゃっきんとり	shakkinntori
合す	あわす	awasu
谷あい	たにあい	taniai
念ずる	ねんずる	nennzuru
旅だつ	たびだつ	tabidatsu
名前負け	なまえまけ	namaemake
手づかみ	てづかみ	tedukami
打ち合せる	うちあわせる	uchiawaseru
末広がり	すえひろがり	suehirogari
すくい上げる	すくいあげる	sukuiageru
焼き付ける	やきつける	yakitsukeru
取り次ぐ	とりつぐ	toritsugu
顔付き	かおつき	kaotsuki
雨よけ	あまよけ	amayoke
見付ける	みつける	mitsukeru
組み合う	くみあう|くみおう	kumiau|kumiou
首つり	くびつり	kubitsuri
富める	とめる	tomeru
肉付け	にくづけ	nikuduke
物すごい	ものすごい	monosugoi
生みの親	うみのおや	uminooya
追い落とす	おいおとす	oiotosu
通り雨	とおりあめ	tooriame
そぞろ歩き	そぞろあるき	sozoroaruki
聞きだす	ききだす	kikidasu
真打ち	しんうち	shinnuchi
歌いまくる	うたいまくる	utaimakuru
玉こんにゃく	たまこんにゃく	tamakonnnyaku
読取り	よみとり	yomitori
根負け	こんまけ	konnmake
思す	おぼす	obosu
日なた	ひなた	hinata
開け放す	あけはなす	akehanasu
飲み代	のみしろ	nomishiro
お手の物	おてのもの	otenomono
そば湯	そばゆ	sobayu
くす玉	くすだま	kusudama
ひと回り	ひとまわり	hitomawari
書き分ける	かきわける	kakiwakeru
通し番号	とおしばんごう	tooshibanngou
働き手	はたらきて	hatarakite
勇み足	いさみあし	isamiashi
大もうけ	おおもうけ	oomouke
書初め	かきぞめ	kakizome
待ち人	まちびと	machibito
風しん	ふうしん	fuushinn
もの申す	ものもうす	monomousu
人でなし	ひとでなし	hitodenashi
失ふ	うしなふ|うしのふ	ushinafu|ushinofu
むしり取る	むしりとる	mushiritoru
見くびる	みくびる	mikubiru
つむじ風	つむじかぜ	tsumujikaze
命知らず	いのちしらず	inochishirazu
ひねり出す	ひねりだす	hineridasu
働きがい	はたらきがい	hatarakigai
考え物	かんがえもの	kanngaemono
通いつめる	かよいつめる	kayoitsumeru
取り下げる	とりさげる	torisageru
生き別れ	いきわかれ	ikiwakare
ひし形	ひしがた	hishigata
米びつ	こめびつ	komebitsu
敗ける	まける	makeru
手みやげ	てみやげ	temiyage
はね返す	はねかえす	hanekaesu
取下げる	とりさげる	torisageru
配する	はいする	haisuru
早生まれ	はやうまれ	hayaumare
生める	うめる	umeru
読み出す	よみだす	yomidasu
ほほ笑む	ほほえむ	hohoemu
焼付け	やきつけ	yakitsuke
手すき	てすき	tesuki
老いぼれる	おいぼれる	oiboreru
言いきる	いいきる	iikiru
争える	あらそえる	arasoeru
生きぬく	いきぬく	ikinuku
重み付け	おもみづけ	omomiduke
人づて	ひとづて	hitodute
てこ入れ	てこいれ	tekoire
画する	かくする	kakusuru
取りやめる	とりやめる	toriyameru
こびり付く	こびりつく	kobiritsuku
目じり	めじり	mejiri
組み合せる	くみあわせる	kumiawaseru
空き室	あきしつ	akishitsu
借り切る	かりきる	karikiru
やせ細る	やせほそる	yasehosoru
根から	ねから	nekara
引け目	ひけめ	hikeme
連れ回す	つれまわす	tsuremawasu
何時の間に	いつのまに	itsunomani
ほの暗い	ほのぐらい	honogurai
取っ組み合い	とっくみあい	tokkumiai
がら空き	がらあき|がらすき	garaaki|garasuki
利す	りす	risu
冷やせる	ひやせる	hiyaseru
落ちつき	おちつき	ochitsuki
売り切り	うりきり	urikiri
打ち落とす	うちおとす	uchiotosu
口もと	くちもと	kuchimoto
町外れ	まちはずれ	machihazure
お代	おだい	odai
一こま	ひとこま	hitokoma
色めく	いろめく	iromeku
へそ曲がり	へそまがり	hesomagari
火の手	ひのて	hinote
目明し	めあかし	meakashi
少しく	すこしく	sukoshiku
事足る	ことたる	kototaru
はまり役	はまりやく	hamariyaku
語り合える	かたりあえる	katariaeru
熱す	ねっす	nessu
手折る	たおる	taoru
帰せる	かえせる	kaeseru
青みがかる	あおみがかる	aomigakaru
口ぐせ	くちぐせ	kuchiguse
産み付ける	うみつける	umitsukeru
科する	かする	kasuru
つけ根	つけね	tsukene
朝もや	あさもや	asamoya
売りまくる	うりまくる	urimakuru
追いこむ	おいこむ	oikomu
持ち出せる	もちだせる	mochidaseru
円建て	えんだて	enndate
向き合える	むきあえる	mukiaeru
松の内	まつのうち	matsunouchi
立ちのぼる	たちのぼる	tachinoboru
知らぬ顔	しらぬかお	shiranukao
付け所	つけどころ	tsukedokoro
塩ゆで	しおゆで	shioyude
わき道	わきみち	wakimichi
生まれつく	うまれつく	umaretsuku
力負け	ちからまけ	chikaramake
覚る	さとる	satoru
位する	くらいする	kuraisuru
転ける	こける	kokeru
代かき	しろかき	shirokaki
目立て	めたて|めだて	metate|medate
心づかい	こころづかい	kokorodukai
打ち出せる	うちだせる	uchidaseru
話し合える	はなしあえる	hanashiaeru
ふっ飛ぶ	ふっとぶ	futtobu
軽はずみ	かるはずみ	karuhazumi
秋めく	あきめく	akimeku
夜なべ	よなべ	yonabe
七転び八起き	ななころびやおき	nanakorobiyaoki
下働き	したばたらき	shitabataraki
付け入る	つけいる	tsukeiru
ぶっ続け	ぶっつづけ	buttsuduke
申し送る	もうしおくる	moushiokuru
大安売り	おおやすうり	ooyasuuri
読みあさる	よみあさる	yomiasaru
紙すき	かみすき	kamisuki
正せる	ただせる	tadaseru
絵入り	えいり	eiri
人なつこい	ひとなつこい	hitonatsukoi
山ろく	さんろく	sannroku
交わせる	かわせる	kawaseru
目覚し	めざまし	mezamashi
出会い頭	であいがしら	deaigashira
追い出せる	おいだせる	oidaseru
身投げ	みなげ	minage
ひとり歩き	ひとりあるき	hitoriaruki
兄たち	あにたち	anitachi
しかめっ面	しかめっつら	shikamettsura
死に体	しにたい	shinitai
勝れる	すぐれる	sugureru
仕向ける	しむける	shimukeru
赤茶ける	あかちゃける	akatyakeru
注す	さす|ちゅうす	sasu|tyuusu
目くそ	めくそ	mekuso
手返し	てがえし	tegaeshi
商う	あきなう|あきのう	akinau|akinou
すすり泣く	すすりなく	susurinaku
出ずっぱり	でずっぱり	dezuppari
受けいれる	うけいれる	ukeireru
万事休す	ばんじきゅうす	bannjikyuusu
口答え	くちごたえ	kuchigotae
したり顔	したりがお	shitarigao
生き血	いきち	ikichi
理る	ことわる	kotowaru
照り返す	てりかえす	terikaesu
売り主	うりぬし	urinushi
投げ付ける	なげつける	nagetsukeru
気ぜわしい	きぜわしい	kizewashii
知合い	しりあい	shiriai
こぎ着ける	こぎつける	kogitsukeru
ひと足	ひとあし	hitoashi
ひと通り	ひととおり	hitotoori
山焼き	やまやき	yamayaki
持ちかえる	もちかえる	mochikaeru
よつ葉	よつば	yotsuba
菜っ葉	なっぱ	nappa
飛びだす	とびだす	tobidasu
天下る	あまくだる	amakudaru
知りあい	しりあい	shiriai
行き着ける	いきつける|ゆきつける	ikitsukeru|yukitsukeru
むき身	むきみ	mukimi
たたき起こす	たたきおこす	tatakiokosu
手いっぱい	ていっぱい	teippai
聞き役	ききやく	kikiyaku
花ごよみ	はなごよみ	hanagoyomi
飛びまわる	とびまわる	tobimawaru
実入り	みいり	miiri
飛び飛び	とびとび	tobitobi
小見出し	こみだし	komidashi
使いもの	つかいもの	tsukaimono
い服	いふく	ifuku
成れる	なれる	nareru
男泣き	おとこなき	otokonaki
ふれ合い	ふれあい	fureai
冷や水	ひやみず	hiyamizu
天下分け目	てんかわけめ	tennkawakeme
思いたつ	おもいたつ	omoitatsu
早分かり	はやわかり	hayawakari
声変わり	こえがわり	koegawari
具える	そなえる	sonaeru
まゆ毛	まゆげ	mayuge
見定める	みさだめる	misadameru
重んずる	おもんずる	omonnzuru
わり算	わりざん	warizann
立ちあがり	たちあがり	tachiagari
夜鳴き	よなき	yonaki
極楽とんぼ	ごくらくとんぼ	gokurakutonnbo
注し	さし|ちゅうし|ざし	sashi|tyuushi|zashi
死なす	しなす	shinasu
手はず	てはず	tehazu
橋りょう	きょうりょう	kyouryou
はぎ取る	はぎとる	hagitoru
目付け	めつけ	metsuke
差しかかる	さしかかる	sashikakaru
投げ入れる	なげいれる	nageireru
飲みもの	のみもの	nomimono
飛び付く	とびつく	tobitsuku
都落ち	みやこおち	miyakoochi
取りつかれる	とりつかれる	toritsukareru
仲間外れ	なかまはずれ	nakamahazure
読み下す	よみくだす	yomikudasu
料る	りょうる	ryouru
動機付ける	どうきづける	doukidukeru
島しょ	とうしょ	tousho
すきま風	すきまかぜ	sukimakaze
人好き	ひとずき	hitozuki
切れ者	きれもの|きれもん	kiremono|kiremonn
まっ白	まっしろ	masshiro
別もの	べつもの	betsumono
助く	たすく	tasuku
足どり	あしどり	ashidori
走り出る	はしりでる	hashirideru
選り好み	えりごのみ|よりごのみ	erigonomi|yorigonomi
首ったけ	くびったけ	kubittake
仕置き	しおき	shioki
送りだす	おくりだす	okuridasu
白みそ	しろみそ	shiromiso
切りそろえる	きりそろえる	kirisoroeru
先付け	さきづけ	sakiduke
送り付ける	おくりつける	okuritsukeru
打ちっ放し	うちっぱなし	uchippanashi
数え上げる	かぞえあげる	kazoeageru
取消す	とりけす	torikesu
食いつなぐ	くいつなぐ	kuitsunagu
お高く	おたかく	otakaku
取りこむ	とりこむ	torikomu
相変わる	あいかわる	aikawaru
夏向き	なつむき	natsumuki
せせら笑う	せせらわらう|せせらわろう	seserawarau|seserawarou
積み荷	つみに	tsumini
茶こし	ちゃこし	tyakoshi
ぶん投げる	ぶんなげる	bunnnageru
うちの人	うちのひと	uchinohito
金もうけ	かねもうけ	kanemouke
なり手	なりて	narite
先がける	さきがける	sakigakeru
ただ者	ただもの	tadamono
さし絵	さしえ	sashie
和める	なごめる	nagomeru
浴びせかける	あびせかける	abisekakeru
取りつく	とりつく	toritsuku
羽ばたける	はばたける	habatakeru
入れかえる	いれかえる	irekaeru
青黒い	あおぐろい	aoguroi
聞き苦しい	ききぐるしい	kikigurushii
送りこむ	おくりこむ	okurikomu
語りつぐ	かたりつぐ	kataritsugu
野遊び	のあそび	noasobi
上ずる	うわずる	uwazuru
くの一	くのいち	kunoichi
方向づけ	ほうこうづけ	houkouduke
水がめ	みずがめ	mizugame
分け目	わけめ	wakeme
かけ橋	かけはし	kakehashi
七光り	ななひかり	nanahikari
力づける	ちからづける	chikaradukeru
人さし指	ひとさしゆび	hitosashiyubi
板ばさみ	いたばさみ	itabasami
世話焼き	せわやき	sewayaki
わき起こる	わきおこる	wakiokoru
仲よし	なかよし	nakayoshi
まき絵	まきえ	makie
見なれる	みなれる	minareru
ぜい肉	ぜいにく	zeiniku
聞き分ける	ききわける	kikiwakeru
泣きわめく	なきわめく	nakiwameku
香しい	かぐわしい	kaguwashii
学び取る	まなびとる	manabitoru
わき水	わきみず	wakimizu
言いだしっぺ	いいだしっぺ	iidashippe
合せる	あわせる	awaseru
うるう年	うるうどし	uruudoshi
包める	つつめる|くるめる	tsutsumeru|kurumeru
道行き	みちゆき	michiyuki
弱っちい	よわっちい	yowacchii
目のあたり	まのあたり	manoatari
追いすがる	おいすがる	oisugaru
引き取り手	ひきとりて	hikitorite
散り散り	ちりぢり|ちりじり	chiridiri|chirijiri
毛むくじゃら	けむくじゃら	kemukujara
水け	みずけ	mizuke
赤みがかる	あかみがかる	akamigakaru
めん類	めんるい	mennrui
ぜん息	ぜんそく	zennsoku
焼きつける	やきつける	yakitsukeru
手負い	ておい	teoi
なで下ろす	なでおろす	nadeorosu
まい進	まいしん	maishinn
一皮むける	ひとかわむける	hitokawamukeru
真ん丸	まんまる	mannmaru
和する	わする	wasuru
便せん	びんせん	binnsenn
組入れる	くみいれる	kumiireru
観音開き	かんのんびらき	kannnonnbiraki
雪どけ	ゆきどけ	yukidoke
虫の息	むしのいき	mushinoiki
入れ代わる	いれかわる	irekawaru
引きだす	ひきだす	hikidasu
火あぶり	ひあぶり	hiaburi
出あう	であう	deau
成り代わる	なりかわる	narikawaru
お流れ	おながれ	onagare
はしご車	はしごしゃ	hashigosha
花かご	はなかご	hanakago
切りかかる	きりかかる	kirikakaru
作り笑い	つくりわらい	tsukuriwarai
かき出す	かきだす	kakidasu
大っぴら	おおっぴら	ooppira
積み立てる	つみたてる	tsumitateru
かき鳴らす	かきならす	kakinarasu
大売出し	おおうりだし	oouridashi
かぶと虫	かぶとむし	kabutomushi
点取り	てんとり	tenntori
死に場所	しにばしょ	shinibasho
手さばき	てさばき	tesabaki
弓なり	ゆみなり	yuminari
おびき出す	おびきだす	obikidasu
岩のり	いわのり	iwanori
右向き	みぎむき	migimuki
求まる	もとまる	motomaru
こぼれ落ちる	こぼれおちる	koboreochiru
記せる	しるせる	shiruseru
もみ消す	もみけす	momikesu
極まり	きわまり|きまり	kiwamari|kimari
来し方	きしかた|こしかた	kishikata|koshikata
またたく間	またたくま	matatakuma
読み流す	よみながす	yominagasu
借上げ	かりあげ	kariage
当て馬	あてうま	ateuma
書き付ける	かきつける	kakitsukeru
でき上がり	できあがり	dekiagari
鳴ける	なける	nakeru
焼きいも	やきいも	yakiimo
色刷り	いろずり	irozuri
結わえる	ゆわえる	yuwaeru
なき声	なきごえ	nakigoe
いんげん豆	いんげんまめ	inngennmame
氷る	こおる|こうる	kooru|kouru
物覚え	ものおぼえ	monooboe
横好き	よこずき	yokozuki
悪乗り	わるのり	warunori
計れる	はかれる	hakareru
切れ切れ	きれぎれ	kiregire
のたうち回る	のたうちまわる	notauchimawaru
売りつくす	うりつくす	uritsukusu
風切り	かざきり|かぜきり	kazakiri|kazekiri
成れの果て	なれのはて	narenohate
湯引く	ゆびく	yubiku
立ち上り	たちあがり|たちのぼり	tachiagari|tachinobori
仲立ち	なかだち	nakadachi
読みとり	よみとり	yomitori
足つき	あしつき	ashitsuki
進ちょく	しんちょく	shinntyoku
乗入れる	のりいれる	noriireru
節回し	ふしまわし	fushimawashi
読みこなす	よみこなす	yomikonasu
海鳴り	うみなり	uminari
ろ紙	ろし	roshi
養える	やしなえる	yashinaeru
くみ取り	くみとり	kumitori
取りかえる	とりかえる	torikaeru
取り落とす	とりおとす	toriotosu
水かさ	みずかさ	mizukasa
追い上げる	おいあげる	oiageru
印す	しるす|いんす	shirusu|innsu
育てあげる	そだてあげる	sodateageru
目鼻立ち	めはなだち	mehanadachi
借る	かる	karu
間近い	まぢかい|まじかい	madikai|majikai
面食い	めんくい|めんくらい	mennkui|mennkurai
積立て	つみたて	tsumitate
置きかえる	おきかえる	okikaeru
福引き	ふくびき	fukubiki
的はずれ	まとはずれ	matohazure
寺参り	てらまいり	teramairi
風待ち	かざまち|かぜまち	kazamachi|kazemachi
建て前	たてまえ	tatemae
山かけ	やまかけ	yamakake
具に	つぶさに	tsubusani
練り合わせる	ねりあわせる	neriawaseru
がた落ち	がたおち	gataochi
天つゆ	てんつゆ	tenntsuyu
書き表す	かきあらわす	kakiarawasu
何のその	なんのその	nannnosono
うすら寒い	うすらさむい|うすらさみい	usurasamui|usurasamii
世話好き	せわずき	sewazuki
前立て	まえだて	maedate
買い受ける	かいうける	kaiukeru
泳ぎ方	およぎかた	oyogikata
日の本	ひのもと	hinomoto
こけら落とし	こけらおとし	kokeraotoshi
読み通す	よみとおす	yomitoosu
雪あかり	ゆきあかり	yukiakari
月の輪	つきのわ	tsukinowa
四つ角	よつかど	yotsukado
湯せん	ゆせん	yusenn
ひた走り	ひたはしり|ひたばしり	hitahashiri|hitabashiri
思うつぼ	おもうつぼ	omoutsubo
犬ぞり	いぬぞり	inuzori
切り目	きりめ	kirime
中落ち	なかおち	nakaochi
飲み明かす	のみあかす	nomiakasu
続き物	つづきもの	tsudukimono
とり上げる	とりあげる	toriageru
ばら肉	ばらにく	baraniku
見立てる	みたてる	mitateru
差し出せる	さしだせる	sashidaseru
止めど	とめど	tomedo
親せき	しんせき	shinnseki
病が	びょうが	byouga
後ろ指	うしろゆび	ushiroyubi
元売り	もとうり	motouri
かけ合う	かけあう|かけおう	kakeau|kakeou
重量挙げ	じゅうりょうあげ	juuryouage
受けとり	うけとり	uketori
足かけ	あしかけ	ashikake
花ことば	はなことば	hanakotoba
風前の灯	ふうぜんのともしび	fuuzennnotomoshibi
差し出がましい	さしでがましい	sashidegamashii
置き引き	おきびき	okibiki
きれい事	きれいごと	kireigoto
早打ち	はやうち	hayauchi
つぼ焼き	つぼやき	tsuboyaki
切りとる	きりとる	kiritoru
売り言葉	うりことば	urikotoba
置き物	おきもの	okimono
日本晴れ	にっぽんばれ|にほんばれ	nipponnbare|nihonnbare
顔向け	かおむけ	kaomuke
気立て	きだて	kidate
使いみち	つかいみち	tsukaimichi
書きつける	かきつける	kakitsukeru
心する	こころする	kokorosuru
研さん	けんさん	kennsann
お歯黒	おはぐろ	ohaguro
ちり紙	ちりがみ|ちりし	chirigami|chirishi
金切り声	かなきりごえ	kanakirigoe
孫の手	まごのて	magonote
学びや	まなびや	manabiya
心ならずも	こころならずも	kokoronarazumo
なたね油	なたねあぶら	nataneabura
安らう	やすらう	yasurau
他山の石	たざんのいし	tazannnoishi
ささ身	ささみ	sasami
ごま塩	ごましお	gomashio
花いちもんめ	はないちもんめ	hanaichimonnme
水ぼうそう	みずぼうそう	mizubousou
大写し	おおうつし	ooutsushi
ばら色	ばらいろ	barairo
いま一つ	いまひとつ	imahitotsu
熱る	ほてる|いきる	hoteru|ikiru
こぼれ種	こぼれだね	koboredane
持ち分	もちぶん	mochibunn
願い下げ	ねがいさげ	negaisage
ただし書き	ただしがき	tadashigaki
関連付ける	かんれんづける	kannrenndukeru
一足飛び	いっそくとび	issokutobi
行きずり	いきずり|ゆきずり	ikizuri|yukizuri
差引く	さしひく	sashihiku
競る	せる|きそえる|ぜる	seru|kisoeru|zeru
口開け	くちあけ	kuchiake
身ぶり	みぶり	miburi
開き戸	ひらきど	hirakido
七つの海	ななつのうみ	nanatsunoumi
気むずかしい	きむずかしい	kimuzukashii
組み付く	くみつく	kumitsuku
口ひげ	くちひげ	kuchihige
高飛び	たかとび	takatobi
失する	しっする|うする	shissuru|usuru
陽ざし	ひざし	hizashi
指し手	さして	sashite
立て直せる	たてなおせる	tatenaoseru
具合い	ぐあい	guai
雨あられ	あめあられ	amearare
当たりまえ	あたりまえ	atarimae
すし飯	すしめし	sushimeshi
はじき返す	はじきかえす	hajikikaesu
一ぱい	いっぱい	ippai
朝立ち	あさだち	asadachi
焼きもの	やきもの	yakimono
花入れ	はないれ	hanaire
やり切れない	やりきれない	yarikirenai
差し金	さしがね	sashigane
姉たち	あねたち	anetachi
雨だれ	あまだれ	amadare
積み出す	つみだす	tsumidasu
借り出す	かりだす	karidasu
急がす	いそがす	isogasu
夕ごはん	ゆうごはん	yuugohann
つるし上げ	つるしあげ	tsurushiage
落とし前	おとしまえ	otoshimae
かば焼き	かばやき	kabayaki
追える	おえる	oeru
七つ道具	ななつどうぐ	nanatsudougu
もらい物	もらいもの	moraimono
出初め	でぞめ	dezome
勝ち気	かちき	kachiki
山の手線	やまのてせん	yamanotesenn
地ならし	じならし	jinarashi
人聞き	ひとぎき	hitogiki
左向き	ひだりむき	hidarimuki
歯向かう	はむかう	hamukau
血の池	ちのいけ	chinoike
食い合う	くいあう|くいおう	kuiau|kuiou
上目使い	うわめづかい	uwamedukai
冷やか	ひややか	hiyayaka
問いあわせる	といあわせる	toiawaseru
月あかり	つきあかり	tsukiakari
見当る	みあたる	miataru
土いじり	つちいじり	tsuchiijiri
希う	こいねがう|こいねごう|ねがう|ねごう	koinegau|koinegou|negau|negou
耳より	みみより	mimiyori
年の功	としのこう	toshinokou
もめ事	もめごと	momegoto
たわ言	たわごと	tawagoto
飲み下す	のみくだす	nomikudasu
つり合う	つりあう|つりおう	tsuriau|tsuriou
集える	つどえる	tsudoeru
祝える	いわえる	iwaeru
見下げる	みさげる	misageru
山びこ	やまびこ	yamabiko
ひいき目	ひいきめ	hiikime
いろは歌	いろはうた	irohauta
飯ごう	はんごう	hanngou
冬ごもり	ふゆごもり	fuyugomori
向かいあう	むかいあう	mukaiau
書き立てる	かきたてる	kakitateru
投ずる	とうずる	touzuru
すすり泣き	すすりなき	susurinaki
上れる	のぼれる|あがれる	noboreru|agareru
見せどころ	みせどころ	misedokoro
小ぢんまり	こぢんまり|こじんまり	kodinnmari|kojinnmari
意味あい	いみあい	imiai
結い上げる	ゆいあげる	yuiageru
雪うさぎ	ゆきうさぎ	yukiusagi
小さ目	ちいさめ	chiisame
引きずり回す	ひきずりまわす	hikizurimawasu
天びん	てんびん	tennbinn
買いこむ	かいこむ	kaikomu
書き送る	かきおくる	kakiokuru
まっ黒	まっくろ	makkuro
言い立てる	いいたてる	iitateru
遊び回る	あそびまわる	asobimawaru
立上り	たちあがり|たちのぼり	tachiagari|tachinobori
せん定	せんてい	senntei
男好き	おとこずき	otokozuki
見すえる	みすえる	misueru
太っちょ	ふとっちょ	futottyo
小うるさい	こうるさい	kourusai
見つけ出せる	みつけだせる	mitsukedaseru
取入れ	とりいれ	toriire
歌わす	うたわす	utawasu
さく井	さくせい	sakusei
くみ取る	くみとる	kumitoru
はき出す	はきだす	hakidasu
かかわり合い	かかわりあい	kakawariai
むせ返る	むせかえる	musekaeru
庭作り	にわつくり|にわづくり	niwatsukuri|niwadukuri
じん帯	じんたい	jinntai
一時しのぎ	いちじしのぎ	ichijishinogi
どら焼	どらやき	dorayaki
産みつける	うみつける	umitsukeru
山すそ	やますそ	yamasuso
返す返す	かえすがえす	kaesugaesu
読みもの	よみもの	yomimono
くぎ付け	くぎづけ	kugiduke
手ざわり	てざわり	tezawari
目まい	めまい	memai
ひん曲がる	ひんまがる	hinnmagaru
出切る	できる	dekiru
昔語り	むかしがたり	mukashigatari
金づる	かねづる	kaneduru
初っぱな	しょっぱな	shoppana
船積み	ふなづみ	funadumi
何時しか	いつしか	itsushika
手ひどい	てひどい	tehidoi
列ぶ	ならぶ	narabu
強ばる	こわばる	kowabaru
泣き所	なきどころ	nakidokoro
塩っぱい	しょっぱい	shoppai
底無し	そこなし	sokonashi
起が	きが	kiga
雨ざらし	あまざらし	amazarashi
空かす	すかす	sukasu
巣ごもる	すごもる	sugomoru
あいさつ回り	あいさつまわり	aisatsumawari
つまみ出す	つまみだす	tsumamidasu
ただ事	ただごと	tadagoto
石こう	せっこう	sekkou
取りはずす	とりはずす	torihazusu
雨ふり	あめふり	amefuri
焼け死ぬ	やけしぬ	yakeshinu
上げ下ろし	あげおろし	ageoroshi
取り立てる	とりたてる	toritateru
差せる	させる	saseru
お側	おそば	osoba
建て売り	たてうり	tateuri
さくら草	さくらそう	sakurasou
買い言葉	かいことば	kaikotoba
言葉少な	ことばすくな|ことばずくな	kotobasukuna|kotobazukuna
積み下ろし	つみおろし	tsumioroshi
引きあげる	ひきあげる	hikiageru
まがい物	まがいもの	magaimono
有り金	ありがね	arigane
落ちつける	おちつける	ochitsukeru
羊かん	ようかん	youkann
首すじ	くびすじ	kubisuji
お仕着せ	おしきせ	oshikise
左きき	ひだりきき	hidarikiki
給する	きゅうする	kyuusuru
取決める	とりきめる	torikimeru
徒に	いたずらに	itazurani
そば切り	そばきり	sobakiri
橋げた	はしげた	hashigeta
石づき	いしづき	ishiduki
使いで	つかいで	tsukaide
死に神	しにがみ	shinigami
乗りつける	のりつける	noritsukeru
冷や飯	ひやめし	hiyameshi
金ぴか	きんぴか	kinnpika
見合せる	みあわせる	miawaseru
借り方	かりかた	karikata
読み返せる	よみかえせる	yomikaeseru
いの一番	いのいちばん	inoichibann
人少な	ひとずくな	hitozukuna
置き手紙	おきてがみ	okitegami
朝起き	あさおき	asaoki
持出す	もちだす	mochidasu
あきれ果てる	あきれはてる	akirehateru
乗りこなせる	のりこなせる	norikonaseru
語り明かす	かたりあかす	katariakasu
用足し	ようたし	youtashi
女たらし	おんなたらし	onnnatarashi
切り付ける	きりつける	kiritsukeru
取りまく	とりまく	torimaku
書きためる	かきためる	kakitameru
とろ火	とろび	torobi
口説き落とす	くどきおとす	kudokiotosu
少なくも	すくなくも	sukunakumo
いけ好かない	いけすかない	ikesukanai
ほほ笑み	ほほえみ	hohoemi
野次る	やじる	yajiru
七草がゆ	ななくさがゆ	nanakusagayu
浅まい	あさまい	asamai
差し入れる	さしいれる	sashiireru
打合わせ	うちあわせ	uchiawase
赤らむ	あからむ	akaramu
気どる	きどる|けどる	kidoru|kedoru
そぎ切り	そぎぎり	sogigiri
ひっくり返せる	ひっくりかえせる	hikkurikaeseru
見のがす	みのがす	minogasu
色いろ	いろいろ	iroiro
取っ付き	とっつき	tottsuki
行き付け	いきつけ|ゆきつけ	ikitsuke|yukitsuke
はち切れる	はちきれる	hachikireru
挙る	あがる|こぞる	agaru|kozoru
聞き入れる	ききいれる	kikiireru
ほう助	ほうじょ	houjo
折り紙付き	おりがみつき	origamitsuki
遊び歩く	あそびあるく	asobiaruku
打ち放す	うちはなす	uchihanasu
手ぬるい	てぬるい	tenurui
川開き	かわびらき	kawabiraki
かん養	かんよう	kannyou
売り上げる	うりあげる	uriageru
行ずる	ぎょうずる	gyouzuru
組みなおす	くみなおす	kuminaosu
血合い	ちあい	chiai
山出し	やまだし	yamadashi
止り	とまり|どまり|とどまり	tomari|domari|todomari
読み合わせる	よみあわせる	yomiawaseru
書する	しょする	shosuru
晴らせる	はらせる	haraseru
根無し草	ねなしぐさ	nenashigusa
富くじ	とみくじ	tomikuji
取りとめる	とりとめる	toritomeru
取り消せる	とりけせる	torikeseru
鼻持ち	はなもち	hanamochi
おぼろ月夜	おぼろづきよ	oborodukiyo
買受ける	かいうける	kaiukeru
よそ行き	よそいき|よそゆき	yosoiki|yosoyuki
中入り	なかいり	nakairi
高みの見物	たかみのけんぶつ	takaminokennbutsu
さい帯	さいたい	saitai
売りきれる	うりきれる	urikireru
くせ者	くせもの	kusemono
とび出る	とびでる	tobideru
思いあたる	おもいあたる	omoiataru
出直せる	でなおせる	denaoseru
力試し	ちからだめし	chikaradameshi
かんきつ類	かんきつるい	kannkitsurui
横やり	よこやり	yokoyari
花かんざし	はなかんざし	hanakannzashi
温む	ぬるむ	nurumu
見取り	みとり|みどり	mitori|midori
行く年	ゆくとし	yukutoshi
生まれ変われる	うまれかわれる	umarekawareru
中の間	なかのま	nakanoma
子だくさん	こだくさん	kodakusann
書きあげる	かきあげる	kakiageru
飛び切り	とびきり	tobikiri
ご両人	ごりょうにん	goryouninn
読みかえる	よみかえる	yomikaeru
焼き場	やきば	yakiba
むし暑い	むしあつい|むしあちい	mushiatsui|mushiachii
立ちどまる	たちどまる	tachidomaru
名のり	なのり	nanori
内輪もめ	うちわもめ	uchiwamome
身一つ	みひとつ	mihitotsu
貝がら	かいがら	kaigara
口やかましい	くちやかましい	kuchiyakamashii
色つや	いろつや	irotsuya
親代わり	おやがわり	oyagawari
かん高い	かんだかい	kanndakai
覚す	さます|ざます	samasu|zamasu
話しぶり	はなしぶり	hanashiburi
がん具	がんぐ	ganngu
身ぐるみ	みぐるみ	migurumi
めぐり合わせ	めぐりあわせ	meguriawase
さいの目	さいのめ	sainome
見なせる	みなせる	minaseru
ゆずり葉	ゆずりは	yuzuriha
速まる	はやまる	hayamaru
本に	ほんに	honnni
何気無い	なにげない	nanigenai
黒こげ	くろこげ	kurokoge
書き下す	かきくだす	kakikudasu
言い聞かす	いいきかす	iikikasu
差入れ	さしいれ	sashiire
たたき上げる	たたきあげる	tatakiageru
仕上る	しあがる	shiagaru
上げ相場	あげそうば	agesouba
待ち合わせる	まちあわせる	machiawaseru
焼きもち	やきもち	yakimochi
前ぶれ	まえぶれ	maebure
出たとこ勝負	でたとこしょうぶ	detatokoshoubu
目の子	めのこ	menoko
あて名	あてな	atena
加さん	かさん	kasann
かじ取り	かじとり	kajitori
やり玉	やりだま	yaridama
切下げ	きりさげ	kirisage
落着き	おちつき	ochitsuki
研げる	とげる	togeru
取っつき	とっつき	tottsuki
引き回す	ひきまわす	hikimawasu
買いかぶる	かいかぶる	kaikaburu
宮仕え	みやづかえ	miyadukae
急く	せく	seku
差出す	さしだす	sashidasu
指切り	ゆびきり	yubikiri
岡っ引き	おかっぴき	okappiki
死に目	しにめ	shinime
すり足	すりあし	suriashi
目ざめ	めざめ	mezame
引っくり返す	ひっくりかえす	hikkurikaesu
付きっきり	つきっきり	tsukikkiri
丸だし	まるだし	marudashi
ひとっ飛び	ひとっとび	hitottobi
消し止める	けしとめる	keshitomeru
世界じゅう	せかいじゅう	sekaijuu
くい止める	くいとめる	kuitomeru
立ち代る	たちかわる	tachikawaru
ぐい飲み	ぐいのみ	guinomi
上げ底	あげぞこ	agezoko
取り計らい	とりはからい	torihakarai
引きずりこむ	ひきずりこむ	hikizurikomu
食べかす	たべかす	tabekasu
ぼう然	ぼうぜん	bouzenn
持ち帰れる	もちかえれる	mochikaereru
し笑	ししょう	shishou
起てる	たてる|だてる	tateru|dateru
手さげ	てさげ	tesage
心付け	こころづけ	kokoroduke
くり出す	くりだす	kuridasu
聞きづらい	ききづらい	kikidurai
残りもの	のこりもの	nokorimono
行く行く	ゆくゆく	yukuyuku
さらし者	さらしもの	sarashimono
水かき	みずかき	mizukaki
荷さばき	にさばき	nisabaki
辞する	じする	jisuru
火の元	ひのもと	hinomoto
説き明かす	ときあかす	tokiakasu
買い付ける	かいつける	kaitsukeru
立ち聞き	たちぎき|たちきき	tachigiki|tachikiki
かな漢字	かなかんじ	kanakannji
覚り	さとり	satori
労しい	いたわしい	itawashii
仕事がら	しごとがら	shigotogara
通わす	かよわす	kayowasu
立ち直れる	たちなおれる	tachinaoreru
こむら返り	こむらがえり	komuragaeri
田作り	たづくり	tadukuri
浴する	よくする	yokusuru
から口	からくち	karakuchi
うわの空	うわのそら	uwanosora
むせび泣く	むせびなく	musebinaku
残り火	のこりび	nokoribi
生焼け	なまやけ	namayake
切り出せる	きりだせる	kiridaseru
つり上がる	つりあがる	tsuriagaru
手落ち	ておち	teochi
思いのたけ	おもいのたけ	omoinotake
草もち	くさもち	kusamochi
選り分ける	えりわける|よりわける	eriwakeru|yoriwakeru
乗りだす	のりだす	noridasu
くり広げる	くりひろげる	kurihirogeru
助け船	たすけぶね	tasukebune
心もち	こころもち	kokoromochi
対がん	たいがん	taigann
真っ平	まっぴら	mappira
読上げる	よみあげる	yomiageru
あめ色	あめいろ	ameiro
物の数	もののかず	mononokazu
習える	ならえる	naraeru
焼き印	やきいん	yakiinn
物入り	ものいり	monoiri
青田買い	あおたがい	aotagai
物分り	ものわかり	monowakari
おつかれ様	おつかれさま	otsukaresama
回らん	かいらん	kairann
星くず	ほしくず	hoshikuzu
大立ち回り	おおたちまわり	ootachimawari
後かたづけ	あとかたづけ	atokataduke
大わらわ	おおわらわ	oowarawa
打切り	うちきり	uchikiri
出来ばえ	できばえ	dekibae
取りたて	とりたて	toritate
通せんぼ	とおせんぼ|とおせんぼう	toosennbo|toosennbou
心づく	こころづく	kokoroduku
入り用	いりよう	iriyou
相まつ	あいまつ	aimatsu
目通し	めどおし	medooshi
気くばり	きくばり	kikubari
空っ風	からっかぜ	karakkaze
力つきる	ちからつきる	chikaratsukiru
死に顔	しにがお	shinigao
思いなおす	おもいなおす	omoinaosu
こう着	こうちゃく	koutyaku
金づち	かなづち	kanaduchi
数え歌	かぞえうた	kazoeuta
乗りかえ	のりかえ	norikae
丸つぶれ	まるつぶれ	marutsubure
口げんか	くちげんか	kuchigennka
湯冷まし	ゆざまし	yuzamashi
はした金	はしたがね	hashitagane
内また	うちまた	uchimata
前借り	まえがり	maegari
葉たばこ	はたばこ	hatabako
向う側	むこうがわ	mukougawa
飛び下りる	とびおりる	tobioriru
組付ける	くみつける	kumitsukeru
売り付ける	うりつける	uritsukeru
もちの木	もちのき	mochinoki
角い	かくい|かきい	kakui|kakii
仕合せ	しあわせ	shiawase
たい積	たいせき	taiseki
べに花	べにばな	benibana
行きがけ	いきがけ|ゆきがけ	ikigake|yukigake
い死	いし	ishi
果てし	はてし	hateshi
聞き出せる	ききだせる	kikidaseru
道具立て	どうぐだて	dougudate
生き字引	いきじびき	ikijibiki
つま先立つ	つまさきだつ	tsumasakidatsu
あぶり出し	あぶりだし	aburidashi
焼け付く	やけつく	yaketsuku
遠乗り	とおのり	toonori
切りつめる	きりつめる	kiritsumeru
なまけ者	なまけもの	namakemono
目差す	めざす	mezasu
書き下し文	かきくだしぶん	kakikudashibunn
心安い	こころやすい|こころやしい	kokoroyasui|kokoroyashii
持ち合わせる	もちあわせる	mochiawaseru
身代り	みがわり	migawari
荷動き	にうごき	niugoki
観ずる	かんずる	kannzuru
決り	きまり|ぎまり	kimari|gimari
草深い	くさぶかい	kusabukai
うわ言	うわごと	uwagoto
立ち向かえる	たちむかえる	tachimukaeru
うじ虫	うじむし	ujimushi
決め球	きめだま	kimedama
書出し	かきだし	kakidashi
祝い酒	いわいざけ	iwaizake
こう配	こうばい|こうはい	koubai|kouhai
晴れわたる	はれわたる	harewataru
鳴かせる	なかせる	nakaseru
栃の木	とちのき	tochinoki
種もみ	たねもみ	tanemomi
当て身	あてみ	atemi
笑い返す	わらいかえす	waraikaesu
人指し指	ひとさしゆび	hitosashiyubi
位取り	くらいどり	kuraidori
負える	おえる	oeru
書き置き	かきおき	kakioki
話しことば	はなしことば	hanashikotoba
何やかや	なんやかや	nannyakaya
孫引き	まごびき	magobiki
今わ	いまわ	imawa
付合う	つきあう|つきおう	tsukiau|tsukiou
ひまし油	ひましゆ	himashiyu
口取り	くちとり	kuchitori
乗りこえる	のりこえる	norikoeru
産みの親	うみのおや	uminooya
借り主	かりぬし	karinushi
差しのべる	さしのべる	sashinoberu
はじき飛ばす	はじきとばす	hajikitobasu
人使い	ひとづかい	hitodukai
横っ飛び	よこっとび	yokottobi
内の人	うちのひと	uchinohito
ひこうき雲	ひこうきぐも	hikoukigumo
ひとりっ子	ひとりっこ	hitorikko
願える	ねがえる	negaeru
はえ縄	はえなわ	haenawa
感じとれる	かんじとれる	kannjitoreru
出がらし	でがらし	degarashi
でっち上げる	でっちあげる	decchiageru
やけ酒	やけざけ	yakezake
引き下ろす	ひきおろす	hikiorosu
本決まり	ほんぎまり	honngimari
付きもの	つきもの	tsukimono
調子づく	ちょうしづく	tyoushiduku
木いちご	きいちご	kiichigo
交ざる	まざる	mazaru
色変わり	いろがわり	irogawari
里いも	さといも	satoimo
景気づけ	けいきづけ	keikiduke
気がね	きがね	kigane
お付	おつき	otsuki
問い直し	といなおし	toinaoshi
死に別れる	しにわかれる	shiniwakareru
消し炭	けしずみ	keshizumi
好もしい	このもしい	konomoshii
考えごと	かんがえごと	kanngaegoto
暗やみ	くらやみ	kurayami
待合せ	まちあわせ	machiawase
名うて	なうて	naute
目ざましい	めざましい	mezamashii
つや出し	つやだし	tsuyadashi
見積る	みつもる	mitsumoru
借り出し	かりだし	karidashi
年度始め	ねんどはじめ	nenndohajime
不ぞろい	ふぞろい	fuzoroi
食いもの	くいもの	kuimono
鼻つまみ	はなつまみ	hanatsumami
思う様	おもうさま	omousama
火の気	ひのけ	hinoke
飲みほす	のみほす	nomihosu
お手つき	おてつき	otetsuki
魚つり	さかなつり	sakanatsuri
血の道	ちのみち	chinomichi
送り出せる	おくりだせる	okuridaseru
打ちきる	うちきる	uchikiru
通ぶる	つうぶる	tsuuburu
男っぷり	おとこっぷり	otokoppuri
夕ぐれ	ゆうぐれ	yuugure
差し止める	さしとめる	sashitomeru
月極め	つきぎめ	tsukigime
あきれ返る	あきれかえる	akirekaeru
ふり向く	ふりむく	furimuku
引く手あまた	ひくてあまた	hikuteamata
思いおこす	おもいおこす	omoiokosu
円やか	まろやか	maroyaka
飲みで	のみで	nomide
焼きとり	やきとり	yakitori
月のもの	つきのもの	tsukinomono
おみ足	おみあし	omiashi
七曲り	ななまがり	nanamagari
つなぎ止める	つなぎとめる	tsunagitomeru
利ざや	りざや	rizaya
会わす	あわす	awasu
立合い	たちあい	tachiai
道づれ	みちづれ	michidure
買い主	かいぬし	kainushi
ひと声	ひとこえ	hitokoe
申し入れ書	もうしいれしょ	moushiiresho
重る	おもる|かさなる	omoru|kasanaru
ほうき星	ほうきぼし	houkiboshi
目打ち	めうち	meuchi
火ぶた	ひぶた	hibuta
手っとり早い	てっとりばやい	tettoribayai
わき目	わきめ	wakime
目だつ	めだつ	medatsu
かり出す	かりだす	karidasu
取り分ける	とりわける	toriwakeru
つなぎ服	つなぎふく	tsunagifuku
急ごしらえ	きゅうごしらえ	kyuugoshirae
議す	ぎす	gisu
心がまえ	こころがまえ	kokorogamae
食わせる	くわせる	kuwaseru
事切れる	こときれる	kotokireru
当てずっぽう	あてずっぽう	atezuppou
打放す	うちはなす	uchihanasu
取りあう	とりあう	toriau
打ち勝てる	うちかてる	uchikateru
お冷	おひや	ohiya
用立てる	ようだてる	youdateru
ねずみ色	ねずみいろ	nezumiiro
言いよどむ	いいよどむ	iiyodomu
転がせる	ころがせる	korogaseru
説ける	とける	tokeru
いたずら書き	いたずらがき	itazuragaki
はしご酒	はしござけ	hashigozake
売り出せる	うりだせる	uridaseru
口説ける	くどける	kudokeru
借り入れる	かりいれる	kariireru
追いまわす	おいまわす	oimawasu
使いこむ	つかいこむ	tsukaikomu
ひょろ長い	ひょろながい	hyoronagai
円すい	えんすい	ennsui
話しこむ	はなしこむ	hanashikomu
取って置き	とっておき	totteoki
お下げ	おさげ	osage
力こぶ	ちからこぶ	chikarakobu
黒焼き	くろやき	kuroyaki
委しい	くわしい	kuwashii
引き分ける	ひきわける	hikiwakeru
さらし首	さらしくび	sarashikubi
なれ合い	なれあい	nareai
だみ声	だみごえ	damigoe
飲みこむ	のみこむ	nomikomu
ちんどん屋	ちんどんや	chinndonnya
安が	あんが	annga
手付け	てつけ	tetsuke
たたき売り	たたきうり	tatakiuri
玉子とじ	たまごとじ	tamagotoji
らい病	らいびょう	raibyou
約する	やくする	yakusuru
走り出せる	はしりだせる	hashiridaseru
でんでん虫	でんでんむし	denndennmushi
書きかた	かきかた	kakikata
食いっぱぐれ	くいっぱぐれ	kuippagure
心づもり	こころづもり	kokorodumori
ねじ切り	ねじきり	nejikiri
相いれる	あいいれる	aiireru
切り開ける	きりひらける	kirihirakeru
大人ぶる	おとなぶる	otonaburu
ぺんぺん草	ぺんぺんぐさ	pennpenngusa
はね返る	はねかえる	hanekaeru
も本	もほん	mohonn
波うつ	なみうつ	namiutsu
出歩ける	であるける	dearukeru
夜ふかし	よふかし	yofukashi
別れ道	わかれみち	wakaremichi
見まがう	みまがう	mimagau
人まかせ	ひとまかせ	hitomakase
学びとる	まなびとる	manabitoru
うの花	うのはな	unohana
差上げる	さしあげる	sashiageru
飛び立てる	とびたてる	tobitateru
当てつける	あてつける	atetsukeru
たて続け	たてつづけ	tatetsuduke
黄み	きみ	kimi
照り付ける	てりつける	teritsukeru
まっ先に	まっさきに	massakini
乗ずる	じょうずる	jouzuru
仲たがい	なかたがい	nakatagai
茶飲み	ちゃのみ	tyanomi
宿無し	やどなし	yadonashi
木取り	きどり|きとり	kidori|kitori
引出す	ひきだす	hikidasu
ごちそう様	ごちそうさま	gochisousama
改む	あらたむ	aratamu
風の神	かぜのかみ	kazenokami
面差し	おもざし	omozashi
落とし主	おとしぬし	otoshinushi
持て成す	もてなす	motenasu
鳥の子	とりのこ	torinoko
目の玉	めのたま	menotama
先だつ	さきだつ	sakidatsu
歯ならび	はならび	hanarabi
仕出かす	しでかす	shidekasu
色どり	いろどり	irodori
立上がる	たちあがる	tachiagaru
光り物	ひかりもの	hikarimono
水あか	みずあか	mizuaka
分かち書き	わかちがき	wakachigaki
側が	そくが	sokuga
貝焼き	かいやき	kaiyaki
労り	いたわり	itawari
漁り火	いさりび	isaribi
着の身着のまま	きのみきのまま	kinomikinomama
やり投げ	やりなげ	yarinage
出し手	だして	dashite
書き出せる	かきだせる	kakidaseru
形見分け	かたみわけ	katamiwake
虫送り	むしおくり	mushiokuri
切上げ	きりあげ	kiriage
積上げる	つみあげる	tsumiageru
待ち合い	まちあい	machiai
町はずれ	まちはずれ	machihazure
はやし立てる	はやしたてる	hayashitateru
明くる日	あくるひ	akuruhi
笑い飛ばせる	わらいとばせる	waraitobaseru
転ばす	ころばす	korobasu
投てき	とうてき	touteki
口さがない	くちさがない	kuchisaganai
旅立てる	たびだてる	tabidateru
ひと山	ひとやま	hitoyama
時どき	ときどき	tokidoki
売付ける	うりつける	uritsukeru
長そで	ながそで	nagasode
力まかせ	ちからまかせ	chikaramakase
打ちどころ	うちどころ	uchidokoro
産気づく	さんけづく	sannkeduku
軽軽しい	かるがるしい|かろがろしい	karugarushii|karogaroshii
塩引き	しおびき	shiobiki
飛び魚	とびうお	tobiuo
切り結ぶ	きりむすぶ	kirimusubu
お気にいり	おきにいり	okiniiri
とまり木	とまりぎ	tomarigi
使い走り	つかいはしり	tsukaihashiri
事も無げ	こともなげ	kotomonage
芽出し	めだし	medashi
言い付ける	いいつける	iitsukeru
引返し	ひきかえし	hikikaeshi
配れる	くばれる	kubareru
生生しい	なまなましい	namanamashii
組みこむ	くみこむ	kumikomu
待合い	まちあい	machiai
買い上げる	かいあげる	kaiageru
馬鹿笑い	ばかわらい	bakawarai
引きしめる	ひきしめる	hikishimeru
生き写し	いきうつし	ikiutsushi
研ぎ出し	とぎだし	togidashi
土ぼこり	つちぼこり	tsuchibokori
紙ふぶき	かみふぶき	kamifubuki
か黒い	かぐろい	kaguroi
受入れる	うけいれる	ukeireru
問合せる	といあわせる	toiawaseru
お守	おまもり|おもり	omamori|omori
真ちゅう	しんちゅう	shinntyuu
二重取り	にじゅうどり	nijuudori
曲がれる	まがれる	magareru
書置き	かきおき	kakioki
戦く	おののく	ononoku
牛ふん	ぎゅうふん	gyuufunn
子別れ	こわかれ	kowakare
知り合える	しりあえる	shiriaeru
どの方	どのかた	donokata
てん菜	てんさい	tennsai
早帰り	はやがえり	hayagaeri
まわり道	まわりみち	mawarimichi
具する	ぐする	gusuru
言いぐさ	いいぐさ	iigusa
食いで	くいで	kuide
長たらしい	ながたらしい	nagatarashii
ひとり立ち	ひとりだち	hitoridachi
来なさる	きなさる	kinasaru
弱り目	よわりめ	yowarime
手のもの	てのもの	tenomono
取って返す	とってかえす	tottekaesu
出合える	であえる	deaeru
言いあう	いいあう	iiau
道すじ	みちすじ	michisuji
人さらい	ひとさらい	hitosarai
着古し	きふるし	kifurushi
大売り出し	おおうりだし	oouridashi
小ざかしい	こざかしい	kozakashii
長びく	ながびく	nagabiku
泣き付く	なきつく	nakitsuku
無いものねだり	ないものねだり	naimononedari
語りべ	かたりべ	kataribe
夕立ち	ゆうだち	yuudachi
見取る	みとる	mitoru
何はなくとも	なにはなくとも	nanihanakutomo
手の者	てのもの	tenomono
あお向け	あおむけ	aomuke
出来す	でかす	dekasu
のど元	のどもと	nodomoto
根の国	ねのくに	nenokuni
物見高い	ものみだかい	monomidakai
果せる	おおせる|はたせる|おうせる	ooseru|hataseru|ouseru
からっ風	からっかぜ	karakkaze
問わず語り	とわずがたり	towazugatari
あ然	あぜん	azenn
死がい	しがい	shigai
木かげ	こかげ	kokage
見晴らす	みはらす	miharasu
清ら	きよら	kiyora
手切れ金	てぎれきん	tegirekinn
木ねじ	もくねじ	mokuneji
ふれ合う	ふれあう|ふれおう	fureau|fureou
待ちこがれる	まちこがれる	machikogareru
取りくむ	とりくむ	torikumu
ひそひそ話	ひそひそばなし	hisohisobanashi
黒み	くろみ	kuromi
焼き切る	やききる	yakikiru
新しもの	あたらしもの	atarashimono
入り切る	はいりきる	hairikiru
願かけ	がんかけ	gannkake
思い止まる	おもいとどまる|おもいとまる	omoitodomaru|omoitomaru
しこ名	しこな	shikona
もろ手	もろて	morote
のけ者	のけもの	nokemono
あばら家	あばらや	abaraya
ろくろ首	ろくろくび	rokurokubi
文無し	もんなし	monnnashi
口当り	くちあたり	kuchiatari
通し柱	とおしばしら	tooshibashira
付け上がる	つけあがる	tsukeagaru
仕合わせ	しあわせ	shiawase
つまみ上げる	つまみあげる	tsumamiageru
心弱い	こころよわい	kokoroyowai
手当たり	てあたり	teatari
おちょぼ口	おちょぼぐち	otyoboguchi
油絵の具	あぶらえのぐ	aburaenogu
作りかえる	つくりかえる	tsukurikaeru
お茶の子	おちゃのこ	otyanoko
三つどもえ	みつどもえ	mitsudomoe
持する	じする	jisuru
星祭り	ほしまつり	hoshimatsuri
老い先	おいさき	oisaki
拾いもの	ひろいもの	hiroimono
身もだえ	みもだえ	mimodae
前祝い	まえいわい	maeiwai
側仕え	そばづかえ	sobadukae
走り回れる	はしりまわれる	hashirimawareru
鳥追い	とりおい	torioi
歩みよる	あゆみよる	ayumiyoru
る説	るせつ	rusetsu
横ずれ	よこずれ	yokozure
松かさ	まつかさ	matsukasa
真っ直中	まっただなか	mattadanaka
今し方	いましがた	imashigata
反す	はんす|かえす	hannsu|kaesu
つづら折り	つづらおり	tsuduraori
読み札	よみふだ	yomifuda
空ろ	うつろ|くうろ|へろ	utsuro|kuuro|hero
流れ図	ながれず	nagarezu
物取り	ものとり	monotori
顔かたち	かおかたち	kaokatachi
真黒い	まっくろい	makkuroi
なす事	なすこと	nasukoto
はげ山	はげやま	hageyama
生き馬	いきうま	ikiuma
引き当てる	ひきあてる	hikiateru
聞きにくい	ききにくい	kikinikui
身のほど	みのほど	minohodo
みつ豆	みつまめ	mitsumame
ふるい落とす	ふるいおとす	furuiotosu
鳴りだす	なりだす	naridasu
竹やり	たけやり	takeyari
時代もの	じだいもの	jidaimono
後向き	うしろむき	ushiromuki
と列	とれつ	toretsu
たたき落とす	たたきおとす	tatakiotosu
手ずから	てずから	tezukara
出来ごと	できごと	dekigoto
覚束無い	おぼつかない	obotsukanai
照焼き	てりやき	teriyaki
無い物ねだり	ないものねだり	naimononedari
黄いろい	きいろい	kiiroi
好きずき	すきずき	sukizuki
着ぶくれ	きぶくれ	kibukure
言いそびれる	いいそびれる	iisobireru
金回り	かねまわり	kanemawari
見回せる	みまわせる	mimawaseru
当り散らす	あたりちらす	atarichirasu
ひとさし指	ひとさしゆび	hitosashiyubi
取り口	とりくち	torikuchi
乗り通す	のりとおす	noritoosu
身持ち	みもち	mimochi
朝な夕な	あさなゆうな	asanayuuna
玉取り	たまとり	tamatori
出どころ	でどころ	dedokoro
買いつける	かいつける	kaitsukeru
勝ち進める	かちすすめる	kachisusumeru
物別れ	ものわかれ	monowakare
聞きほれる	ききほれる	kikihoreru
お菜	おさい	osai
物笑い	ものわらい	monowarai
焼け出す	やけだす	yakedasu
成立つ	なりたつ	naritatsu
気強い	きづよい	kiduyoi
軽んずる	かろんずる	karonnzuru
うら悲しい	うらがなしい	uraganashii
皿回し	さらまわし	saramawashi
手ぐすね	てぐすね	tegusune
委せる	まかせる	makaseru
ぜい弱	ぜいじゃく	zeijaku
つばぜり合い	つばぜりあい	tsubazeriai
横合い	よこあい	yokoai
わき出る	わきでる	wakideru
内もも	うちもも	uchimomo
手さぐり	てさぐり	tesaguri
いわし雲	いわしぐも	iwashigumo
たて糸	たていと	tateito
牛追い	うしおい	ushioi
行きがかり	いきがかり|ゆきがかり	ikigakari|yukigakari
落としぶた	おとしぶた	otoshibuta
でんぐり返し	でんぐりがえし	denngurigaeshi
開けっぱなし	あけっぱなし	akeppanashi
矢じり	やじり	yajiri
水たき	みずたき	mizutaki
つり上げる	つりあげる	tsuriageru
組上げる	くみあげる	kumiageru
平たん	へいたん	heitann
いら立ち	いらだち	iradachi
気軽い	きがるい|きがりい	kigarui|kigarii
七さん	しちさん	shichisann
戦ぐ	そよぐ	soyogu
火打ち	ひうち	hiuchi
ふるい分ける	ふるいわける	furuiwakeru
打ち所	うちどころ	uchidokoro
べき乗	べきじょう	bekijou
追いまくる	おいまくる	oimakuru
立ち上がれる	たちあがれる	tachiagareru
かん子	かんし	kannshi
耳新しい	みみあたらしい	mimiatarashii
間の子	あいのこ	ainoko
食い道楽	くいどうらく	kuidouraku
うす切り	うすぎり	usugiri
すみれ色	すみれいろ	sumireiro
動ずる	どうずる	douzuru
平らか	たいらか	tairaka
立ち会える	たちあえる	tachiaeru
勝ち戦	かちいくさ	kachiikusa
生あたたかい	なまあたたかい	namaatatakai
虫下し	むしくだし	mushikudashi
子の日	ねのひ	nenohi
勉める	つとめる	tsutomeru
買いたたく	かいたたく	kaitataku
立ち止る	たちどまる	tachidomaru
助け合える	たすけあえる	tasukeaeru
下り立つ	おりたつ	oritatsu
灯台もと暗し	とうだいもとくらし	toudaimotokurashi
立ち働く	たちはたらく	tachihataraku
わき見	わきみ	wakimi
選り取り	よりどり|よりとり	yoridori|yoritori
耳ざとい	みみざとい	mimizatoi
手だし	てだし	tedashi
待遠しい	まちどおしい	machidooshii
もみ上げ	もみあげ	momiage
箱書き	はこがき	hakogaki
有り体	ありてい	aritei
書き入れる	かきいれる	kakiireru
聞き流せる	ききながせる	kikinagaseru
のけ反る	のけぞる	nokezoru
生白い	なまじろい|なまっちろい	namajiroi|namacchiroi
あん分	あんぶん	annbunn
鼻白む	はなじろむ	hanajiromu
人気もの	にんきもの	ninnkimono
書きたてる	かきたてる	kakitateru
くず鉄	くずてつ	kuzutetsu
いたし方	いたしかた	itashikata
死にものぐるい	しにものぐるい	shinimonogurui
茶入れ	ちゃいれ	tyaire
放りだす	ほうりだす	houridasu
お上りさん	おのぼりさん	onoborisann
足とり	あしとり	ashitori
より目	よりめ	yorime
水きり	みずきり	mizukiri
お七夜	おしちや	oshichiya
身ごろ	みごろ	migoro
家族づれ	かぞくづれ	kazokudure
書き直せる	かきなおせる	kakinaoseru
分けつ	ぶんけつ	bunnketsu
大事無い	だいじない	daijinai
しゃくり上げる	しゃくりあげる	shakuriageru
だ円	だえん	daenn
手軽い	てがるい|てがりい	tegarui|tegarii
由無い	よしない	yoshinai
投げこむ	なげこむ	nagekomu
組みかえる	くみかえる	kumikaeru
手前みそ	てまえみそ	temaemiso
夜ふけ	よふけ	yofuke
南回り	みなみまわり	minamimawari
光らす	ひからす	hikarasu
茶飲み話	ちゃのみばなし	tyanomibanashi
見切れる	みきれる	mikireru
かき消える	かききえる	kakikieru
読取る	よみとる	yomitoru
わき毛	わきげ	wakige
成行き	なりゆき	nariyuki
下っぱ	したっぱ	shitappa
取り計らう	とりはからう	torihakarau
別刷り	べつづり|べつずり	betsuduri|betsuzuri
受持つ	うけもつ	ukemotsu
面立ち	おもだち	omodachi
宿り木	やどりぎ	yadorigi
耳ざわり	みみざわり	mimizawari
引きおこす	ひきおこす	hikiokosu
もの静か	ものしずか	monoshizuka
極め付ける	きめつける	kimetsukeru
年取り	としとり	toshitori
買い切る	かいきる	kaikiru
青じろい	あおじろい	aojiroi
うれし泣き	うれしなき	ureshinaki
小手調べ	こてしらべ	koteshirabe
物の本	もののほん	mononohonn
生きいき	いきいき	ikiiki
作り付け	つくりつけ	tsukuritsuke
さし木	さしき	sashiki
温み	ぬくみ|あたたかみ|ぬるみ	nukumi|atatakami|nurumi
面はゆい	おもはゆい	omohayui
流行らす	はやらす	hayarasu
大きに	おおきに	ookini
転べる	ころべる	koroberu
湯あがり	ゆあがり	yuagari
黒作り	くろづくり	kurodukuri
生き神	いきがみ	ikigami
人なれる	ひとなれる	hitonareru
みかげ石	みかげいし	mikageishi
夜もすがら	よもすがら	yomosugara
芽ばえ	めばえ	mebae
もつれ合う	もつれあう|もつれおう	motsureau|motsureou
ひ弱い	ひよわい	hiyowai
はね上がる	はねあがる	haneagaru
うそ寒い	うそさむい|うそさみい	usosamui|usosamii
物わかり	ものわかり	monowakari
絵合わせ	えあわせ	eawase
聞き付ける	ききつける	kikitsukeru
音頭取り	おんどとり	onndotori
立て板に水	たていたにみず	tateitanimizu
度しがたい	どしがたい	doshigatai
言いまくり	いいまくり	iimakuri
わが校	わがこう	wagakou
うす茶	うすちゃ	usutya
朝ぼらけ	あさぼらけ	asaborake
組みたてる	くみたてる	kumitateru
申し伝える	もうしつたえる	moushitsutaeru
打出し	うちだし	uchidashi
一本立ち	いっぽんだち	ipponndachi
下読み	したよみ	shitayomi
百度参り	ひゃくどまいり	hyakudomairi
散じる	さんじる	sannjiru
ずり落ちる	ずりおちる	zuriochiru
刷り上がる	すりあがる	suriagaru
用向き	ようむき	youmuki
取付き	とりつき	toritsuki
出合い頭	であいがしら	deaigashira
もり立てる	もりたてる	moritateru
食い足りる	くいたりる	kuitariru
水びたし	みずびたし	mizubitashi
予て	かねて	kanete
長ずる	ちょうずる	tyouzuru
先出し	さきだし	sakidashi
当たり散らす	あたりちらす	atarichirasu
冷えこむ	ひえこむ	hiekomu
荷受け	にうけ	niuke
買い入れる	かいいれる	kaiireru
丸のみ	まるのみ	marunomi
生きながらえる	いきながらえる	ikinagaraeru
予てから	かねてから	kanetekara
やむ無い	やむない	yamunai
差しだす	さしだす	sashidasu
引立て	ひきたて|ひったて	hikitate|hittate
茶せん	ちゃせん	tyasenn
焼き打ち	やきうち	yakiuchi
ささやき声	ささやきごえ	sasayakigoe
泣きはらす	なきはらす	nakiharasu
熱苦しい	あつくるしい	atsukurushii
写し絵	うつしえ	utsushie
小暗い	おぐらい|こぐらい	ogurai|kogurai
荷作り	にづくり	nidukuri
三すくみ	さんすくみ	sannsukumi
取ってつけたよう	とってつけたよう	tottetsuketayou
思いめぐらす	おもいめぐらす	omoimegurasu
息む	いきむ	ikimu
飲んべえ	のんべえ	nonnbee
安んずる	やすんずる	yasunnzuru
追いはぎ	おいはぎ	oihagi
玉乗り	たまのり	tamanori
火打ち石	ひうちいし	hiuchiishi
試し切り	ためしぎり	tameshigiri
心づよい	こころづよい	kokoroduyoi
馬の足	うまのあし	umanoashi
切り下げる	きりさげる	kirisageru
聞す	きこす|きかす	kikosu|kikasu
はだか麦	はだかむぎ	hadakamugi
体する	たいする	taisuru
ぴか一	ぴかいち	pikaichi
切出し	きりだし	kiridashi
初める	そめる|ぞめる|はじめる	someru|zomeru|hajimeru
ひとつ覚え	ひとつおぼえ	hitotsuoboe
ひな鳥	ひなどり	hinadori
立ち後れる	たちおくれる	tachiokureru
横っ面	よこっつら	yokottsura
水あげ	みずあげ	mizuage
組立てる	くみたてる	kumitateru
飛出す	とびだす	tobidasu
飲み手	のみて	nomite
見送れる	みおくれる	miokureru
形無し	かたなし	katanashi
投げ出せる	なげだせる	nagedaseru
上がり口	あがりぐち|あがりくち	agariguchi|agarikuchi
手取り早い	てっとりばやい	tettoribayai
あん馬	あんば	annba
用だつ	ようだつ	youdatsu
わら半紙	わらばんし	warabannshi
生きかえる	いきかえる	ikikaeru
福福しい	ふくぶくしい	fukubukushii
いわく付き	いわくつき	iwakutsuki
以ての外	もってのほか	mottenohoka
極め付き	きわめつき	kiwametsuki
草いきれ	くさいきれ	kusaikire
さくら貝	さくらがい	sakuragai
投げだす	なげだす	nagedasu
仕分ける	しわける	shiwakeru
付きっ切り	つきっきり	tsukikkiri
水もの	みずもの	mizumono
然して	しかして|さして|しこうして	shikashite|sashite|shikoushite
息ぐるしい	いきぐるしい	ikigurushii
地固め	じがため	jigatame
あみ出す	あみだす	amidasu
耳遠い	みみどおい	mimidooi
あずま屋	あずまや	azumaya
店開き	みせびらき	misebiraki
虫めがね	むしめがね	mushimegane
三つ指	みつゆび	mitsuyubi
急き立てる	せきたてる	sekitateru
落ちのびる	おちのびる	ochinobiru
こま犬	こまいぬ	komainu
なまり節	なまりぶし	namaribushi
船遊び	ふなあそび	funaasobi
赤める	あかめる	akameru
鼻っ柱	はなっぱしら	hanappashira
木ぐらい	こぐらい	kogurai
毛じらみ	けじらみ	kejirami
負かせる	まかせる	makaseru
お勝手	おかって	okatte
受け合う	うけあう|うけおう	ukeau|ukeou
変ずる	へんずる	hennzuru
願わしい	ねがわしい	negawashii
図図しい	ずうずうしい	zuuzuushii
山ごもり	やまごもり	yamagomori
取っておき	とっておき	totteoki
主立つ	おもだつ	omodatsu
取りなす	とりなす	torinasu
引っつかむ	ひっつかむ	hittsukamu
具わる	そなわる	sonawaru
初初しい	ういういしい	uiuishii
がまん強い	がまんづよい	gamannduyoi
切りぬく	きりぬく	kirinuku
冷っこい	ひやっこい	hiyakkoi
とちの木	とちのき	tochinoki
根づよい	ねづよい	neduyoi
なまっ白い	なまっちろい	namacchiroi
えり好み	えりごのみ	erigonomi
差しあげる	さしあげる	sashiageru
続き間	つづきあい	tsudukiai
鏡もち	かがみもち	kagamimochi
る言	るげん	rugenn
語り物	かたりもの	katarimono
別れ別れ	わかれわかれ	wakarewakare
悪がしこい	わるがしこい	warugashikoi
験し	ためし|けんし|だめし	tameshi|kennshi|dameshi
手ぶくろ	てぶくろ	tebukuro
夜明かし	よあかし	yoakashi
お足	おあし	oashi
はね上げる	はねあげる	haneageru
よこ糸	よこいと	yokoito
かすめ取る	かすめとる	kasumetoru
あばら屋	あばらや	abaraya
花びん	かびん	kabinn
生なましい	なまなましい	namanamashii
波の花	なみのはな	naminohana
口伝え	くちづたえ	kuchidutae
面もち	おももち	omomochi
進み出す	すすみだす	susumidasu
作り立て	つくりたて	tsukuritate
生まれ月	うまれづき	umareduki
付けどころ	つけどころ	tsukedokoro
小ぐらい	おぐらい|こぐらい	ogurai|kogurai
取り決める	とりきめる	torikimeru
差し当たり	さしあたり	sashiatari
残り多い	のこりおおい|のこりおうい	nokoriooi|nokorioui
手あみ	てあみ	teami
開けっぴろげ	あけっぴろげ	akeppiroge
次つぎ	つぎつぎ	tsugitsugi
試そう	しそう|ためそう	shisou|tamesou
せり出す	せりだす	seridasu
はせ参じる	はせさんじる	hasesannjiru
思い起す	おもいおこす	omoiokosu
後暗い	うしろぐらい	ushirogurai
なすり付ける	なすりつける	nasuritsukeru
ばら積み	ばらづみ	baradumi
転か	てんか	tennka
老いらく	おいらく	oiraku
鼻かぜ	はなかぜ	hanakaze
暗きょ	あんきょ	annkyo
残多い	のこりおおい|のこりおうい	nokoriooi|nokorioui
せん無い	せんない	sennnai
向い風	むかいかぜ	mukaikaze
飛びたつ	とびたつ	tobitatsu
順送り	じゅんおくり	junnokuri
読みこなせる	よみこなせる	yomikonaseru
もの言い	ものいい	monoii
受止める	うけとめる	uketomeru
馬返し	うまがえし	umagaeshi
小ぎれい	こぎれい	kogirei
持上げる	もちあげる	mochiageru
名だかい	なだかい	nadakai
生っ白い	なまっちろい	namacchiroi
切れ上がる	きれあがる	kireagaru
北回り	きたまわり	kitamawari
想える	おもえる	omoeru
丸焼け	まるやけ	maruyake
女もの	おんなもの	onnnamono
手がたい	てがたい	tegatai
間遠い	まどおい	madooi
ふくれっ面	ふくれっつら	fukurettsura
山ふところ	やまふところ	yamafutokoro
酒びたり	さけびたり	sakebitari
日向ぼこ	ひなたぼこ	hinataboko
書き入れ時	かきいれどき	kakiiredoki
浅ぐろい	あさぐろい	asaguroi
借受ける	かりうける	kariukeru
時めく	ときめく	tokimeku
根回り	ねまわり	nemawari
表ざた	おもてざた	omotezata
引つる	ひきつる	hikitsuru
倍する	ばいする	baisuru
首っ引き	くびっぴき	kubippiki
好いたらしい	すいたらしい	suitarashii
番える	つがえる	tsugaeru
弱よわしい	よわよわしい	yowayowashii
目ばやい	めばやい	mebayai
開きなおる	ひらきなおる	hirakinaoru
手間どる	てまどる	temadoru
口べた	くちべた	kuchibeta
売行き	うれゆき	ureyuki
事新しい	ことあたらしい	kotoatarashii
物ぐるおしい	ものぐるおしい	monoguruoshii
引き起す	ひきおこす	hikiokosu
口がたい	くちがたい	kuchigatai
出し切れる	だしきれる	dashikireru
しみ入る	しみいる	shimiiru
女女しい	めめしい	memeshii
差出がましい	さしでがましい	sashidegamashii
度がたい	どしがたい	doshigatai
息せき切る	いきせききる	ikisekikiru
耳どおい	みみどおい	mimidooi
散歩みち	さんぽみち	sannpomichi
細細しい	こまごましい	komagomashii
花やか	はなやか	hanayaka
別して	べっして	besshite
果し合い	はたしあい	hatashiai
気はずかしい	きはずかしい	kihazukashii
神神しい	こうごうしい	kougoushii
とって返す	とってかえす	tottekaesu
付け出し	つけだし	tsukedashi
おぼろ月	おぼろづき	oboroduki
冷や麦	ひやむぎ	hiyamugi
出来上り	できあがり	dekiagari
然ること	さること	sarukoto
結える	ゆわえる	yuwaeru
外まわり	そとまわり	sotomawari
気近い	けぢかい|けじかい	kedikai|kejikai
使われだす	つかわれだす	tsukawaredasu
意味付ける	いみづける	imidukeru
小ぜわしい	こぜわしい	kozewashii
放りっぱなし	ほうりっぱなし	hourippanashi
重おもしい	おもおもしい	omoomoshii
物物しい	ものものしい	monomonoshii
朝めし	あさめし	asameshi
温もる	ぬくもる	nukumoru
受け流せる	うけながせる	ukenagaseru
書送る	かきおくる	kakiokuru
かかあ天下	かかあでんか|かかぁでんか	kakaadennka|kakaladennka
合い方	あいかた	aikata
引きたてる	ひきたてる	hikitateru
重重しい	おもおもしい	omoomoshii
売りこむ	うりこむ	urikomu
生っちろい	なまっちろい	namacchiroi
計り売り	はかりうり	hakariuri
聞苦しい	ききぐるしい	kikigurushii
小やかましい	こやかましい	koyakamashii
つつが無い	つつがない	tsutsuganai
聞ぐるしい	ききぐるしい	kikigurushii
赤じそ	あかじそ	akajiso
曲り角	まがりかど	magarikado
よんどころ無い	よんどころない	yonndokoronai
手あつい	てあつい	teatsui
種取り	たねとり	tanetori
手っとりばやい	てっとりばやい	tettoribayai
かい人	かいじん	kaijinn
苦にがしい	にがにがしい	niganigashii
百日ぜき	ひゃくにちぜき	hyakunichizeki
花はずかしい	はなはずかしい	hanahazukashii
犬死に	いぬじに	inujini
笑いごと	わらいごと	waraigoto
女めしい	めめしい	memeshii
目の当り	まのあたり	manoatari
ぽっと出	ぽっとで	pottode
梅雨晴れ	つゆばれ	tsuyubare
あえ物	あえもの	aemono
手ばしこい	てばしこい	tebashikoi
見ぐるしい	みぐるしい	migurushii
しつけ糸	しつけいと	shitsukeito
空空しい	そらぞらしい	sorazorashii
類さん	るいさん	ruisann
人がましい	ひとがましい	hitogamashii
人なつかしい	ひとなつかしい	hitonatsukashii
火の番	ひのばん	hinobann
持ち切り	もちきり	mochikiri
手びろい	てびろい	tebiroi
物がなしい	ものがなしい	monoganashii
小書き	こがき	kogaki
手重い	ておもい	teomoi
列ねる	つらねる	tsuraneru
育くむ	はぐくむ	hagukumu
おんなの子	おんなのこ	onnnanoko
由由しい	ゆゆしい	yuyushii
昔なじみ	むかしなじみ	mukashinajimi
見目好い	みめよい	mimeyoi
ばく進	ばくしん	bakushinn
便無い	びんない	binnnai
清すがしい	すがすがしい	sugasugashii
いけ図図しい	いけずうずうしい	ikezuuzuushii
口ぎたない	くちぎたない	kuchigitanai
付せん	ふせん	fusenn
物すさまじい	ものすさまじい	monosusamajii
のら犬	のらいぬ	norainu
ひざ元	ひざもと	hizamoto
気づかわしい	きづかわしい	kidukawashii
笑い物	わらいもの	waraimono
引合い	ひきあい	hikiai
死にぞこない	しにぞこない	shinizokonai
たれ流し	たれながし	tarenagashi
つかみ合う	つかみあう|つかみおう	tsukamiau|tsukamiou
生れつき	うまれつき	umaretsuki
まわり遠い	まわりどおい	mawaridooi
晴がましい	はれがましい	haregamashii
手速い	てばやい	tebayai
生じろい	なまじろい	namajiroi
毛ぶかい	けぶかい	kebukai
縄のれん	なわのれん	nawanorenn
有り合わせ	ありあわせ	ariawase
競り市	せりいち	seriichi
労労い	ろうろうい	rouroui
こん包	こんぽう	konnpou
茶がら	ちゃがら	tyagara
さび付く	さびつく	sabitsuku
長もち	ながもち	nagamochi
男男しい	おおしい	ooshii
生新しい	なまあたらしい	namaatarashii
博する	はくする	hakusuru
気色ばむ	けしきばむ	keshikibamu
草ぶかい	くさぶかい	kusabukai
がん作	がんさく	gannsaku
空ぞらしい	そらぞらしい	sorazorashii
回り遠い	まわりどおい	mawaridooi
言い古す	いいふるす	iifurusu
物がたい	ものがたい	monogatai
ほろほろ鳥	ほろほろどり|ほろほろちょう	horohorodori|horohorotyou
軽がろしい	かろがろしい	karogaroshii
点じる	てんじる	tennjiru
すがり付く	すがりつく	sugaritsuku
初もの	はつもの	hatsumono
成りたつ	なりたつ	naritatsu
泣き泣き	なきなき	nakinaki
分別らしい	ふんべつらしい	funnbetsurashii
細かしい	こまかしい	komakashii
物ものしい	ものものしい	monomonoshii
取出す	とりだす	toridasu
白白しい	しらじらしい	shirajirashii
清けい	さやけい	sayakei
小だかい	こだかい	kodakai
角角しい	かどかどしい|かとかどしい	kadokadoshii|katokadoshii
花花しい	はなばなしい	hanabanashii
気がつく	きがつく	kigatsuku
苦しまぎれ	くるしまぎれ	kurushimagire
見好い	みよい	miyoi
小ぎたない	こぎたない	kogitanai
貝の口	かいのくち	kainokuchi
手ばやい	てばやい	tebayai
神ごうしい	こうごうしい	kougoushii
愛づらい	めづらい	medurai
美美しい	びびしい	bibishii
指ぬき	ゆびぬき	yubinuki
気づよい	きづよい	kiduyoi
代われる	かわれる	kawareru
気だかい	けだかい	kedakai
日なたぼっこ	ひなたぼっこ	hinatabokko
木ぶかい	こぶかい	kobukai
薬きょう	やっきょう	yakkyou
勝ち名乗り	かちなのり	kachinanori
木深い	こぶかい	kobukai
苦苦しい	にがにがしい	niganigashii
組合せる	くみあわせる	kumiawaseru
入れあげる	いれあげる	ireageru
無くする	なくする	nakusuru
茶どころ	ちゃどころ	tyadokoro
空はずかしい	そらはずかしい	sorahazukashii
わき役	わきやく	wakiyaku
事ごとしい	ことごとしい	kotogotoshii
転がりこむ	ころがりこむ	korogarikomu
回遠い	まわりどおい	mawaridooi
手がるい	てがるい	tegarui
時雨れる	しぐれる	shigureru
出向ける	でむける	demukeru
だだっ子	だだっこ	dadakko
失くなる	なくなる	nakunaru
弓取り	ゆみとり	yumitori
積重ねる	つみかさねる	tsumikasaneru
画びょう	がびょう	gabyou
焼き塩	やきしお	yakishio
入り日	いりひ	irihi
目ばゆい	まばゆい	mabayui
物ぐるわしい	ものぐるわしい	monoguruwashii
打ちだす	うちだす	uchidasu
角かどしい	かとかどしい	katokadoshii
何心無い	なにごころない	nanigokoronai
曲曲しい	まがまがしい	magamagashii
好き好きい	すきずきい	sukizukii
真っ正直	まっしょうじき	masshoujiki
ずり上がる	ずりあがる	zuriagaru
聞にくい	ききにくい	kikinikui
君付け	くんづけ	kunnduke
本意無い	ほいない	hoinai
もっての外	もってのほか	mottenohoka
手向ける	たむける	tamukeru
聞づらい	ききづらい	kikidurai
はた目	はため	hatame
上がり目	あがりめ	agarime
好きずきい	すきずきい	sukizukii
やぶ医者	やぶいしゃ	yabuisha
根ぶかい	ねぶかい	nebukai
何のかんの	なんのかんの	nannnokannno
飛びこみ	とびこみ	tobikomi
連れる	つれる|づれる	tsureru|dureru
立直す	たてなおす	tatenaosu
入りびたる	いりびたる	iribitaru
四つ身	よつみ	yotsumi
事事しい	ことごとしい	kotogotoshii
初ういしい	ういういしい	uiuishii
あえ無い	あえない	aenai
遠白い	とおしろい	tooshiroi
覚えず	おぼえず	oboezu
上せる	のぼせる	noboseru
横っちょ	よこっちょ	yokottyo
うり二つ	うりふたつ	urifutatsu
つぎ足す	つぎたす	tsugitasu
言いなす	いいなす	iinasu
目つぶし	めつぶし	metsubushi
身びいき	みびいき	mibiiki
美びしい	びびしい	bibishii
小はずかしい	こはずかしい	kohazukashii
白め	しろめ|しらめ	shirome|shirame
界わい	かいわい	kaiwai
見返せる	みかえせる	mikaeseru
くみ出す	くみだす	kumidasu
起きぬけ	おきぬけ	okinuke
やじ馬	やじうま	yajiuma
乗りかえる	のりかえる	norikaeru
花ふぶき	はなふぶき	hanafubuki
切取り	きりとり	kiritori
書入れ	かきいれ	kakiire
わい曲	わいきょく	waikyoku
売り声	うりごえ	urigoe
手開き	てひらき|てびらき	tehiraki|tebiraki
打ちあげる	うちあげる	uchiageru
観する	かんする	kannsuru
読出し	よみだし	yomidashi
送りがな	おくりがな	okurigana
打消す	うちけす	uchikesu
てん末	てんまつ	tennmatsu
通し矢	とおしや	tooshiya
一つ身	ひとつみ	hitotsumi
雪明り	ゆきあかり	yukiakari
玉ぐし	たまぐし	tamagushi
すい星	すいせい	suisei
一人ぽっち	ひとりぽっち	hitoripocchi
切り子	きりこ	kiriko
調子付く	ちょうしづく	tyoushiduku
焼け太り	やけぶとり	yakebutori
育める	はぐくめる	hagukumeru
田遊び	たあそび	taasobi
雪おろし	ゆきおろし	yukioroshi
明り取り	あかりとり	akaritori
所帯持ち	しょたいもち	shotaimochi
重ね合わす	かさねあわす	kasaneawasu
黒める	くろめる	kuromeru
ぜん動	ぜんどう	zenndou
買い上がる	かいあがる	kaiagaru
歩き回れる	あるきまわれる	arukimawareru
買い気	かいき	kaiki
決めこむ	きめこむ	kimekomu
見落す	みおとす	miotosu
取り切れる	とりきれる	torikireru
注する	ちゅうする	tyuusuru
住まわす	すまわす	sumawasu
昼めし	ひるめし	hirumeshi
芽ぶく	めぶく	mebuku
おしろい花	おしろいばな	oshiroibana
体当り	たいあたり	taiatari
起き上がれる	おきあがれる	okiagareru
手あか	てあか	teaka
思うさま	おもうさま	omousama
手わざ	てわざ	tewaza
ひと役	ひとやく	hitoyaku
標す	しるす	shirusu
親思い	おやおもい	oyaomoi
さい先	さいさき	saisaki
火持ち	ひもち	himochi
年回り	としまわり	toshimawari
先んずる	さきんずる	sakinnzuru
地鳴き	じなき	jinaki
はね返り	はねかえり	hanekaeri
紙入れ	かみいれ	kamiire
習わす	ならわす	narawasu
乗りまわす	のりまわす	norimawasu
待ち客	まちきゃく	machikyaku
悪たれ	あくたれ	akutare
駅売り	えきうり	ekiuri
打上げ花火	うちあげはなび	uchiagehanabi
びた一文	びたいちもん	bitaichimonn
金つば	きんつば	kinntsuba
着付ける	きつける	kitsukeru
立て付け	たてつけ	tatetsuke
あだ花	あだばな	adabana
追いたてる	おいたてる	oitateru
うぐいす色	うぐいすいろ	uguisuiro
やり返せる	やりかえせる	yarikaeseru
果たし合い	はたしあい	hatashiai
ぶち当てる	ぶちあてる	buchiateru
火の見やぐら	ひのみやぐら	hinomiyagura
目する	もくする	mokusuru
低める	ひくめる	hikumeru
参ろう	さんろう|まいろう	sannrou|mairou
流ちょう	りゅうちょう	ryuutyou
上向ける	うわむける	uwamukeru
見返る	みかえる	mikaeru
作りもの	つくりもの	tsukurimono
笑いこける	わらいこける	waraikokeru
お絵書き	おえかき	oekaki
言挙げ	ことあげ	kotoage
うす口	うすくち	usukuchi
ひと皮	ひとかわ	hitokawa
笑いころげる	わらいころげる	waraikorogeru
梅ぼし	うめぼし	umeboshi
係り結び	かかりむすび	kakarimusubi
付出し	つけだし	tsukedashi
どら息子	どらむすこ	doramusuko
付け加わる	つけくわわる	tsukekuwawaru
見合わす	みあわす	miawasu
輪乗り	わのり	wanori
仕来り	しきたり	shikitari
折り返せる	おりかえせる	orikaeseru
はん用	はんよう	hannyou
女ごころ	おんなごころ	onnnagokoro
札止め	ふだどめ	fudadome
すりこ木	すりこぎ	surikogi
乗り出せる	のりだせる	noridaseru
すべり出し	すべりだし	suberidashi
後れ毛	おくれげ	okurege
折り重ねる	おりかさねる	orikasaneru
雪ぐ	そそぐ|すすぐ	sosogu|susugu
夏もの	なつもの	natsumono
打ち消せる	うちけせる	uchikeseru
うす焼き	うすやき	usuyaki
菜っぱ	なっぱ	nappa
はしご乗り	はしごのり	hashigonori
底引き	そこびき	sokobiki
言付け	ことづけ|いいつけ	kotoduke|iitsuke
鳥の子紙	とりのこがみ	torinokogami
名折れ	なおれ	naore
うす皮	うすかわ	usukawa
二の矢	にのや	ninoya
先乗り	さきのり	sakinori
立て役者	たてやくしゃ	tateyakusha
う回	うかい	ukai
一生けん命	いっしょうけんめい	isshoukennmei
初参り	はつまいり	hatsumairi
思い当る	おもいあたる	omoiataru
引っぱたく	ひっぱたく	hippataku
ほうり出す	ほうりだす	houridasu
石うす	いしうす	ishiusu
言祝ぐ	ことほぐ	kotohogu
目ざまし	めざまし	mezamashi
星回り	ほしまわり	hoshimawari
送り返せる	おくりかえせる	okurikaeseru
勝ちぬく	かちぬく	kachinuku
松やに	まつやに	matsuyani
色好み	いろごのみ	irogonomi
旗持ち	はたもち	hatamochi
笑い種	わらいぐさ	waraigusa
引き物	ひきもの	hikimono
待ちあわせる	まちあわせる	machiawaseru
見下せる	みくだせる	mikudaseru
切り落す	きりおとす	kiriotosu
思ほす	おもほす	omohosu
菜ばし	さいばし	saibashi
打ち返せる	うちかえせる	uchikaeseru
食い上げ	くいあげ	kuiage
方向づける	ほうこうづける	houkoudukeru
月参り	つきまいり	tsukimairi
手回り	てまわり	temawari
小屋組み	こやぐみ	koyagumi
糸あやつり	いとあやつり	itoayatsuri
小止み	こやみ|おやみ	koyami|oyami
お代り	おかわり	okawari
待ち合せる	まちあわせる	machiawaseru
花立て	はなたて	hanatate
青む	あおむ	aomu
油通し	あぶらどおし|ゆどおし	aburadooshi|yudooshi
見晴らせる	みはらせる	miharaseru
はげ頭	はげあたま	hageatama
夏負け	なつまけ	natsumake
もらい手	もらいて	moraite
手あて	てあて	teate
一本やり	いっぽんやり	ipponnyari
加われる	くわわれる	kuwawareru
付け人	つけびと	tsukebito
村びと	むらびと	murabito
ぼたん雪	ぼたんゆき	botannyuki
語い	ごい|かたらい	goi|katarai
顔合せ	かおあわせ	kaoawase
ひん曲げる	ひんまげる	hinnmageru
い集	いしゅう	ishuu
前後ろ	まえうしろ	maeushiro
引受ける	ひきうける	hikiukeru
ぬぐい去る	ぬぐいさる	nuguisaru
見とがめる	みとがめる	mitogameru
つゆ草	つゆくさ	tsuyukusa
紙きれ	かみきれ	kamikire
科の木	しなのき	shinanoki
のぼせ上がる	のぼせあがる	noboseagaru
切り回す	きりまわす	kirimawasu
なつ印	なついん	natsuinn
打明ける	うちあける	uchiakeru
持合い	もちあい	mochiai
競べ	くらべ	kurabe
身欠きにしん	みがきにしん	migakinishinn
手ふき	てふき	tefuki
草とり	くさとり	kusatori
京おんな	きょうおんな	kyouonnna
引き合わす	ひきあわす	hikiawasu
便る	たよる	tayoru
身動ぎ	みじろぎ	mijirogi
組み合い	くみあい	kumiai
見守れる	みまもれる	mimamoreru
建売り	たてうり	tateuri
落ちこぼれる	おちこぼれる	ochikoboreru
人いきれ	ひといきれ	hitoikire
手配り	てくばり	tekubari
草かんむり	くさかんむり	kusakannmuri
持ち重り	もちおもり	mochiomori
きのこ雲	きのこぐも	kinokogumo
祝ひ	ほがい|いわい	hogai|iwai
心当り	こころあたり	kokoroatari
かかわり合う	かかわりあう|かかわりおう	kakawariau|kakawariou
水の手	みずのて	mizunote
つけ足す	つけたす	tsuketasu
卒する	そっする|しゅっする	sossuru|shussuru
働きもの	はたらきもの	hatarakimono
組みつく	くみつく	kumitsuku
野ねずみ	のねずみ	nonezumi
出会す	でくわす	dekuwasu
でんぐり返る	でんぐりがえる	denngurigaeru
夕なぎ	ゆうなぎ	yuunagi
切り合う	きりあう|きりおう	kiriau|kiriou
ご用聞き	ごようきき	goyoukiki
約束ごと	やくそくごと	yakusokugoto
切返し	きりかえし	kirikaeshi
けん化	けんか	kennka
何くれ	なにくれ	nanikure
手かせ	てかせ	tekase
給わる	たまわる	tamawaru
笑いとばす	わらいとばす	waraitobasu
人まね	ひとまね	hitomane
がく然	がくぜん	gakuzenn
まごの手	まごのて	magonote
もち屋	もちや	mochiya
差っ引く	さっぴく	sappiku
まっ暗	まっくら	makkura
無げ	なげ	nage
後ろ前	うしろまえ	ushiromae
弓引く	ゆみひく	yumihiku
書下し	かきおろし|かきくだし	kakioroshi|kakikudashi
こう門	こうもん	koumonn
事もなげ	こともなげ	kotomonage
力付ける	ちからづける	chikaradukeru
書出す	かきだす	kakidasu
聞取り	ききとり	kikitori
見ほれる	みほれる	mihoreru
西洋なし	せいようなし	seiyounashi
昼下り	ひるさがり	hirusagari
食いしんぼう	くいしんぼう	kuishinnbou
熱冷まし	ねつさまし	netsusamashi
開き直れる	ひらきなおれる	hirakinaoreru
ふり入れる	ふりいれる	furiireru
毛せん	もうせん	mousenn