情報	じょうほう	jouhou
表示	ひょうじ	hyouji
可能	かのう	kanou
内容	ないよう	naiyou
現在	げんざい	gennzai
個人	こじん	kojinn
質問	しつもん	shitsumonn
女性	じょせい|にょしょう	josei|nyoshou
対応	たいおう	taiou
物件	ぶっけん	bukkenn
画像	えぞう|がぞう	ezou|gazou
状態	じょうたい	joutai
技術	ぎじゅつ	gijutsu
機能	きのう	kinou
評価	ひょうか	hyouka
基本	きほん	kihonn
調査	ちょうさ	chousa
価格	かかく	kakaku
条件	じょうけん	joukenn
設定	せってい	settei
実際	じっさい	jissai
効果	こうか	kouka
報告	ほうこく	houkoku
歴史	れきし	rekishi
保険	ほけん	hokenn
経験	けいけん	keikenn
理解	りかい	rikai
確か	たしか	tashika
対象	たいしょう	taishou
営業	えいぎょう	eigyou
結構	けっこう	kekkou
過去	かこ	kako
広告	こうこく	koukoku
事件	じけん	jikenn
程度	ていど	teido
保護	ほご	hogo
経営	けいえい	keiei
資料	しりょう	shiryou
規定	きてい	kitei
責任	せきにん	sekininn
国際	こくさい	kokusai
移動	いどう	idou
製品	せいひん	seihinn
制度	せいど	seido
過ぎ	すぎ	sugi
指導	しどう	shidou
運営	うんえい	unnei
編集	へんしゅう	hennshuu
政治	せいじ	seiji
非常	ひじょう	hijou
総合	そうごう	sougou
業務	ぎょうむ	gyoumu
絶対	ぜったい	zettai
限り	かぎり	kagiri
判断	はんだん	hanndann
団体	だんたい	danntai
政府	せいふ	seifu
原因	げんいん	genninn
表現	ひょうげん	hyougenn
建築	けんちく	kennchiku
男性	だんせい	dannsei
投資	とうし	toushi
意識	いしき	ishiki
知識	ちしき	chishiki
設置	せっち	secchi
能力	のうりょく	nouryoku
準備	じゅんび	junnbi
組織	そしき	soshiki
限定	げんてい	genntei
消費	しょうひ	shouhi
精神	せいしん	seishinn
直接	ちょくせつ	chokusetsu
実現	じつげん	jitsugenn
興味	きょうみ	kyoumi
事務	じむ	jimu
構造	こうぞう	kouzou
主義	しゅぎ	shugi
規約	きやく	kiyaku
通常	つうじょう	tsuujou
解決	かいけつ	kaiketsu
増え	ふえ	fue
事故	じこ	jiko
基準	きじゅん	kijunn
検査	けんさ	kennsa
転職	てんしょく	tennshoku
整備	せいび	seibi
製造	せいぞう	seizou
採用	さいよう	saiyou
建設	けんせつ	kennsetsu
美容	びよう	biyou
解説	かいせつ	kaisetsu
取得	しゅとく	shutoku
感謝	かんしゃ	kannsha
職員	しょくいん	shokuinn
現場	げんば|げんじょう	gennba|gennjou
授業	じゅぎょう	jugyou
設計	せっけい	sekkei
素材	そざい	sozai
印象	いんしょう	innshou
久しぶり	ひさしぶり	hisashiburi
出演	しゅつえん	shutsuenn
行政	ぎょうせい	gyousei
現実	げんじつ	gennjitsu
新規	しんき	shinnki
構成	こうせい	kousei
現代	げんだい	genndai
資格	しかく	shikaku
在庫	ざいこ	zaiko
禁止	きんし	kinnshi
出版	しゅっぱん	shuppann
有効	ゆうこう	yuukou
導入	どうにゅう	dounyuu
提案	ていあん	teiann
医師	いし|くすし	ishi|kusushi
反応	はんのう	hannnou
金額	きんがく	kinngaku
保証	ほしょう	hoshou
設備	せつび	setsubi
修正	しゅうせい	shuusei
研修	けんしゅう	kennshuu
比べ	くらべ	kurabe
可愛い	かわいい|かわい	kawaii|kawai
制作	せいさく	seisaku
世紀	せいき	seiki
基づく	もとづく	motoduku
回復	かいふく	kaifuku
日常	にちじょう	nichijou
想像	そうぞう	souzou
費用	ひよう	hiyou
複数	ふくすう	fukusuu
講演	こうえん	kouenn
新築	しんちく	shinnchiku
再生	さいせい	saisei
平均	へいきん	heikinn
適用	てきよう	tekiyou
提出	ていしゅつ	teishutsu
伝統	でんとう	denntou
確保	かくほ	kakuho
豊か	ゆたか	yutaka
防止	ぼうし	boushi
現状	げんじょう	gennjou
素晴らしい	すばらしい	subarashii
豊富	ほうふ	houfu
再び	ふたたび	futatabi
主張	しゅちょう	shuchou
事情	じじょう	jijou
教授	きょうじゅ	kyouju
報道	ほうどう	houdou
資金	しきん	shikinn
手術	しゅじゅつ	shujutsu
許可	きょか	kyoka
本格	ほんかく	honnkaku
正確	せいかく	seikaku
現地	げんち	gennchi
無断	むだん	mudann
一応	いちおう	ichiou
利益	りえき|りやく	rieki|riyaku
証明	しょうめい	shoumei
示し	しめし	shimeshi
体制	たいせい	taisei
戦略	せんりゃく	sennryaku
犯罪	はんざい	hannzai
表情	ひょうじょう	hyoujou
制限	せいげん	seigenn
最適	さいてき	saiteki
確実	かくじつ	kakujitsu
増加	ぞうか	zouka
停止	ていし|ちょうじ	teishi|chouji
合格	ごうかく	goukaku
性格	せいかく	seikaku
復活	ふっかつ	fukkatsu
独自	どくじ	dokuji
規制	きせい	kisei
大型	おおがた	oogata
予防	よぼう	yobou
集団	しゅうだん	shuudann
製作	せいさく	seisaku
講師	こうし|こうじ	koushi|kouji
任せ	まかせ	makase
効率	こうりつ	kouritsu
教師	きょうし	kyoushi
条例	じょうれい	jourei
弁当	べんとう	benntou
独立	どくりつ	dokuritsu
夫婦	ふうふ|めおと|みょうと	fuufu|meoto|myouto
設立	せつりつ	setsuritsu
要素	ようそ	youso
実績	じっせき	jisseki
航空	こうくう	koukuu
資産	しさん	shisann
感情	かんじょう	kannjou
得る	える|うる	eru|uru
接続	せつぞく	setsuzoku
物質	ぶっしつ	busshitsu
修理	しゅうり|しゅり	shuuri|shuri
品質	ひんしつ	hinnshitsu
示す	しめす	shimesu
評判	ひょうばん	hyoubann
支持	しじ	shiji
芸術	げいじゅつ	geijutsu
快適	かいてき	kaiteki
寄せ	よせ	yose
周囲	しゅうい	shuui
公演	こうえん	kouenn
職場	しょくば	shokuba
同士	どうし	doushi
田舎	いなか	inaka
喜び	よろこび	yorokobi
現れ	あらわれ	araware
構築	こうちく	kouchiku
演出	えんしゅつ	ennshutsu
活性	かっせい	kassei
何故	なぜ|なにゆえ	naze|naniyue
標準	ひょうじゅん	hyoujunn
原則	げんそく	gennsoku
減少	げんしょう	gennshou
神経	しんけい	shinnkei
移転	いてん	itenn
受賞	じゅしょう	jushou
測定	そくてい	sokutei
職業	しょくぎょう	shokugyou
居る	いる|おる	iru|oru
経過	けいか	keika
確定	かくてい	kakutei
所属	しょぞく	shozoku
基地	きち	kichi
災害	さいがい	saigai
大統領	だいとうりょう	daitouryou
適切	てきせつ	tekisetsu
居酒屋	いざかや	izakaya
規則	きそく	kisoku
勢い	いきおい	ikioi
武器	ぶき	buki
貸し	かし|がし	kashi|gashi
適当	てきとう	tekitou
現象	げんしょう	gennshou
慣れ	なれ	nare
得意	とくい	tokui
財産	ざいさん	zaisann
保育	ほいく	hoiku
輸入	ゆにゅう	yunyuu
支配	しはい	shihai
個別	こべつ	kobetsu
所得	しょとく|ところえ	shotoku|tokoroe
態度	たいど	taido
機構	きこう	kikou
財政	ざいせい	zaisei
義務	ぎむ	gimu
出張	しゅっちょう	shucchou
指示	しじ	shiji
性能	せいのう	seinou
記述	きじゅつ	kijutsu
資本	しほん	shihonn
開設	かいせつ	kaisetsu
殺し	ころし|ごろし	koroshi|goroshi
格安	かくやす	kakuyasu
好評	こうひょう	kouhyou
競技	きょうぎ	kyougi
雑貨	ざっか	zakka
強制	きょうせい	kyousei
自殺	じさつ	jisatsu
金属	きんぞく	kinnzoku
解消	かいしょう	kaishou
支え	ささえ|つかえ|かえ	sasae|tsukae|kae
明確	めいかく	meikaku
損害	そんがい	sonngai
文句	もんく	monnku
個性	こせい	kosei
常識	じょうしき	joushiki
保健	ほけん	hokenn
成績	せいせき	seiseki
日程	にってい	nittei
美術	びじゅつ	bijutsu
過程	かてい	katei
期限	きげん	kigenn
特性	とくせい	tokusei
保管	ほかん	hokann
設け	もうけ	mouke
備え	そなえ|ぞなえ	sonae|zonae
素直	すなお	sunao
殺人	さつじん	satsujinn
事態	じたい	jitai
複雑	ふくざつ	fukuzatsu
職人	しょくにん	shokuninn
限界	げんかい	gennkai
統合	とうごう	tougou
芸能	げいのう	geinou
形態	けいたい	keitai
支給	しきゅう	shikyuu
再度	さいど	saido
実態	じったい	jittai
経由	けいゆ	keiyu
配布	はいふ	haifu
統一	とういつ	touitsu
新幹線	しんかんせん	shinnkannsenn
支部	しぶ	shibu
習慣	しゅうかん	shuukann
博士	はかせ|はくし	hakase|hakushi
取り寄せ	とりよせ	toriyose
面接	めんせつ	mennsetsu
通過	つうか	tsuuka
通報	つうほう	tsuuhou
厚生	こうせい	kousei
税金	ぜいきん	zeikinn
検証	けんしょう	kennshou
独特	どくとく	dokutoku
燃料	ねんりょう	nennryou
増える	ふえる	fueru
予測	よそく	yosoku
判決	はんけつ	hannketsu
支店	してん	shitenn
復帰	ふっき	fukki
総会	そうかい	soukai
布団	ふとん|ぶとん	futonn|butonn
確立	かくりつ	kakuritsu
血液	けつえき	ketsueki
前提	ぜんてい	zenntei
定義	ていぎ	teigi
講習	こうしゅう	koushuu
現金	げんきん	gennkinn
講義	こうぎ	kougi
検定	けんてい	kenntei
性質	せいしつ	seishitsu
衛生	えいせい	eisei
過ぎる	よぎる|すぎる	yogiru|sugiru
統計	とうけい	toukei
査定	さてい	satei
造り	つくり|づくり	tsukuri|dukuri
広報	こうほう	kouhou
応用	おうよう	ouyou
受講	じゅこう	jukou
演技	えんぎ	enngi
食堂	しょくどう|じきどう	shokudou|jikidou
仏教	ぶっきょう	bukkyou
入居	にゅうきょ	nyuukyo
判定	はんてい	hanntei
小型	こがた	kogata
観測	かんそく	kannsoku
在住	ざいじゅう	zaijuu
防衛	ぼうえい	bouei
要因	よういん	youinn
在日	ざいにち	zainichi
総理	そうり	souri
永遠	えいえん|とわ	eienn|towa
再現	さいげん	saigenn
救急	きゅうきゅう	kyuukyuu
再開	さいかい	saikai
現役	げんえき	genneki
出現	しゅつげん	shutsugenn
移行	いこう	ikou
予報	よほう	yohou
総務	そうむ	soumu
申告	しんこく	shinnkoku
素人	しろうと	shirouto
確率	かくりつ	kakuritsu
主婦	しゅふ	shufu
新型	しんがた	shinngata
提示	ていじ	teiji
余計	よけい	yokei
格好	かっこう|かっこ	kakkou|kakko
容易	たやす|ようい	tayasu|youi
無効	むこう	mukou
留学	りゅうがく	ryuugaku
予告	よこく	yokoku
改造	かいぞう	kaizou
条約	じょうやく	jouyaku
消防	しょうぼう	shoubou
防災	ぼうさい	bousai
保全	ほぜん	hozenn
特許	とっきょ	tokkyo
輸送	ゆそう	yusou
犯人	はんにん	hannninn
有限	ゆうげん	yuugenn
編成	へんせい	hennsei
形状	けいじょう	keijou
余り	あまり	amari
容量	ようりょう	youryou
防ぐ	ふせぐ	fusegu
幹部	かんぶ	kannbu
勢力	せいりょく	seiryoku
開示	かいじ	kaiji
修行	しゅぎょう	shugyou
解放	かいほう	kaihou
分布	ぶんぷ	bunnpu
保有	ほゆう	hoyuu
業績	ぎょうせき	gyouseki
幹事	かんじ	kannji
不可	ふか	fuka
応え	こたえ|いらえ	kotae|irae
正解	せいかい	seikai
適正	てきせい	tekisei
帰属	きぞく	kizoku
付属	ふぞく	fuzoku
正常	せいじょう	seijou
主演	しゅえん	shuenn
解散	かいさん	kaisann
招待	しょうたい	shoutai
過ごす	すごす	sugosu
本質	ほんしつ	honnshitsu
速報	そくほう	sokuhou
分解	ぶんかい	bunnkai
水準	すいじゅん	suijunn
比べる	くらべる	kuraberu
経費	けいひ	keihi
暴力	ぼうりょく	bouryoku
往復	おうふく	oufuku
輸出	ゆしゅつ	yushutsu
許し	ゆるし	yurushi
大勢	おおぜい|たいせい|たいぜい	oozei|taisei|taizei
判明	はんめい	hannmei
財団	ざいだん	zaidann
週刊	しゅうかん	shuukann
圧力	あつりょく	atsuryoku
増し	まし	mashi
意義	いぎ	igi
任意	にんい	ninni
実質	じっしつ	jisshitsu
河川	かせん	kasenn
逆転	ぎゃくてん	gyakutenn
見解	けんかい	kennkai
法則	ほうそく	housoku
保守	ほしゅ	hoshu
本件	ほんけん	honnkenn
複製	ふくせい	fukusei
正義	せいぎ	seigi
張り	はり|ばり|ぱり	hari|bari|pari
得点	とくてん	tokutenn
賛成	さんせい	sannsei
単独	たんどく	tanndoku
容器	ようき	youki
点検	てんけん	tennkenn
酸素	さんそ	sannso
火災	かさい	kasai
花粉	かふん	kafunn
移植	いしょく	ishoku
総額	そうがく	sougaku
相性	あいしょう|そうしょう	aishou|soushou
工程	こうてい	koutei
告白	こくはく	kokuhaku
謝罪	しゃざい	shazai
制服	せいふく	seifuku
個室	こしつ	koshitsu
貿易	ぼうえき	boueki
職種	しょくしゅ	shokushu
婦人	ふじん|ぷじん	fujinn|pujinn
飼育	しいく	shiiku
重複	じゅうふく|ちょうふく	juufuku|choufuku
愛情	あいじょう	aijou
財布	さいふ	saifu
酸化	さんか	sannka
軽減	けいげん	keigenn
書士	しょし	shoshi
刊行	かんこう	kannkou
務め	つとめ	tsutome
構想	こうそう	kousou
才能	さいのう	sainou
居住	きょじゅう	kyojuu
意志	いし	ishi
現れる	あらわれる	arawareru
現行	げんこう	gennkou
支える	ささえる|つかえる	sasaeru|tsukaeru
防犯	ぼうはん	bouhann
件数	けんすう	kennsuu
検出	けんしゅつ	kennshutsu
省略	しょうりゃく	shouryaku
職務	しょくむ	shokumu
財務	ざいむ	zaimu
解体	かいたい	kaitai
確信	かくしん	kakushinn
体質	たいしつ	taishitsu
説得	せっとく	settoku
史上	しじょう	shijou
保持	ほじ	hoji
告知	こくち	kokuchi
新刊	しんかん	shinnkann
雑談	ざつだん	zatsudann
戦士	せんし	sennshi
正規	せいき	seiki
墓地	ぼち	bochi
境内	けいだい	keidai
寄り	より	yori
規格	きかく	kikaku
損失	そんしつ	sonnshitsu
加減	かげん	kagenn
属性	ぞくせい	zokusei
新設	しんせつ	shinnsetsu
構え	かまえ|がまえ	kamae|gamae
精度	せいど	seido
高額	こうがく	kougaku
複合	ふくごう	fukugou
類似	るいじ	ruiji
守備	しゅび	shubi
人格	じんかく	jinnkaku
寄付	きふ	kifu
制定	せいてい	seitei
実務	じつむ	jitsumu
課税	かぜい	kazei
殺す	ころす	korosu
不快	ふかい	fukai
情熱	じょうねつ	jounetsu
真似	まね	mane
改修	かいしゅう	kaishuu
計測	けいそく	keisoku
要件	ようけん	youkenn
衛星	えいせい	eisei
再建	さいけん|さいこん	saikenn|saikonn
境界	きょうかい|きょうがい|けいかい	kyoukai|kyougai|keikai
解明	かいめい	kaimei
比率	ひりつ	hiritsu
木造	もくぞう	mokuzou
兵士	へいし	heishi
技能	ぎのう	ginou
無限	むげん	mugenn
原告	げんこく	gennkoku
情勢	じょうせい	jousei
絶望	ぜつぼう	zetsubou
殺害	さつがい|せつがい	satsugai|setsugai
格差	かくさ	kakusa
学術	がくじゅつ	gakujutsu
接種	せっしゅ	sesshu
肥料	ひりょう	hiryou
暴走	ぼうそう	bousou
独り言	ひとりごと	hitorigoto
武士	ぶし|もののふ	bushi|mononofu
生態	せいたい	seitai
支出	ししゅつ	shishutsu
眼鏡	めがね|がんきょう	megane|gannkyou
年寄り	としより|どしより	toshiyori|doshiyori
基金	ききん	kikinn
答弁	とうべん	toubenn
予備	よび	yobi
証言	しょうげん	shougenn
混雑	こんざつ	konnzatsu
団地	だんち	dannchi
接客	せっきゃく	sekkyaku
提言	ていげん	teigenn
習得	しゅうとく	shuutoku
変態	へんたい	henntai
属する	ぞくする|しょくする	zokusuru|shokusuru
清潔	せいけつ	seiketsu
混合	こんごう	konngou
賞味	しょうみ	shoumi
迷い	まよい	mayoi
自演	じえん	jienn
個体	こたい	kotai
決断	けつだん	ketsudann
政令	せいれい	seirei
市営	しえい	shiei
不可欠	ふかけつ	fukaketsu
再会	さいかい	saikai
増やす	ふやす	fuyasu
夢中	むちゅう	muchuu
貸切	かしきり	kashikiri
出資	しゅっし	shusshi
適応	てきおう	tekiou
修復	しゅうふく	shuufuku
養護	ようご	yougo
常連	じょうれん	jourenn
演説	えんぜつ	ennzetsu
住居	じゅうきょ	juukyo
限度	げんど	genndo
水素	すいそ	suiso
復興	ふっこう	fukkou
気象	きしょう	kishou
高価	こうか|たか|だか	kouka|taka|daka
液体	えきたい	ekitai
学歴	がくれき	gakureki
典型	てんけい	tennkei
貯金	ちょきん	chokinn
感性	かんせい	kannsei
大賞	たいしょう	taishou
限る	かぎる	kagiru
球団	きゅうだん	kyuudann
眼科	がんか	gannka
共演	きょうえん	kyouenn
救い	すくい	sukui
夫妻	ふさい	fusai
破損	はそん	hasonn
不能	ふのう	funou
識別	しきべつ	shikibetsu
民営	みんえい	minnei
飼い主	かいぬし	kainushi
確かめ	たしかめ	tashikame
減る	へる	heru
移住	いじゅう	ijuu
車検	しゃけん	shakenn
苦情	くじょう	kujou
酒造	しゅぞう	shuzou
破産	はさん	hasann
喜ぶ	よろこぶ	yorokobu
工務	こうむ	koumu
告げ	つげ	tsuge
案件	あんけん	annkenn
演習	えんしゅう	ennshuu
復旧	ふっきゅう	fukkyuu
復元	ふくげん	fukugenn
効く	きく	kiku
仮面	かめん	kamenn
横断	おうだん	oudann
接近	せっきん	sekkinn
中断	ちゅうだん	chuudann
的確	てきかく|てっかく	tekikaku|tekkaku
校舎	こうしゃ	kousha
備考	びこう	bikou
課程	かてい	katei
易い	やすい|やしい	yasui|yashii
祖父	そふ|おおじ|じい|じじ	sofu|ooji|jii|jiji
要領	ようりょう	youryou
国境	こっきょう|くにざかい	kokkyou|kunizakai
演じる	えんじる	ennjiru
先祖	せんぞ	sennzo
月額	げつがく	getsugaku
上限	じょうげん	jougenn
資材	しざい	shizai
性別	せいべつ	seibetsu
経路	けいろ	keiro
保つ	たもつ|もつ	tamotsu|motsu
救う	すくう	sukuu
仮想	かそう	kasou
断熱	だんねつ	dannnetsu
標識	ひょうしき	hyoushiki
減らし	へらし	herashi
停車	ていしゃ	teisha
本編	ほんぺん	honnpenn
血圧	けつあつ	ketsuatsu
主導	しゅどう	shudou
絶賛	ぜっさん	zessann
常時	じょうじ	jouji
入賞	にゅうしょう	nyuushou
任務	にんむ	ninnmu
特価	とっか	tokka
接着	せっちゃく	secchaku
志望	しぼう	shibou
月刊	げっかん	gekkann
建造	けんぞう	kennzou
解答	かいとう	kaitou
同居	どうきょ	doukyo
応答	おうとう	outou
永久	えいきゅう|とわ	eikyuu|towa
祖母	そぼ|おば|ばば	sobo|oba|baba
完備	かんび	kannbi
守護	しゅご	shugo
全額	ぜんがく	zenngaku
主任	しゅにん	shuninn
適合	てきごう	tekigou
燃焼	ねんしょう	nennshou
営利	えいり	eiri
切断	せつだん	setsudann
検察	けんさつ	kennsatsu
消毒	しょうどく	shoudoku
実在	じつざい	jitsuzai
実証	じっしょう	jisshou
名義	めいぎ	meigi
減らす	へらす	herasu
良質	りょうしつ	ryoushitsu
解約	かいやく	kaiyaku
不在	ふざい	fuzai
増大	ぞうだい	zoudai
務める	つとめる	tsutomeru
技法	ぎほう	gihou
銀河	ぎんが	ginnga
経理	けいり	keiri
経歴	けいれき	keireki
無職	ぶしょく|むしょく	bushoku|mushoku
交際	こうさい	kousai
軍団	ぐんだん	gunndann
志向	しこう	shikou
採取	さいしゅ	saishu
快速	かいそく	kaisoku
断念	だんねん	dannnenn
半額	はんがく	hanngaku
比例	ひれい|ぴれい	hirei|pirei
混ん	こん|まじん	konn|majinn
風情	ふぜい	fuzei
必殺	ひっさつ	hissatsu
紀行	きこう	kikou
続編	ぞくへん	zokuhenn
適度	てきど	tekido
再発	さいはつ	saihatsu
飼い	かい|がい	kai|gai
賛同	さんどう	sanndou
辞任	じにん	jininn
招き	まねき	maneki
暗殺	あんさつ	annsatsu
歴代	れきだい	rekidai
上質	じょうしつ	joushitsu
水質	すいしつ	suishitsu
独身	どくしん	dokushinn
社団	しゃだん	shadann
規程	きてい	kitei
電圧	でんあつ	dennatsu
再編	さいへん	saihenn
団子	だんご	danngo
救助	きゅうじょ	kyuujo
鳥居	とりい	torii
戦術	せんじゅつ	sennjutsu
安価	あんか	annka
友情	ゆうじょう	yuujou
絶品	ぜっぴん	zeppinn
労務	ろうむ	roumu
中毒	ちゅうどく	chuudoku
余地	よち	yochi
根性	こんじょう	konnjou
複写	ふくしゃ	fukusha
接する	せっする	sessuru
日刊	にっかん	nikkann
燃費	ねんぴ	nennpi
準用	じゅんよう	junnyou
統制	とうせい	tousei
責め	せめ|ぜめ	seme|zeme
立ち寄り	たちより	tachiyori
動脈	どうみゃく	doumyaku
情けない	なさけない	nasakenai
所在	しょざい	shozai
間接	かんせつ	kannsetsu
特製	とくせい	tokusei
代謝	たいしゃ	taisha
絶景	ぜっけい	zekkei
基調	きちょう	kichou
防水	ぼうすい	bousui
木製	もくせい	mokusei
移民	いみん	iminn
構図	こうず	kouzu
採点	さいてん	saitenn
許す	ゆるす	yurusu
急性	きゅうせい	kyuusei
定額	ていがく|じょうがく	teigaku|jougaku
雑記	ざっき	zakki
運輸	うんゆ	unnyu
制約	せいやく	seiyaku
外資	がいし	gaishi
本堂	ほんどう	honndou
教職員	きょうしょくいん	kyoushokuinn
航海	こうかい	koukai
経つ	たつ	tatsu
保安	ほあん	hoann
公布	こうふ	koufu
弁護	べんご	benngo
短編	たんぺん	tannpenn
単価	たんか	tannka
有価	ゆうか	yuuka
留意	りゅうい	ryuui
炭素	たんそ	tannso
提起	ていき	teiki
低減	ていげん	teigenn
税制	ぜいせい	zeisei
油断	ゆだん	yudann
留め	とどめ|とめ|どめ	todome|tome|dome
前述	ぜんじゅつ	zennjutsu
解禁	かいきん	kaikinn
税務	ぜいむ	zeimu
述べる	のべる	noberu
悪質	あくしつ	akushitsu
漁師	りょうし	ryoushi
炭酸	たんさん	tannsann
先程	さきほど	sakihodo
酸味	さんみ|すみ	sannmi|sumi
公益	こうえき	koueki
統治	とうち|とうじ	touchi|touji
告発	こくはつ	kokuhatsu
先制	せんせい	sennsei
許容	きょよう	kyoyou
現に	げんに	gennni
体型	たいけい	taikei
残留	ざんりゅう	zannryuu
肥満	ひまん	himann
会費	かいひ	kaihi
燃える	もえる	moeru
招く	まねく	maneku
順序	じゅんじょ	junnjo
増す	ます	masu
安易	あんい	anni
新興	しんこう	shinnkou
絶好	ぜっこう	zekkou
急増	きゅうぞう	kyuuzou
同情	どうじょう	doujou
基板	きばん	kibann
改築	かいちく	kaichiku
造形	ぞうけい	zoukei
迷う	まよう	mayou
導く	みちびく	michibiku
雑草	ざっそう	zassou
任命	にんめい	ninnmei
本能	ほんのう	honnnou
引っ張り	ひっぱり	hippari
暴行	ぼうこう	boukou
領土	りょうど	ryoudo
上演	じょうえん	jouenn
効能	こうのう	kounou
増税	ぞうぜい	zouzei
仏像	ぶつぞう	butsuzou
設ける	もうける	moukeru
税率	ぜいりつ	zeiritsu
書評	しょひょう	shohyou
初版	しょはん	shohann
低迷	ていめい	teimei
快感	かいかん	kaikann
自在	じざい	jizai
可決	かけつ	kaketsu
和解	わかい	wakai
元祖	がんそ	gannso
物価	ぶっか	bukka
告げる	つげる	tsugeru
破れ	やぶれ|われ|やれ	yabure|ware|yare
自衛	じえい	jiei
居心地	いごこち	igokochi
貸し出し	かしだし	kashidashi
任期	にんき	ninnki
精進	しょうじん	shoujinn
製薬	せいやく	seiyaku
応える	こたえる	kotaeru
編み	あみ	ami
武力	ぶりょく	buryoku
材質	ざいしつ	zaishitsu
構い	かまい	kamai
犯行	はんこう	hannkou
因子	いんし	innshi
住職	じゅうしょく	juushoku
増進	ぞうしん	zoushinn
粉末	ふんまつ	funnmatsu
移設	いせつ	isetsu
構内	こうない	kounai
明示	めいじ	meiji
厚い	あつい|あちい	atsui|achii
倍率	ばいりつ	bairitsu
賞品	しょうひん	shouhinn
減額	げんがく	genngaku
素晴らし	すばらし	subarashi
快晴	かいせい	kaisei
張る	はる|ばる	haru|baru
判る	わかる	wakaru
護衛	ごえい	goei
効力	こうりょく	kouryoku
衛門	えもん|えもんの	emonn|emonnno
余談	よだん	yodann
接待	せったい	settai
音質	おんしつ	onnshitsu
実情	じつじょう	jitsujou
総研	そうけん	soukenn
人件	じんけん	jinnkenn
過失	かしつ	kashitsu
救出	きゅうしゅつ	kyuushutsu
特設	とくせつ	tokusetsu
定価	ていか	teika
移り	うつり	utsuri
発現	はつげん	hatsugenn
気の毒	きのどく	kinodoku
画質	がしつ	gashitsu
保留	ほりゅう	horyuu
断然	だんぜん	dannzenn
心得	こころえ|こころう	kokoroe|kokorou
率いる	ひきいる	hikiiru
築地	ついじ|つきじ	tsuiji|tsukiji
独り	ひとり	hitori
飼料	しりょう|かいりょう	shiryou|kairyou
前条	ぜんじょう	zennjou
解る	わかる	wakaru
理性	りせい	risei
解く	とく|ほどく	toku|hodoku
功績	こうせき	kouseki
性的	せいてき	seiteki
物資	ぶっし	busshi
可愛らしい	かわいらしい	kawairashii
証人	しょうにん	shouninn
心境	しんきょう	shinnkyou
賞金	しょうきん	shoukinn
史料	しりょう	shiryou
仮定	かてい	katei
原価	げんか	gennka
製法	せいほう	seihou
伝授	でんじゅ	dennju
均一	きんいつ	kinnitsu
測量	そくりょう	sokuryou
転移	てんい	tenni
河口	かこう|かわぐち	kakou|kawaguchi
素子	そし	soshi
気圧	きあつ	kiatsu
余分	よぶん	yobunn
在学	ざいがく	zaigaku
価額	かがく	kagaku
日報	にっぽう	nippou
河原	かわら|がわら	kawara|gawara
長編	ちょうへん	chouhenn
支社	ししゃ	shisha
織り	おり	ori
夢見	ゆめみ	yumemi
有志	ゆうし	yuushi
市政	しせい	shisei
色素	しきそ	shikiso
力士	りきし	rikishi
留守	るす	rusu
断面	だんめん	dannmenn
貸付	かしつけ	kashitsuke
提唱	ていしょう	teishou
在る	ある	aru
防ぎ	ふせぎ	fusegi
団長	だんちょう	dannchou
増強	ぞうきょう	zoukyou
質感	しつかん	shitsukann
事象	じしょう	jishou
判例	はんれい	hannrei
告示	こくじ	kokuji
興行	こうぎょう	kougyou
仮説	かせつ	kasetsu
過言	かげん|かごん	kagenn|kagonn
駅舎	えきしゃ	ekisha
鉱山	こうざん	kouzann
現物	げんぶつ	gennbutsu
断言	だんげん	danngenn
態勢	たいせい	taisei
編入	へんにゅう	hennnyuu
格別	かくべつ	kakubetsu
税額	ぜいがく	zeigaku
税法	ぜいほう	zeihou
心情	しんじょう	shinnjou
証書	しょうしょ	shousho
作製	さくせい	sakusei
委任	いにん	ininn
協賛	きょうさん	kyousann
法務	ほうむ	houmu
万能	ばんのう|まんのう	bannnou|mannnou
復習	ふくしゅう	fukushuu
健在	けんざい	kennzai
採集	さいしゅう	saishuu
選任	せんにん	sennninn
備える	そなえる	sonaeru
元素	げんそ	gennso
仮名	かな|かめい|がな|けみょう	kana|kamei|gana|kemyou
団結	だんけつ	dannketsu
増設	ぞうせつ	zousetsu
損益	そんえき	sonneki
無能	むのう	munou
貧しい	まずしい	mazushii
起因	きいん	kiinn
散布	さんぷ	sannpu
行程	こうてい	koutei
精力	せいりょく	seiryoku
判別	はんべつ	hannbetsu
均等	きんとう	kinntou
減量	げんりょう	gennryou
義理	ぎり	giri
知能	ちのう	chinou
後編	こうへん	kouhenn
雑魚	ざこ|じゃこ	zako|jako
前編	ぜんぺん	zennpenn
武道	ぶどう	budou
受容	じゅよう	juyou
航路	こうろ	kouro
観賞	かんしょう	kannshou
開講	かいこう	kaikou
点在	てんざい	tennzai
教団	きょうだん	kyoudann
精算	せいさん	seisann
墓石	はかいし|ぼせき	hakaishi|boseki
定評	ていひょう	teihyou
故意	こい	koi
念仏	ねんぶつ|ねぶつ	nennbutsu|nebutsu
正統	せいとう	seitou
倍増	ばいぞう	baizou
地質	ちしつ|じしつ	chishitsu|jishitsu
演歌	えんか	ennka
特技	とくぎ	tokugi
法規	ほうき	houki
悪夢	あくむ	akumu
総長	そうちょう	souchou
同志	どうし	doushi
鉱物	こうぶつ	koubutsu
在来	ざいらい	zairai
資質	ししつ	shishitsu
応対	おうたい	outai
営む	いとなむ	itonamu
相応	そうおう|ふさわし	souou|fusawashi
実演	じつえん	jitsuenn
無罪	むざい	muzai
軽快	けいかい	keikai
情景	じょうけい	joukei
宿舎	しゅくしゃ	shukusha
慣れる	なれる	nareru
公務	こうむ	koumu
高圧	こうあつ	kouatsu
質量	しつりょう	shitsuryou
快楽	かいらく|けらく	kairaku|keraku
入団	にゅうだん	nyuudann
破り	やぶり|わり	yaburi|wari
貸出	かしだし	kashidashi
国防	こくぼう	kokubou
素顔	すがお	sugao
率直	そっちょく	socchoku
義母	ぎぼ	gibo
造成	ぞうせい	zousei
知性	ちせい	chisei
不備	ふび	fubi
多額	たがく	tagaku
牧師	ぼくし	bokushi
法制	ほうせい	housei
人妻	ひとづま	hitoduma
因果	いんが	innga
有益	ゆうえき	yuueki
人質	ひとじち	hitojichi
囲ん	かこん|めぐん	kakonn|megunn
常任	じょうにん	jouninn
接点	せってん	settenn
混ぜる	まぜる	mazeru
効き	きき	kiki
役職	やくしょく	yakushoku
評議	ひょうぎ	hyougi
版画	はんが	hannga
昼過ぎ	ひるすぎ	hirusugi
毛布	もうふ	moufu
現職	げんしょく	gennshoku
安保	あんぽ	annpo
技師	ぎし	gishi
貸家	かしや	kashiya
大河	たいが	taiga
経年	けいねん	keinenn
移る	うつる	utsuru
対比	たいひ	taihi
編曲	へんきょく	hennkyoku
支所	ししょ	shisho
停電	ていでん	teidenn
保温	ほおん	hoonn
術後	じゅつご	jutsugo
時価	じか	jika
朝刊	ちょうかん	choukann
混入	こんにゅう	konnnyuu
公営	こうえい	kouei
接合	せつごう	setsugou
減税	げんぜい	gennzei
造る	つくる|づくる	tsukuru|dukuru
理容	りよう	riyou
格子	こうし|ごうし	koushi|goushi
支度	したく|じたく	shitaku|jitaku
解き	とき|ほどき	toki|hodoki
間際	まぎわ	magiwa
演算	えんざん	ennzann
相応しい	ふさわしい	fusawashii
過度	かど	kado
迷子	まいご	maigo
図解	ずかい	zukai
最寄り	もより	moyori
加護	かご	kago
過ごせる	すごせる	sugoseru
採り	とり|どり	tori|dori
挙句	あげく	ageku
故人	こじん	kojinn
常温	じょうおん	jouonn
差額	さがく	sagaku
総数	そうすう	sousuu
塩素	えんそ	ennso
導き	みちびき	michibiki
白河	はくが	hakuga
重厚	じゅうこう	juukou
夕刊	ゆうかん	yuukann
参政	さんせい	sannsei
救命	きゅうめい	kyuumei
在り	あり	ari
絶大	ぜつだい	zetsudai
武家	ぶけ	buke
運勢	うんせい	unnsei
半減	はんげん	hanngenn
幹線	かんせん	kannsenn
配備	はいび	haibi
祖国	そこく	sokoku
公示	こうじ	kouji
調停	ちょうてい	choutei
伝導	でんどう	denndou
移す	うつす	utsusu
応急	おうきゅう	oukyuu
都営	とえい	toei
山脈	さんみゃく	sannmyaku
国政	こくせい	kokusei
防火	ぼうか	bouka
静脈	じょうみゃく	joumyaku
貧血	ひんけつ	hinnketsu
反則	はんそく	hannsoku
体勢	たいせい	taisei
備品	びひん	bihinn
採算	さいさん	saisann
格付け	かくづけ	kakuduke
公団	こうだん	koudann
織物	おりもの	orimono
原型	げんけい	gennkei
提灯	ちょうちん|ぢょうちん	chouchinn|dyouchinn
体格	たいかく	taikaku
人情	にんじょう	ninnjou
精製	せいせい	seisei
外務	がいむ	gaimu
可動	かどう	kadou
公判	こうはん	kouhann
乗務	じょうむ	joumu
採決	さいけつ	saiketsu
一報	いっぽう	ippou
政界	せいかい	seikai
新婦	しんぷ	shinnpu
雑学	ざつがく	zatsugaku
楽団	がくだん	gakudann
任せる	まかせる	makaseru
受領	じゅりょう|ずりょう	juryou|zuryou
実技	じつぎ	jitsugi
時効	じこう	jikou
失格	しっかく	shikkaku
出費	しゅっぴ	shuppi
寄り道	よりみち	yorimichi
大師	だいし	daishi
基点	きてん	kitenn
読解	どっかい	dokkai
悪性	あくせい|あくしょう	akusei|akushou
史実	しじつ	shijitsu
通告	つうこく	tsuukoku
断定	だんてい	danntei
運河	うんが	unnga
地検	ちけん	chikenn
基幹	きかん	kikann
断る	ことわる	kotowaru
確かめる	たしかめる	tashikameru
個数	こすう	kosuu
防具	ぼうぐ	bougu
酸性	さんせい	sannsei
冷え性	ひえしょう	hieshou
墓参り	はかまいり	hakamairi
有罪	ゆうざい	yuuzai
精子	せいし	seishi
貸借	たいしゃく	taishaku
配属	はいぞく	haizoku
運航	うんこう	unnkou
現われ	あらわれ	araware
国営	こくえい	kokuei
眼差し	まなざし	manazashi
志願	しがん	shigann
減速	げんそく	gennsoku
暴言	ぼうげん	bougenn
築く	きずく|つく|づく	kizuku|tsuku|duku
毒性	どくせい	dokusei
検事	けんじ	kennji
辞職	じしょく	jishoku
囲む	かこむ	kakomu
圧勝	あっしょう	asshou
迷宮	めいきゅう	meikyuu
公告	こうこく	koukoku
会報	かいほう	kaihou
武術	ぶじゅつ	bujutsu
駅弁	えきべん	ekibenn
造船	ぞうせん	zousenn
寄せる	よせる	yoseru
労災	ろうさい	rousai
経常	けいじょう	keijou
気質	かたぎ|きしつ	katagi|kishitsu
総勢	そうぜい	souzei
大仏	だいぶつ	daibutsu
演目	えんもく	ennmoku
中略	ちゅうりゃく	chuuryaku
師事	しじ	shiji
寄る	よる	yoru
極限	きょくげん	kyokugenn
求職	きゅうしょく	kyuushoku
寄生	きせい	kisei
損保	そんぽ	sonnpo
適性	てきせい	tekisei
肥大	ひだい	hidai
増額	ぞうがく	zougaku
独断	どくだん	dokudann
地価	ちか	chika
検知	けんち	kennchi
前衛	ぜんえい	zennei
混同	こんどう	konndou
県境	けんきょう|けんざかい	kennkyou|kennzakai
中性	ちゅうせい	chuusei
絶版	ぜっぱん	zeppann
常務	じょうむ	joumu
転居	てんきょ	tennkyo
人脈	じんみゃく	jinnmyaku
祖先	そせん	sosenn
血統	けっとう	kettou
構える	かまえる	kamaeru
飼う	かう|こう	kau|kou
過ち	あやまち	ayamachi
解読	かいどく	kaidoku
永住	えいじゅう	eijuu
条文	じょうぶん	joubunn
混在	こんざい	konnzai
直営	ちょくえい	chokuei
修士	しゅうし	shuushi
断り	ことわり	kotowari
学費	がくひ	gakuhi
責務	せきむ	sekimu
似合い	にあい	niai
眼下	がんか	gannka
欠損	けっそん	kessonn
謝る	あやまる	ayamaru
適量	てきりょう	tekiryou
報復	ほうふく	houfuku
絵師	えし	eshi
新居	しんきょ	shinnkyo
包囲	ほうい	houi
変容	へんよう	hennyou
信条	しんじょう	shinnjou
暗示	あんじ	annji
暴落	ぼうらく	bouraku
文脈	ぶんみゃく	bunnmyaku
自費	じひ	jihi
居間	いま	ima
資する	しする	shisuru
武者	むしゃ	musha
師団	しだん	shidann
往来	おうらい	ourai
応力	おうりょく	ouryoku
氷河	ひょうが	hyouga
暴動	ぼうどう	boudou
中型	ちゅうがた	chuugata
境地	きょうち	kyouchi
引き寄せ	ひきよせ	hikiyose
常設	じょうせつ	jousetsu
混じり	まじり	majiri
得する	とくする	tokusuru
設営	せつえい	setsuei
心構え	こころがまえ	kokorogamae
開演	かいえん	kaienn
関税	かんぜい	kannzei
枝豆	えだまめ	edamame
保養	ほよう	hoyou
実費	じっぴ	jippi
耕作	こうさく	kousaku
陽性	ようせい	yousei
営み	いとなみ	itonami
戦犯	せんぱん	sennpann
実効	じっこう	jikkou
発刊	はっかん	hakkann
修業	しゅぎょう|しゅうぎょう	shugyou|shuugyou
反復	はんぷく	hannpuku
常用	じょうよう	jouyou
フッ素	ふっそ	fusso
電解	でんかい	dennkai
対価	たいか	taika
貯まる	たまる	tamaru
義父	ぎふ	gifu
破る	やぶる|わる	yaburu|waru
精米	せいまい	seimai
近接	きんせつ	kinnsetsu
教祖	きょうそ	kyouso
河童	かっぱ	kappa
仮設	かせつ	kasetsu
件名	けんめい	kennmei
賞賛	しょうさん	shousann
病状	びょうじょう	byoujou
準ずる	じゅんずる	junnzuru
国益	こくえき	kokueki
指圧	しあつ	shiatsu
増減	ぞうげん	zougenn
罪悪	ざいあく	zaiaku
造園	ぞうえん	zouenn
画素	がそ	gaso
移管	いかん	ikann
立証	りっしょう	risshou
角質	かくしつ	kakushitsu
応じる	おうじる	oujiru
薬師	くすし|やくし	kusushi|yakushi
取寄せ	とりよせ	toriyose
業態	ぎょうたい	gyoutai
上告	じょうこく	joukoku
移入	いにゅう	inyuu
共益	きょうえき	kyoueki
制圧	せいあつ	seiatsu
支流	しりゅう	shiryuu
修得	しゅうとく	shuutoku
解任	かいにん	kaininn
分断	ぶんだん	bunndann
総体	そうたい	soutai
品格	ひんかく	hinnkaku
県政	けんせい	kennsei
適格	てきかく|てっかく	tekikaku|tekkaku
招集	しょうしゅう	shoushuu
交易	こうえき	koueki
容積	ようせき	youseki
航行	こうこう	koukou
有能	ゆうのう	yuunou
国保	こくほ	kokuho
寄席	よせ	yose
気絶	きぜつ	kizetsu
愛護	あいご	aigo
支柱	しちゅう	shichuu
受益	じゅえき	jueki
政務	せいむ	seimu
木綿	もめん|きわた|もくめん	momenn|kiwata|mokumenn
総統	そうとう	soutou
月経	げっけい	gekkei
語句	ごく	goku
現像	げんぞう	gennzou
病態	びょうたい	byoutai
法師	ほうし|ほし|ぼうし|ぼし	houshi|hoshi|boushi|boshi
防音	ぼうおん	bouonn
支局	しきょく	shikyoku
効用	こうよう	kouyou
分厚い	ぶあつい|ぶあちい	buatsui|buachii
在留	ざいりゅう	zairyuu
減価	げんか	gennka
領主	りょうしゅ	ryoushu
後任	こうにん	kouninn
平常	へいじょう	heijou
比重	ひじゅう	hijuu
在職	ざいしょく	zaishoku
死因	しいん	shiinn
精液	せいえき	seieki
増築	ぞうちく	zouchiku
慣習	かんしゅう	kannshuu
花弁	かべん|はなびら	kabenn|hanabira
官能	かんのう	kannnou
精通	せいつう	seitsuu
旅費	りょひ	ryohi
防寒	ぼうかん	boukann
良識	りょうしき	ryoushiki
余程	よほど	yohodo
女史	じょし	joshi
精油	せいゆ	seiyu
競演	きょうえん	kyouenn
測る	はかる	hakaru
変質	へんしつ	hennshitsu
神仏	しんぶつ|かみほとけ	shinnbutsu|kamihotoke
電報	でんぽう	dennpou
過大	かだい	kadai
ろ過	ろか	roka
炭鉱	たんこう	tannkou
現世	げんせ|げんせい	gennse|gennsei
築城	ちくじょう	chikujou
夢見る	ゆめみる	yumemiru
殺虫	さっちゅう	sacchuu
先導	せんどう	senndou
根幹	こんかん	konnkann
後述	こうじゅつ	koujutsu
格言	かくげん	kakugenn
祖父母	そふぼ	sofubo
古河	ふるかわ	furukawa
勝率	しょうりつ	shouritsu
雑感	ざっかん	zakkann
過労	かろう	karou
合弁	ごうべん	goubenn
教義	きょうぎ	kyougi
製本	せいほん	seihonn
増資	ぞうし	zoushi
布教	ふきょう	fukyou
禁断	きんだん	kinndann
断固	だんこ	dannko
本性	ほんしょう|ほんせい	honnshou|honnsei
不可解	ふかかい	fukakai
近衛	このえ|こんえ	konoe|konne
賛美	さんび	sannbi
下限	かげん	kagenn
税関	ぜいかん	zeikann
復刊	ふっかん	fukkann
留置	りゅうち|とめおき	ryuuchi|tomeoki
責める	せめる	semeru
貸す	かす|がす	kasu|gasu
銅像	どうぞう	douzou
講堂	こうどう	koudou
送検	そうけん	soukenn
常備	じょうび	joubi
迷路	めいろ	meiro
防護	ぼうご	bougo
災い	わざわい	wazawai
談義	だんぎ	danngi
財界	ざいかい	zaikai
団員	だんいん	danninn
明快	めいかい	meikai
風格	ふうかく	fuukaku
金賞	きんしょう	kinnshou
貸金	かしきん	kashikinn
迷走	めいそう	meisou
雑音	ざつおん	zatsuonn
節句	せっく|ぜっく	sekku|zekku
桜木	さくらぎ	sakuragi
初演	しょえん	shoenn
独学	どくがく	dokugaku
反逆	はんぎゃく	hanngyaku
殺意	さつい	satsui
製鉄	せいてつ	seitetsu
総じて	そうじて	soujite
眼前	がんぜん	gannzenn
演題	えんだい	enndai
全編	ぜんぺん	zennpenn
往生	おうじょう	oujou
新旧	しんきゅう	shinnkyuu
一眼	ひとめ	hitome
農政	のうせい	nousei
相殺	そうさい|そうさつ	sousai|sousatsu
素手	すで	sude
農耕	のうこう	noukou
国税	こくぜい	kokuzei
士官	しかん	shikann
移送	いそう	isou
険しい	けわしい	kewashii
断絶	だんぜつ	dannzetsu
快挙	かいきょ	kaikyo
新報	しんぽう	shinnpou
囲い	かこい|がこい	kakoi|gakoi
版元	はんもと	hannmoto
上述	じょうじゅつ	joujutsu
桜花	おうか|さくらばな	ouka|sakurabana
動態	どうたい	doutai
検挙	けんきょ	kennkyo
布告	ふこく	fukoku
仏具	ぶつぐ	butsugu
調製	ちょうせい	chousei
快勝	かいしょう	kaishou
居室	きょしつ	kyoshitsu
職歴	しょくれき	shokureki
類型	るいけい	ruikei
打破	だは	daha
国務	こくむ	kokumu
見張り	みはり	mihari
修道	しゅうどう	shuudou
素質	そしつ	soshitsu
旧道	きゅうどう	kyuudou
個所	かしょ	kasho
貯める	ためる	tameru
断食	だんじき	dannjiki
新版	しんばん|しんぱん	shinnbann|shinnpann
横領	おうりょう	ouryou
鉱石	こうせき	kouseki
一因	いちいん	ichiinn
能率	のうりつ	nouritsu
得票	とくひょう	tokuhyou
犯す	おかす	okasu
貧弱	ひんじゃく	hinnjaku
図版	ずはん	zuhann
具現	ぐげん	gugenn
利率	りりつ	riritsu
出航	しゅっこう	shukkou
物性	ぶっせい	bussei
増量	ぞうりょう	zouryou
受精	じゅせい	jusei
率先	そっせん	sossenn
仏法	ぶっぽう	buppou
手応え	てごたえ	tegotae
性器	せいき	seiki
歴任	れきにん	rekininn
役務	えきむ	ekimu
義歯	ぎし	gishi
石仏	せきぶつ|いしぼとけ	sekibutsu|ishibotoke
領地	りょうち	ryouchi
情け	なさけ	nasake
士気	しき	shiki
行き過ぎ	いきすぎ|ゆきすぎ	ikisugi|yukisugi
技量	ぎりょう	giryou
手造り	てづくり	tedukuri
内政	ないせい	naisei
暴れる	あばれる	abareru
食費	しょくひ	shokuhi
天災	てんさい	tennsai
教示	きょうじ|きょうし	kyouji|kyoushi
総て	すべて	subete
成仏	じょうぶつ	joubutsu
長居	ながい	nagai
手技	しゅぎ	shugi
羽織	はおり|ばおり	haori|baori
定型	ていけい	teikei
絶句	ぜっく	zekku
健常	けんじょう	kennjou
輸血	ゆけつ	yuketsu
増水	ぞうすい	zousui
師走	しわす	shiwasu
防備	ぼうび	boubi
講じる	こうじる	koujiru
成型	せいけい	seikei
素早い	すばやい	subayai
眼球	がんきゅう	gannkyuu
永続	えいぞく	eizoku
禁物	きんもつ	kinnmotsu
県営	けんえい	kennei
差し支え	さしつかえ	sashitsukae
買得	かいどく	kaidoku
豊作	ほうさく	housaku
接戦	せっせん	sessenn
同性	どうせい	dousei
判事	はんじ	hannji
適時	てきじ	tekiji
非行	ひこう	hikou
再興	さいこう	saikou
中絶	ちゅうぜつ	chuuzetsu
許せる	ゆるせる	yuruseru
一堂	いちどう	ichidou
快調	かいちょう	kaichou
確変	かくへん	kakuhenn
油圧	ゆあつ	yuatsu
手際	てぎわ	tegiwa
護岸	ごがん	gogann
報知	ほうち	houchi
内職	ないしょく	naishoku
可変	かへん	kahenn
音程	おんてい	onntei
張り紙	はりがみ	harigami
書留	かきとめ	kakitome
燃やす	もやす	moyasu
設問	せつもん	setsumonn
貸し切り	かしきり	kashikiri
水性	すいせい|みずしょう	suisei|mizushou
大判	おおばん	oobann
逆さ	さかさ	sakasa
謝礼	しゃれい	sharei
等価	とうか	touka
移り変わり	うつりかわり	utsurikawari
打率	だりつ	daritsu
混む	こむ	komu
毒素	どくそ	dokuso
公職	こうしょく	koushoku
経典	きょうてん|けいてん	kyoutenn|keitenn
余る	あまる	amaru
型紙	かたがみ	katagami
変性	へんせい	hennsei
真性	しんせい	shinnsei
測り	はかり	hakari
解ける	とける|ほどける	tokeru|hodokeru
境目	さかいめ	sakaime
ご利益	ごりやく	goriyaku
管制	かんせい	kannsei
修験	しゅげん	shugenn
休職	きゅうしょく	kyuushoku
型式	かたしき|けいしき	katashiki|keishiki
人殺し	ひとごろし	hitogoroshi
永年	えいねん|ながねん	einenn|naganenn
塩基	えんき	ennki
石綿	いしわた|せきめん	ishiwata|sekimenn
別格	べっかく	bekkaku
授賞	じゅしょう	jushou
質屋	しちや	shichiya
増員	ぞういん	zouinn
程よい	ほどよい	hodoyoi
勢ぞろい	せいぞろい	seizoroi
混浴	こんよく	konnyoku
習性	しゅうせい	shuusei
採血	さいけつ	saiketsu
別居	べっきょ	bekkyo
政局	せいきょく	seikyoku
軍師	ぐんし	gunnshi
用件	ようけん	youkenn
留保	りゅうほ	ryuuho
墓所	はかしょ|はかどころ|ぼしょ|むしょ	hakasho|hakadokoro|bosho|musho
増刊	ぞうかん	zoukann
再三	さいさん	saisann
適法	てきほう	tekihou
備長	びんちょう	binnchou
辺境	へんきょう	hennkyou
史観	しかん	shikann
報い	むくい	mukui
逆行	ぎゃっこう	gyakkou
演芸	えんげい	enngei
損なう	そこなう	sokonau
移築	いちく	ichiku
効き目	ききめ	kikime
形容	けいよう	keiyou
必修	ひっしゅう	hisshuu
行財政	ぎょうざいせい	gyouzaisei
採る	とる|どる	toru|doru
生保	せいほ	seiho
囲み	かこみ	kakomi
夢想	むそう	musou
流布	るふ	rufu
特質	とくしつ	tokushitsu
講ずる	こうずる	kouzuru
現す	あらわす	arawasu
余命	よめい	yomei
時限	じげん	jigenn
肉眼	にくがん	nikugann
往路	おうろ	ouro
興業	こうぎょう	kougyou
経口	けいこう	keikou
程遠い	ほどとおい	hodotooi
故事	こじ	koji
去勢	きょせい	kyosei
営農	えいのう	einou
年額	ねんがく	nenngaku
質素	しっそ	shisso
代弁	だいべん	daibenn
再考	さいこう	saikou
精査	せいさ	seisa
節税	せつぜい	setsuzei
軍勢	ぐんぜい	gunnzei
句集	くしゅう	kushuu
見識	けんしき	kennshiki
遊技	ゆうぎ	yuugi
暗証	あんしょう	annshou
評定	ひょうじょう|ひょうてい	hyoujou|hyoutei
照準	しょうじゅん	shoujunn
安保理	あんぽり	annpori
公費	こうひ	kouhi
構文	こうぶん	koubunn
体現	たいげん	taigenn
往年	おうねん	ounenn
留まる	とどまる|とまる	todomaru|tomaru
夜桜	よざくら	yozakura
喜ばしい	よろこばしい	yorokobashii
見応え	みごたえ	migotae
一条	いちじょう	ichijou
墓場	はかば	hakaba
講話	こうわ	kouwa
一過	いっか	ikka
罪人	ざいにん|つみびと	zaininn|tsumibito
永代	えいたい	eitai
備え付け	そなえつけ	sonaetsuke
逆流	ぎゃくりゅう	gyakuryuu
根絶	こんぜつ	konnzetsu
母性	ぼせい	bosei
教職	きょうしょく	kyoushoku
志士	しし	shishi
告別	こくべつ	kokubetsu
造営	ぞうえい	zouei
少額	しょうがく	shougaku
不評	ふひょう	fuhyou
急務	きゅうむ	kyuumu
能楽	のうがく	nougaku
国技	こくぎ	kokugi
学資	がくし	gakushi
市制	しせい	shisei
同額	どうがく	dougaku
弁明	べんめい	bennmei
非道	ひどう|ひど	hidou|hido
居城	きょじょう	kyojou
酒造り	さけづくり	sakedukuri
増産	ぞうさん	zousann
型番	かたばん	katabann
序章	じょしょう	joshou
慣らし	ならし	narashi
帰り際	かえりぎわ	kaerigiwa
総連	そうれん	sourenn
破局	はきょく	hakyoku
在外	ざいがい	zaigai
厚手	あつで	atsude
液状	えきじょう	ekijou
面識	めんしき	mennshiki
破格	はかく	hakaku
暴風	ぼうふう	boufuu
旧約	きゅうやく	kyuuyaku
家政	かせい	kasei
示談	じだん	jidann
久遠	くおん	kuonn
一句	いっく	ikku
雪解け	ゆきどけ	yukidoke
過多	かた	kata
非情	ひじょう	hijou
慣行	かんこう	kannkou
雑用	ざつよう|ぞうよう	zatsuyou|zouyou
子規	しき|ほととぎす	shiki|hototogisu
余白	よはく	yohaku
本職	ほんしょく	honnshoku
鉱業	こうぎょう	kougyou
熱演	ねつえん	netsuenn
近似	きんじ	kinnji
妻子	さいし|つまこ	saishi|tsumako
留年	りゅうねん	ryuunenn
本領	ほんりょう	honnryou
講和	こうわ	kouwa
続報	ぞくほう	zokuhou
旅情	りょじょう	ryojou
過熱	かねつ	kanetsu
可燃	かねん	kanenn
再来	さいらい|さらい	sairai|sarai
寄港	きこう	kikou
失態	しったい	shittai
増益	ぞうえき	zoueki
職安	しょくあん	shokuann
変則	へんそく	hennsoku
久しい	ひさしい	hisashii
賛助	さんじょ	sannjo
減点	げんてん	genntenn
鉄則	てっそく	tessoku
余力	よりょく	yoryoku
軍備	ぐんび	gunnbi
導師	どうし	doushi
正史	せいし	seishi
総武	そうぶ	soubu
再起	さいき	saiki
確約	かくやく	kakuyaku
接地	せっち	secchi
木質	もくしつ	mokushitsu
輸出入	ゆしゅつにゅう	yushutsunyuu
土居	つちい|どい	tsuchii|doi
確証	かくしょう	kakushou
素性	すじょう|そせい	sujou|sosei
復路	ふくろ	fukuro
格付	かくづけ	kakuduke
防虫	ぼうちゅう	bouchuu
製材	せいざい	seizai
広義	こうぎ	kougi
首領	しゅりょう	shuryou
救護	きゅうご	kyuugo
民団	みんだん	minndann
素通り	すどおり	sudoori
公設	こうせつ	kousetsu
寄進	きしん	kishinn
任用	にんよう	ninnyou
領有	りょうゆう	ryouyuu
好適	こうてき	kouteki
貯水	ちょすい	chosui
製図	せいず	seizu
改編	かいへん	kaihenn
体液	たいえき	taieki
武勇	ぶゆう	buyuu
手製	てせい	tesei
定規	じょうぎ	jougi
球技	きゅうぎ	kyuugi
形質	けいしつ	keishitsu
町営	ちょうえい	chouei
船団	せんだん	senndann
整復	せいふく	seifuku
旅団	りょだん	ryodann
防げる	ふせげる	fusegeru
保冷	ほれい	horei
検体	けんたい	kenntai
内在	ないざい	naizai
可笑しい	おかしい	okashii
検品	けんぴん	kennpinn
複線	ふくせん	fukusenn
損する	そんする	sonnsuru
戦績	せんせき	sennseki
引率	いんそつ	innsotsu
平素	へいそ	heiso
読破	どくは	dokuha
総代	そうだい	soudai
迷信	めいしん	meishinn
態様	たいよう	taiyou
横暴	おうぼう	oubou
布地	きれじ|ぬのじ	kireji|nunoji
敗因	はいいん	haiinn
共犯	きょうはん	kyouhann
青銅	せいどう	seidou
実測	じっそく	jissoku
技工	ぎこう	gikou
殺そ	ころそ|さっそ	koroso|sasso
禁書	きんしょ	kinnsho
断続	だんぞく	dannzoku
雑種	ざっしゅ	zasshu
弁理	べんり	bennri
護る	まもる	mamoru
石像	せきぞう	sekizou
河岸	かがん|かし|かわぎし|がし	kagann|kashi|kawagishi|gashi
神職	しんしょく	shinnshoku
修練	しゅうれん	shuurenn
挙げ句	あげく	ageku
旧型	きゅうがた	kyuugata
講談	こうだん	koudann
逆光	ぎゃっこう	gyakkou
逆らう	さからう	sakarau
逆境	ぎゃっきょう	gyakkyou
統率	とうそつ	tousotsu
造作	ぞうさ|ぞうさく	zousa|zousaku
開祖	かいそ	kaiso
学識	がくしき	gakushiki
荷造り	にづくり	nidukuri
護身	ごしん	goshinn
旧来	きゅうらい	kyuurai
かき混ぜ	かきまぜ	kakimaze
着任	ちゃくにん	chakuninn
序曲	じょきょく	jokyoku
総量	そうりょう	souryou
余興	よきょう	yokyou
制止	せいし	seishi
水圧	すいあつ	suiatsu
損金	そんきん	sonnkinn
燃油	ねんゆ	nennyu
旧制	きゅうせい	kyuusei
採れる	とれる	toreru
格式	かくしき|きゃくしき	kakushiki|kyakushiki
主眼	しゅがん	shugann
殺生	せっしょう	sesshou
暴れん	あばれん	abarenn
混迷	こんめい	konnmei
不慣れ	ふなれ	funare
留める	とどめる|とめる	todomeru|tomeru
小判	こばん	kobann
能動	のうどう	noudou
定率	ていりつ	teiritsu
気性	きしょう	kishou
略歴	りゃくれき	ryakureki
賞状	しょうじょう	shoujou
志す	こころざす	kokorozasu
山桜	やまざくら	yamazakura
無常	むじょう	mujou
制する	せいする	seisuru
全容	ぜんよう	zennyou
同義	どうぎ	dougi
解毒	げどく	gedoku
道程	どうてい|みちのり	doutei|michinori
査察	ささつ	sasatsu
主務	しゅむ	shumu
居候	いそうろう	isourou
政経	せいけい	seikei
薬効	やっこう	yakkou
初任	しょにん	shoninn
造語	ぞうご	zougo
有毒	ゆうどく	yuudoku
学士	がくし	gakushi
失効	しっこう	shikkou
持久	じきゅう	jikyuu
紀要	きよう	kiyou
息災	そくさい	sokusai
休刊	きゅうかん	kyuukann
素足	すあし	suashi
老師	ろうし	roushi
余す	あます	amasu
肉質	にくしつ	nikushitsu
殺気	さっき	sakki
格調	かくちょう	kakuchou
破たん	はたん	hatann
証し	しょうし|あかし	shoushi|akashi
表象	ひょうしょう	hyoushou
雑多	ざった	zatta
得体	えたい	etai
失禁	しっきん	shikkinn
管財	かんざい	kannzai
例示	れいじ	reiji
講評	こうひょう	kouhyou
張り出し	はりだし	haridashi
法政	ほうせい	housei
公報	こうほう	kouhou
仏事	ぶつじ	butsuji
時報	じほう	jihou
税別	ぜいべつ	zeibetsu
実像	じつぞう	jitsuzou
慣用	かんよう	kannyou
混血	こんけつ	konnketsu
飼養	しよう	shiyou
比べ物	くらべもの	kurabemono
義兄	ぎけい	gikei
混じる	こんじる|まじる	konnjiru|majiru
居合	いあい	iai
評点	ひょうてん	hyoutenn
毒物	どくぶつ	dokubutsu
総力	そうりょく	souryoku
品性	ひんせい	hinnsei
序列	じょれつ	joretsu
主幹	しゅかん	shukann
義姉	ぎし	gishi
逆手	ぎゃくて|さかて	gyakute|sakate
費やす	ついやす	tsuiyasu
開眼	かいがん|かいげん	kaigann|kaigenn
解法	かいほう	kaihou
保身	ほしん	hoshinn
不可思議	ふかしぎ	fukashigi
苦境	くきょう	kukyou
季刊	きかん	kikann
素案	そあん	soann
寄り付き	よりつき	yoritsuki
不潔	ふけつ|やばち	fuketsu|yabachi
暴挙	ぼうきょ	boukyo
築造	ちくぞう	chikuzou
支線	しせん	shisenn
真価	しんか	shinnka
終演	しゅうえん	shuuenn
健保	けんぽ	kennpo
平易	へいい	heii
武具	ぶぐ	bugu
混戦	こんせん	konnsenn
製紙	せいし	seishi
絶する	ぜっする	zessuru
過食	かしょく	kashoku
往時	おうじ	ouji
塩酸	えんさん	ennsann
順応	じゅんのう|じゅんおう	junnnou|junnou
再選	さいせん	saisenn
前略	ぜんりゃく	zennryaku
現われる	あらわれる	arawareru
立像	りつぞう	ritsuzou
前任	ぜんにん	zennninn
名寄	なよせ	nayose
停戦	ていせん	teisenn
再燃	さいねん	sainenn
官報	かんぽう	kannpou
新任	しんにん	shinnninn
温厚	おんこう	onnkou
額面	がくめん	gakumenn
弁解	べんかい	bennkai
発効	はっこう	hakkou
書状	しょじょう	shojou
制動	せいどう	seidou
常緑	じょうりょく	jouryoku
飼い犬	かいいぬ	kaiinu
一団	いちだん	ichidann
紀元	きげん	kigenn
絶え間	たえま	taema
鉄製	てっせい|てつせい	tessei|tetsusei
規正	きせい	kisei
似非	えせ	ese
布石	ふせき	fuseki
証する	しょうする	shousuru
読み応え	よみごたえ	yomigotae
師弟	してい	shitei
金堂	こんどう	konndou
製粉	せいふん	seifunn
独走	どくそう	dokusou
総社	そうじゃ	souja
編み物	あみもの	amimono
買い得	かいどく	kaidoku
自賛	じさん	jisann
基底	きてい	kitei
きな粉	きなこ	kinako
人造	じんぞう	jinnzou
野性	やせい	yasei
政調	せいちょう	seichou
後衛	こうえい	kouei
写経	しゃきょう	shakyou
再読	さいどく	saidoku
木版	もくはん	mokuhann
貯留	ちょりゅう	choryuu
救える	すくえる	sukueru
教務	きょうむ	kyoumu
節減	せつげん	setsugenn
快気	かいき	kaiki
原状	げんじょう	gennjou
属国	ぞっこく	zokkoku
考証	こうしょう	koushou
利得	りとく	ritoku
減圧	げんあつ	gennatsu
識者	しきしゃ	shikisha
読経	どきょう|どっきょう	dokyou|dokkyou
可能性	かのうせい	kanousei
事務所	じむしょ	jimusho
基本的	きほんてき	kihonnteki
個人的	こじんてき	kojinnteki
美術館	びじゅつかん	bijutsukann
弁護士	べんごし	benngoshi
保育園	ほいくえん	hoikuenn
消費者	しょうひしゃ	shouhisha
本格的	ほんかくてき	honnkakuteki
事務局	じむきょく	jimukyoku
報告書	ほうこくしょ	houkokusho
公務員	こうむいん	koumuinn
活性化	かっせいか	kasseika
政治家	せいじか	seijika
保護者	ほごしゃ	hogosha
不可能	ふかのう	fukanou
経営者	けいえいしゃ	keieisha
効果的	こうかてき	koukateki
消費税	しょうひぜい	shouhizei
文化財	ぶんかざい	bunnkazai
講演会	こうえんかい	kouennkai
精神的	せいしんてき	seishinnteki
芸能人	げいのうじん	geinoujinn
経験者	けいけんしゃ	keikennsha
美容室	びようしつ	biyoushitsu
営業日	えいぎょうび	eigyoubi
税理士	ぜいりし	zeirishi
歴史的	れきしてき	rekishiteki
証明書	しょうめいしょ	shoumeisho
保険料	ほけんりょう	hokennryou
未経験	みけいけん	mikeikenn
所在地	しょざいち	shozaichi
技術者	ぎじゅつしゃ	gijutsusha
投資家	とうしか	toushika
総合的	そうごうてき	sougouteki
必要性	ひつようせい	hitsuyousei
安全性	あんぜんせい	annzennsei
指導者	しどうしゃ	shidousha
営業所	えいぎょうしょ	eigyousho
印象的	いんしょうてき	innshouteki
責任者	せきにんしゃ	sekininnsha
編集部	へんしゅうぶ	hennshuubu
政治的	せいじてき	seijiteki
不適切	ふてきせつ	futekisetsu
可愛	かわい	kawai
伝統的	でんとうてき	denntouteki
出演者	しゅつえんしゃ	shutsuennsha
美容院	びよういん	biyouinn
製造業	せいぞうぎょう	seizougyou
講習会	こうしゅうかい	koushuukai
国際的	こくさいてき	kokusaiteki
効率的	こうりつてき	kouritsuteki
重要性	じゅうようせい	juuyousei
建築物	けんちくぶつ	kennchikubutsu
方向性	ほうこうせい	houkousei
工務店	こうむてん	koumutenn
最大限	さいだいげん	saidaigenn
現時点	げんじてん	gennjitenn
民営化	みんえいか	minneika
正確性	せいかくせい	seikakusei
現実的	げんじつてき	gennjitsuteki
産婦人科	さんふじんか	sannfujinnka
技術的	ぎじゅつてき	gijutsuteki
保育所	ほいくしょ	hoikusho
留学生	りゅうがくせい	ryuugakusei
半導体	はんどうたい	hanndoutai
幹事長	かんじちょう	kannjichou
資料館	しりょうかん	shiryoukann
年賀状	ねんがじょう	nenngajou
無意識	むいしき	muishiki
決定版	けっていばん	ketteibann
建築家	けんちくか	kennchikuka
航空機	こうくうき	koukuuki
最低限	さいていげん	saiteigenn
自家製	じかせい	jikasei
非公開	ひこうかい	hikoukai
犯罪者	はんざいしゃ	hannzaisha
精神科	せいしんか	seishinnka
高品質	こうひんしつ	kouhinnshitsu
予備校	よびこう	yobikou
研修会	けんしゅうかい	kennshuukai
新製品	しんせいひん	shinnseihinn
交通費	こうつうひ	koutsuuhi
個性的	こせいてき	koseiteki
対象外	たいしょうがい	taishougai
主義者	しゅぎしゃ	shugisha
業務用	ぎょうむよう	gyoumuyou
最寄駅	もよりえき	moyorieki
同条	どうじょう	doujou
典型的	てんけいてき	tennkeiteki
低価格	ていかかく	teikakaku
実質的	じっしつてき	jisshitsuteki
保険者	ほけんしゃ	hokennsha
対象者	たいしょうしゃ	taishousha
説得力	せっとくりょく	settokuryoku
編集者	へんしゅうしゃ	hennshuusha
編集長	へんしゅうちょう	hennshuuchou
暴力団	ぼうりょくだん	bouryokudann
会計士	かいけいし	kaikeishi
高血圧	こうけつあつ	kouketsuatsu
救急車	きゅうきゅうしゃ	kyuukyuusha
総選挙	そうせんきょ	sousennkyo
高性能	こうせいのう	kouseinou
多様性	たようせい	tayousei
高画質	こうがしつ	kougashitsu
質問者	しつもんしゃ	shitsumonnsha
利便性	りべんせい	ribennsei
効率化	こうりつか	kouritsuka
小麦粉	こむぎこ	komugiko
日常的	にちじょうてき	nichijouteki
人件費	じんけんひ	jinnkennhi
支持率	しじりつ	shijiritsu
管理費	かんりひ	kannrihi
非表示	ひひょうじ	hihyouji
入居者	にゅうきょしゃ	nyuukyosha
有意義	ゆういぎ	yuuigi
非営利	ひえいり	hieiri
機能性	きのうせい	kinousei
保証金	ほしょうきん	hoshoukinn
無責任	むせきにん	musekininn
方程式	ほうていしき	houteishiki
準決勝	じゅんけっしょう	junnkesshou
管理職	かんりしょく	kannrishoku
最小限	さいしょうげん	saishougenn
医師会	いしかい	ishikai
血液型	けつえきがた	ketsuekigata
居場所	いばしょ	ibasho
建造物	けんぞうぶつ	kennzoubutsu
生産性	せいさんせい	seisannsei
不利益	ふりえき	furieki
絶対的	ぜったいてき	zettaiteki
再開発	さいかいはつ	saikaihatsu
再利用	さいりよう	sairiyou
芸能界	げいのうかい	geinoukai
人間性	にんげんせい	ninngennsei
強制的	きょうせいてき	kyouseiteki
基本法	きほんほう	kihonnhou
厚労	こうろう	kourou
建設業	けんせつぎょう	kennsetsugyou
保健所	ほけんじょ	hokennjo
建築士	けんちくし	kennchikushi
所得税	しょとくぜい	shotokuzei
安定性	あんていせい	annteisei
最適化	さいてきか	saitekika
想像力	そうぞうりょく	souzouryoku
習慣病	しゅうかんびょう	shuukannbyou
本質的	ほんしつてき	honnshitsuteki
戦略的	せんりゃくてき	sennryakuteki
直接的	ちょくせつてき	chokusetsuteki
競技場	きょうぎじょう	kyougijou
合格者	ごうかくしゃ	goukakusha
技術力	ぎじゅつりょく	gijutsuryoku
基準法	きじゅんほう	kijunnhou
解像度	かいぞうど	kaizoudo
最寄	もより	moyori
限定版	げんていばん	gennteibann
情報量	じょうほうりょう	jouhouryou
栄養素	えいようそ	eiyouso
栄養士	えいようし	eiyoushi
保証人	ほしょうにん	hoshouninn
保険金	ほけんきん	hokennkinn
留守番	るすばん	rusubann
個人差	こじんさ	kojinnsa
参加費	さんかひ	sannkahi
右衛門	えもん	emonn
準備中	じゅんびちゅう	junnbichuu
指導員	しどういん	shidouinn
出版物	しゅっぱんぶつ	shuppannbutsu
芸術家	げいじゅつか	geijutsuka
保育士	ほいくし	hoikushi
日本製	にほんせい	nihonnsei
美容師	びようし	biyoushi
構造物	こうぞうぶつ	kouzoubutsu
過半数	かはんすう	kahannsuu
高機能	こうきのう	koukinou
情報化	じょうほうか	jouhouka
全国版	ぜんこくばん	zennkokubann
法人税	ほうじんぜい	houjinnzei
製作所	せいさくしょ|せいさくじょ	seisakusho|seisakujo
金型	かながた	kanagata
申告書	しんこくしょ	shinnkokusho
番外編	ばんがいへん	banngaihenn
絶好調	ぜっこうちょう	zekkouchou
有効性	ゆうこうせい	yuukousei
合唱団	がっしょうだん	gasshoudann
基地外	きちがい	kichigai
婦人科	ふじんか	fujinnka
予約制	よやくせい	yoyakusei
授業料	じゅぎょうりょう	jugyouryou
体験版	たいけんばん	taikennbann
非常識	ひじょうしき	hijoushiki
関連性	かんれんせい	kannrennsei
消防団	しょうぼうだん	shouboudann
価格帯	かかくたい	kakakutai
不快感	ふかいかん	fukaikann
機能的	きのうてき	kinouteki
受賞者	じゅしょうしゃ	jushousha
資本金	しほんきん	shihonnkinn
限度額	げんどがく	genndogaku
情報局	じょうほうきょく	jouhoukyoku
世界史	せかいし	sekaishi
無条件	むじょうけん	mujoukenn
生活費	せいかつひ	seikatsuhi
助教授	じょきょうじゅ	jokyouju
似顔絵	にがおえ	nigaoe
在学中	ざいがくちゅう	zaigakuchuu
停留所	ていりゅうじょ	teiryuujo
標準的	ひょうじゅんてき	hyoujunnteki
世紀末	せいきまつ	seikimatsu
事業費	じぎょうひ	jigyouhi
常識的	じょうしきてき	joushikiteki
表現力	ひょうげんりょく	hyougennryoku
支持者	しじしゃ	shijisha
構成員	こうせいいん	kouseiinn
支部長	しぶちょう	shibuchou
再起動	さいきどう	saikidou
感情的	かんじょうてき	kannjouteki
相続税	そうぞくぜい	souzokuzei
現在地	げんざいち	gennzaichi
神経質	しんけいしつ	shinnkeishitsu
組織的	そしきてき	soshikiteki
労務士	ろうむし	roumushi
乗務員	じょうむいん	joumuinn
有用性	ゆうようせい	yuuyousei
標準化	ひょうじゅんか	hyoujunnka
保険証	ほけんしょう	hokennshou
出張所	しゅっちょうしょ|しゅっちょうじょ	shucchousho|shucchoujo
受講者	じゅこうしゃ	jukousha
未対応	みたいおう	mitaiou
関西弁	かんさいべん	kannsaibenn
調査会	ちょうさかい	chousakai
非正規	ひせいき	hiseiki
移動中	いどうちゅう	idouchuu
精力的	せいりょくてき	seiryokuteki
紀元前	きげんぜん	kigennzenn
共益費	きょうえきひ	kyouekihi
新技術	しんぎじゅつ	shinngijutsu
衛生士	えいせいし	eiseishi
能力者	のうりょくしゃ	nouryokusha
市職員	ししょくいん	shishokuinn
国際化	こくさいか	kokusaika
報告会	ほうこくかい	houkokukai
所得者	しょとくしゃ	shotokusha
女性用	じょせいよう	joseiyou
資格者	しかくしゃ	shikakusha
絶望的	ぜつぼうてき	zetsubouteki
重賞	じゅうしょう	juushou
精神病	せいしんびょう	seishinnbyou
適正化	てきせいか	tekiseika
付属品	ふぞくひん	fuzokuhinn
相当額	そうとうがく	soutougaku
有識者	ゆうしきしゃ	yuushikisha
本格化	ほんかくか	honnkakuka
平均的	へいきんてき	heikinnteki
住民税	じゅうみんぜい	juuminnzei
研修医	けんしゅうい	kennshuui
感受性	かんじゅせい	kannjusei
再発見	さいはっけん	saihakkenn
短編集	たんぺんしゅう	tannpennshuu
新世紀	しんせいき	shinnseiki
罪悪感	ざいあくかん	zaiakukann
寄生虫	きせいちゅう	kiseichuu
保険法	ほけんほう	hokennhou
年会費	ねんかいひ	nennkaihi
美術品	びじゅつひん	bijutsuhinn
同性愛	どうせいあい	douseiai
招待状	しょうたいじょう	shoutaijou
消費量	しょうひりょう	shouhiryou
検察官	けんさつかん	kennsatsukann
支配人	しはいにん	shihaininn
意識的	いしきてき	ishikiteki
関係性	かんけいせい	kannkeisei
現行犯	げんこうはん	gennkouhann
武道館	ぶどうかん	budoukann
自衛官	じえいかん	jieikann
救世主	きゅうせいしゅ	kyuuseishu
予告編	よこくへん	yokokuhenn
経歴書	けいれきしょ	keirekisho
無防備	むぼうび	muboubi
合計額	ごうけいがく	goukeigaku
雑貨屋	ざっかや	zakkaya
正常化	せいじょうか	seijouka
酸化物	さんかぶつ	sannkabutsu
修道院	しゅうどういん	shuudouinn
自給率	じきゅうりつ	jikyuuritsu
研究費	けんきゅうひ	kennkyuuhi
外構	がいこう	gaikou
研修生	けんしゅうせい	kennshuusei
不規則	ふきそく	fukisoku
居住者	きょじゅうしゃ	kyojuusha
雑木林	ぞうきばやし	zoukibayashi
精神力	せいしんりょく	seishinnryoku
無表情	むひょうじょう	muhyoujou
不合格	ふごうかく	fugoukaku
気管支	きかんし	kikannshi
何個	なんこ	nannko
整合性	せいごうせい	seigousei
非日常	ひにちじょう	hinichijou
守護神	しゅごしん	shugoshinn
無制限	むせいげん	museigenn
構造的	こうぞうてき	kouzouteki
助産師	じょさんし	josannshi
工事費	こうじひ	koujihi
事業団	じぎょうだん	jigyoudann
責任感	せきにんかん	sekininnkann
低所得	ていしょとく	teishotoku
業務上	ぎょうむじょう	gyoumujou
現代的	げんだいてき	genndaiteki
非課税	ひかぜい	hikazei
総集編	そうしゅうへん	soushuuhenn
全体像	ぜんたいぞう	zenntaizou
支配者	しはいしゃ	shihaisha
運転士	うんてんし	unntennshi
低気圧	ていきあつ	teikiatsu
自営業	じえいぎょう	jieigyou
評議員	ひょうぎいん	hyougiinn
注意報	ちゅういほう	chuuihou
通気性	つうきせい	tsuukisei
成長率	せいちょうりつ	seichouritsu
断熱材	だんねつざい	dannnetsuzai
現金化	げんきんか	gennkinnka
社労士	しゃろうし	sharoushi
代議士	だいぎし	daigishi
増改築	ぞうかいちく	zoukaichiku
米粉	こめこ|べいふん	komeko|beifunn
知識人	ちしきじん	chishikijinn
史上初	しじょうはつ	shijouhatsu
加圧	かあつ	kaatsu
防止法	ぼうしほう	boushihou
飛行士	ひこうし	hikoushi
雑記帳	ざっきちょう	zakkichou
明確化	めいかくか	meikakuka
制作者	せいさくしゃ	seisakusha
武士道	ぶしどう	bushidou
寄付金	きふきん	kifukinn
停止中	ていしちゅう	teishichuu
志望校	しぼうこう	shiboukou
中国製	ちゅうごくせい	chuugokusei
受容体	じゅようたい	juyoutai
失業率	しつぎょうりつ	shitsugyouritsu
流動性	りゅうどうせい	ryuudousei
正当性	せいとうせい	seitousei
逆効果	ぎゃくこうか	gyakukouka
国際法	こくさいほう	kokusaihou
弁護人	べんごにん	benngoninn
保健室	ほけんしつ	hokennshitsu
判断力	はんだんりょく	hanndannryoku
新機能	しんきのう	shinnkinou
保留中	ほりゅうちゅう	horyuuchuu
演出家	えんしゅつか	ennshutsuka
複数人	ふくすうにん	fukusuuninn
不整脈	ふせいみゃく	fuseimyaku
無所属	むしょぞく	mushozoku
解決法	かいけつほう	kaiketsuhou
組織化	そしきか	soshikika
暴走族	ぼうそうぞく	bousouzoku
金属製	きんぞくせい	kinnzokusei
求職者	きゅうしょくしゃ	kyuushokusha
刊行物	かんこうぶつ	kannkoubutsu
料率	りょうりつ	ryouritsu
植物性	しょくぶつせい	shokubutsusei
支店長	してんちょう	shitennchou
社会性	しゃかいせい	shakaisei
肉厚	にくあつ	nikuatsu
調教師	ちょうきょうし	choukyoushi
支配下	しはいか	shihaika
感謝祭	かんしゃさい	kannshasai
新人賞	しんじんしょう	shinnjinnshou
芸術的	げいじゅつてき	geijutsuteki
群像	ぐんぞう	gunnzou
不条理	ふじょうり	fujouri
光熱費	こうねつひ	kounetsuhi
製品名	せいひんめい	seihinnmei
効果音	こうかおん	koukaonn
知財	ちざい	chizai
受講料	じゅこうりょう	jukouryou
在校生	ざいこうせい	zaikousei
弁当箱	べんとうばこ	benntoubako
再発行	さいはっこう	saihakkou
田舎者	いなかもの	inakamono
英検	えいけん	eikenn
留意点	りゅういてん	ryuuitenn
国際線	こくさいせん	kokusaisenn
再評価	さいひょうか	saihyouka
財務相	ざいむしょう	zaimushou
在来線	ざいらいせん	zairaisenn
合理性	ごうりせい	gourisei
非公式	ひこうしき	hikoushiki
設計図	せっけいず	sekkeizu
製品化	せいひんか	seihinnka
暴力的	ぼうりょくてき	bouryokuteki
具現化	ぐげんか	gugennka
製造元	せいぞうもと	seizoumoto
禁止法	きんしほう	kinnshihou
対象物	たいしょうぶつ	taishoubutsu
直営店	ちょくえいてん	chokueitenn
停車駅	ていしゃえき	teishaeki
競技会	きょうぎかい	kyougikai
評議会	ひょうぎかい	hyougikai
標準語	ひょうじゅんご	hyoujunngo
法務局	ほうむきょく	houmukyoku
解説書	かいせつしょ	kaisetsusho
事務員	じむいん	jimuinn
性犯罪	せいはんざい	seihannzai
芸術祭	げいじゅつさい	geijutsusai
栄養価	えいようか	eiyouka
利益率	りえきりつ	riekiritsu
読解力	どっかいりょく	dokkairyoku
許可証	きょかしょう	kyokashou
文学賞	ぶんがくしょう	bunngakushou
特別賞	とくべつしょう	tokubetsushou
保証書	ほしょうしょ	hoshousho
営業部	えいぎょうぶ	eigyoubu
正義感	せいぎかん	seigikann
導電	どうでん	doudenn
仮想化	かそうか	kasouka
質的	しつてき	shitsuteki
記者団	きしゃだん	kishadann
教育費	きょういくひ	kyouikuhi
消防車	しょうぼうしゃ	shoubousha
統計的	とうけいてき	toukeiteki
解説者	かいせつしゃ	kaisetsusha
備長炭	びんちょうたん	binnchoutann
告別式	こくべつしき	kokubetsushiki
保守的	ほしゅてき	hoshuteki
少年団	しょうねんだん	shounenndann
同一性	どういつせい	douitsusei
合格率	ごうかくりつ	goukakuritsu
感謝状	かんしゃじょう	kannshajou
投票率	とうひょうりつ	touhyouritsu
義務化	ぎむか	gimuka
無造作	むぞうさ	muzousa
大前提	だいぜんてい	daizenntei
受益者	じゅえきしゃ	juekisha
美意識	びいしき	biishiki
事務室	じむしつ	jimushitsu
成功率	せいこうりつ	seikouritsu
建設的	けんせつてき	kennsetsuteki
市民税	しみんぜい	shiminnzei
新興国	しんこうこく	shinnkoukoku
弁護団	べんごだん	benngodann
保健師	ほけんし	hokennshi
資料室	しりょうしつ	shiryoushitsu
主任者	しゅにんしゃ	shuninnsha
良型	りょうけい	ryoukei
基地局	きちきょく	kichikyoku
調理師	ちょうりし	chourishi
大動脈	だいどうみゃく	daidoumyaku
小枝	こえだ|さえだ	koeda|saeda
必然性	ひつぜんせい	hitsuzennsei
高学歴	こうがくれき	kougakureki
職員室	しょくいんしつ	shokuinnshitsu
容積率	ようせきりつ	yousekiritsu
調査員	ちょうさいん	chousainn
衛生的	えいせいてき	eiseiteki
演技力	えんぎりょく	enngiryoku
原則的	げんそくてき	gennsokuteki
面接官	めんせつかん	mennsetsukann
限定的	げんていてき	gennteiteki
輸入車	ゆにゅうしゃ	yunyuusha
資料集	しりょうしゅう	shiryoushuu
小型化	こがたか	kogataka
不適当	ふてきとう	futekitou
道州制	どうしゅうせい	doushuusei
経産	けいさん	keisann
事故死	じこし	jikoshi
自意識	じいしき	jiishiki
調査士	ちょうさし	chousashi
健常者	けんじょうしゃ	kennjousha
集団的	しゅうだんてき	shuudannteki
総務部	そうむぶ	soumubu
史的	してき	shiteki
弁理士	べんりし	bennrishi
低所得者	ていしょとくしゃ	teishotokusha
物質的	ぶっしつてき	busshitsuteki
社保	しゃほ	shaho
予防法	よぼうほう	yobouhou
前職	ぜんしょく	zennshoku
営業中	えいぎょうちゅう	eigyouchuu
市税	しぜい	shizei
総務課	そうむか	soumuka
氷河期	ひょうがき	hyougaki
中性子	ちゅうせいし	chuuseishi
独自性	どくじせい	dokujisei
準備金	じゅんびきん	junnbikinn
登録制	とうろくせい	tourokusei
情熱的	じょうねつてき	jounetsuteki
現代語	げんだいご	genndaigo
織布	しょくふ	shokufu
一体型	いったいがた	ittaigata
委任状	いにんじょう	ininnjou
統計学	とうけいがく	toukeigaku
高気圧	こうきあつ	koukiatsu
人型	ひとがた	hitogata
確信犯	かくしんはん	kakushinnhann
指導力	しどうりょく	shidouryoku
電停	でんてい	denntei
総本山	そうほんざん	souhonnzann
地方税	ちほうぜい	chihouzei
自主性	じしゅせい	jishusei
団体戦	だんたいせん	danntaisenn
先天性	せんてんせい	senntennsei
確実性	かくじつせい	kakujitsusei
無機質	むきしつ	mukishitsu
無限大	むげんだい	mugenndai
志願者	しがんしゃ	shigannsha
代表格	だいひょうかく	daihyoukaku
経営学	けいえいがく	keieigaku
営業職	えいぎょうしょく	eigyoushoku
日程表	にっていひょう	nitteihyou
輸入品	ゆにゅうひん	yunyuuhinn
得意先	とくいさき	tokuisaki
直輸入	ちょくゆにゅう	chokuyunyuu
外断熱	そとだんねつ	sotodannnetsu
学術的	がくじゅつてき	gakujutsuteki
不織	ふしょく	fushoku
高得点	こうとくてん	koutokutenn
現実味	げんじつみ	gennjitsumi
主体性	しゅたいせい	shutaisei
公会堂	こうかいどう	koukaidou
居住地	きょじゅうち	kyojuuchi
再出発	さいしゅっぱつ	saishuppatsu
居住用	きょじゅうよう	kyojuuyou
歴史学	れきしがく	rekishigaku
性教育	せいきょういく	seikyouiku
得意技	とくいわざ	tokuiwaza
実効性	じっこうせい	jikkousei
最新刊	さいしんかん	saishinnkann
貸付金	かしつけきん	kashitsukekinn
個人名	こじんめい	kojinnmei
張本人	ちょうほんにん	chouhonnninn
現代史	げんだいし	genndaishi
養育費	よういくひ	youikuhi
政治学	せいじがく	seijigaku
近現代	きんげんだい	kinngenndai
非売品	ひばいひん	hibaihinn
混合物	こんごうぶつ	konngoubutsu
大航海	だいこうかい	daikoukai
公共性	こうきょうせい	koukyousei
議事堂	ぎじどう	gijidou
快適性	かいてきせい	kaitekisei
評価書	ひょうかしょ	hyoukasho
無効化	むこうか	mukouka
非線形	ひせんけい	hisennkei
断続的	だんぞくてき	dannzokuteki
小型犬	こがたけん	kogatakenn
過労死	かろうし	karoushi
定時制	ていじせい	teijisei
無期限	むきげん	mukigenn
総動員	そうどういん	soudouinn
高水準	こうすいじゅん	kousuijunn
大本営	だいほんえい	daihonnei
動物性	どうぶつせい	doubutsusei
競技者	きょうぎしゃ	kyougisha
気象台	きしょうだい	kishoudai
低学歴	ていがくれき	teigakureki
前日比	ぜんじつひ	zennjitsuhi
再生産	さいせいさん	saiseisann
調査団	ちょうさだん	chousadann