地域	ちいき	chiiki
確認	かくにん	kakuninn
一覧	いちらん	ichirann
子供	こども	kodomo
探す	さがす	sagasu
映画	えいが	eiga
提供	ていきょう	teikyou
温泉	おんせん|いでゆ	onnsenn|ideyu
探し	さがし	sagashi
簡単	かんたん	kanntann
存在	そんざい	sonnzai
住宅	じゅうたく	juutaku
賃貸	ちんたい	chinntai
経済	けいざい	keizai
専門	せんもん	sennmonn
忘れ	わすれれ|わすれ	wasurere|wasure
対策	たいさく	taisaku
欲しい	ほしい	hoshii
ご覧	ごらん	gorann
届け	とどけ	todoke
担当	たんとう	tanntou
障害	しょうがい	shougai
検討	けんとう	kenntou
頂き	いただき	itadaki
展開	てんかい	tennkai
処理	しょり	shori
自己	じこ	jiko
誕生	たんじょう	tannjou
難しい	むずかしい|むつかしい	muzukashii|mutsukashii
以降	いこう	ikou
法律	ほうりつ	houritsu
著作	ちょさく	chosaku
雑誌	ざっし	zasshi
拡大	かくだい	kakudai
認め	みとめ|したため	mitome|shitatame
保存	ほぞん	hozonn
暮らし	くらし|ぐらし	kurashi|gurashi
展示	てんじ	tennji
価値	かち	kachi
映像	えいぞう	eizou
負担	ふたん	futann
改善	かいぜん	kaizenn
素敵	すてき	suteki
講座	こうざ	kouza
郵便	ゆうびん	yuubinn
危険	きけん	kikenn
専用	せんよう	sennyou
演奏	えんそう	ennsou
政策	せいさく	seisaku
若い	わかい	wakai
推進	すいしん	suishinn
訪問	ほうもん	houmonn
方針	ほうしん	houshinn
看護	かんご	kanngo
認識	にんしき	ninnshiki
優勝	ゆうしょう	yuushou
警察	けいさつ	keisatsu
異なる	ことなる	kotonaru
将来	しょうらい	shourai
規模	きぼ	kibo
装置	そうち	souchi
宇宙	うちゅう	uchuu
批判	ひはん	hihann
自宅	じたく	jitaku
議論	ぎろん	gironn
就職	しゅうしょく	shuushoku
政権	せいけん	seikenn
発展	はってん	hattenn
お腹	おなか	onaka
勤務	きんむ	kinnmu
疑問	ぎもん	gimonn
段階	だんかい	dannkai
改革	かいかく	kaikaku
納得	なっとく	nattoku
値段	ねだん	nedann
操作	そうさ	sousa
認定	にんてい	ninntei
厳しい	きびしい|いかめしい	kibishii|ikameshii
異常	いじょう	ijou
処分	しょぶん	shobunn
株式	かぶしき	kabushiki
申し訳	もうしわけ	moushiwake
著者	ちょしゃ	chosha
宗教	しゅうきょう	shuukyou
役割	やくわり	yakuwari
感染	かんせん	kannsenn
権利	けんり	kennri
候補	こうほ	kouho
済み	すみ|ずみ	sumi|zumi
呼ばれ	よばれ	yobare
降り	おり|ふり|くだり|ぶり	ori|furi|kudari|buri
補助	ほじょ	hojo
収録	しゅうろく	shuuroku
除く	のぞく	nozoku
死亡	しぼう	shibou
模様	もよう	moyou
訪れ	おとずれ	otozure
承認	しょうにん	shouninn
秘密	ひみつ	himitsu
容疑	ようぎ	yougi
痛い	いたい	itai
優しい	やさしい	yasashii
背景	はいけい	haikei
姿勢	しせい	shisei
否定	ひてい	hitei
証券	しょうけん	shoukenn
従来	じゅうらい	juurai
手段	しゅだん	shudann
危機	きき	kiki
裁判	さいばん	saibann
視点	してん	shitenn
天皇	てんのう|すめらみこと	tennnou|sumeramikoto
装備	そうび	soubi
困難	こんなん	konnnann
我が家	わがや	wagaya
無視	むし	mushi
優先	ゆうせん	yuusenn
翌日	よくじつ	yokujitsu
沿い	そい|ぞい	soi|zoi
看板	かんばん	kannbann
貴重	きちょう	kichou
理論	りろん	rironn
収入	しゅうにゅう	shuunyuu
収集	しゅうしゅう	shuushuu
解除	かいじょ	kaijo
劇場	げきじょう	gekijou
展望	てんぼう	tennbou
資源	しげん	shigenn
憲法	けんぽう	kennpou
宣言	せんげん	senngenn
貴方	あなた|きほう	anata|kihou
若者	わかもの	wakamono
紅葉	こうよう|もみじ	kouyou|momiji
単純	たんじゅん	tannjunn
呼ぶ	よぶ	yobu
階段	かいだん	kaidann
割引	わりびき	waribiki
通勤	つうきん	tsuukinn
宣伝	せんでん	senndenn
回収	かいしゅう	kaishuu
若干	じゃっかん	jakkann
退職	たいしょく	taishoku
背中	せなか	senaka
何処	いずこ|どこ	izuko|doko
帰宅	きたく	kitaku
発揮	はっき	hakki
我が	わが	waga
窓口	まどぐち	madoguchi
保障	ほしょう	hoshou
遺産	いさん	isann
論文	ろんぶん	ronnbunn
筋肉	きんにく|すじにく	kinnniku|sujiniku
異なり	ことなり	kotonari
立派	りっぱ	rippa
供給	きょうきゅう	kyoukyuu
沿線	えんせん	ennsenn
反映	はんえい	hannei
頂く	いただく	itadaku
創造	そうぞう	souzou
人権	じんけん	jinnkenn
収納	しゅうのう	shuunou
重視	じゅうし	juushi
領域	りょういき	ryouiki
呼吸	こきゅう	kokyuu
巻き	まき	maki
数値	すうち	suuchi
延長	えんちょう	ennchou
吸収	きゅうしゅう	kyuushuu
至る	いたる	itaru
時刻	じこく	jikoku
視線	しせん	shisenn
従業	じゅうぎょう	juugyou
山頂	さんちょう	sannchou
内閣	ないかく	naikaku
歌詞	かし	kashi
決済	けっさい	kessai
困る	こまる	komaru
結論	けつろん	ketsuronn
宅配	たくはい	takuhai
激しい	はげしい	hageshii
創作	そうさく	sousaku
割合	わりあい	wariai
衣装	いしょう	ishou
革命	かくめい	kakumei
並びに	ならびに	narabini
女優	じょゆう	joyuu
有難う	ありがとう	arigatou
演劇	えんげき	enngeki
並び	ならび	narabi
株価	かぶか	kabuka
電源	でんげん	denngenn
認証	にんしょう	ninnshou
口座	こうざ	kouza
温暖	おんだん	onndann
俳優	はいゆう	haiyuu
並べ	ならべ	narabe
認める	みとめる|したためる	mitomeru|shitatameru
心臓	しんぞう	shinnzou
疑い	うたがい	utagai
対処	たいしょ	taisho
創業	そうぎょう	sougyou
混乱	こんらん	konnrann
指揮	しき	shiki
興奮	こうふん	koufunn
引退	いんたい	inntai
認知	にんち	ninnchi
株主	かぶぬし	kabunushi
論理	ろんり	ronnri
厳選	げんせん	gennsenn
分割	ぶんかつ	bunnkatsu
届く	とどく	todoku
声優	せいゆう	seiyuu
臨時	りんじ	rinnji
権力	けんりょく	kennryoku
散策	さんさく	sannsaku
就任	しゅうにん	shuuninn
幼児	ようじ|おさなご	youji|osanago
収益	しゅうえき	shuueki
若しくは	もしくわ	moshikuwa
家賃	やちん	yachinn
区域	くいき	kuiki
誤解	ごかい	gokai
若手	わかて	wakate
誤り	あやまり	ayamari
拝見	はいけん	haikenn
年収	ねんしゅう	nennshuu
同盟	どうめい	doumei
牛乳	ぎゅうにゅう	gyuunyuu
加盟	かめい	kamei
閉店	へいてん	heitenn
痛く	いたく	itaku
上映	じょうえい	jouei
除去	じょきょ	jokyo
一層	いっそう	issou
将軍	しょうぐん	shougunn
割れ	われれ|われ	warere|ware
台詞	せりふ|ぜりふ|だいし	serifu|zerifu|daishi
頂ける	いただける	itadakeru
系統	けいとう	keitou
暖かい	あたたかい	atatakai
開幕	かいまく	kaimaku
署名	しょめい	shomei
政党	せいとう	seitou
閉じる	とじる	tojiru
意欲	いよく	iyoku
訪れる	おとずれる	otozureru
砂糖	さとう|ざとう	satou|zatou
郷土	きょうど	kyoudo
私立	しりつ|わたくしりつ	shiritsu|watakushiritsu
装着	そうちゃく	souchaku
盛り	さかり|もり|ざかり	sakari|mori|zakari
賃金	ちんぎん|ちんきん	chinnginn|chinnkinn
並ぶ	ならぶ	narabu
並み	なみ	nami
反射	はんしゃ	hannsha
参拝	さんぱい	sannpai
割り	わり	wari
暮らす	くらす	kurasu
簡易	かんい	kanni
拡張	かくちょう	kakuchou
補正	ほせい	hosei
深刻	しんこく	shinnkoku
警備	けいび	keibi
激安	げきやす	gekiyasu
届出	とどけで	todokede
尊敬	そんけい	sonnkei
従事	じゅうじ	juuji
密着	みっちゃく	micchaku
返済	へんさい	hennsai
危ない	あぶない	abunai
出勤	しゅっきん	shukkinn
連盟	れんめい	rennmei
故障	こしょう	koshou
反論	はんろん	hannronn
中傷	ちゅうしょう	chuushou
故郷	こきょう|ふるさと	kokyou|furusato
包装	ほうそう	housou
頭痛	ずつう	zutsuu
推定	すいてい	suitei
策定	さくてい	sakutei
諸国	しょこく	shokoku
権限	けんげん	kenngenn
染め	そめ|しめ|ぞめ	some|shime|zome
幕府	ばくふ	bakufu
紅茶	こうちゃ	koucha
片手	かたて	katate
言い訳	いいわけ	iiwake
源泉	げんせん	gennsenn
背後	はいご	haigo
体操	たいそう	taisou
非難	ひなん	hinann
県警	けんけい	kennkei
勤め	つとめ|づとめ	tsutome|dutome
推移	すいい	suii
処置	しょち	shochi
承知	しょうち	shouchi
降る	ふる|くだる	furu|kudaru
放映	ほうえい	houei
聖書	せいしょ	seisho
優良	ゆうりょう	yuuryou
頂上	ちょうじょう	choujou
評論	ひょうろん	hyouronn
補給	ほきゅう	hokyuu
盛り上がり	もりあがり	moriagari
体系	たいけい	taikei
服装	ふくそう	fukusou
視野	しや	shiya
模型	もけい	mokei
預金	よきん	yokinn
干し	ほし|ぼし	hoshi|boshi
在宅	ざいたく	zaitaku
派手	はで	hade
食欲	しょくよく	shokuyoku
著書	ちょしょ	chosho
系列	けいれつ	keiretsu
感激	かんげき	kanngeki
盛ん	さかん|もん	sakann|monn
推測	すいそく	suisoku
収容	しゅうよう	shuuyou
俳句	はいく	haiku
縮小	しゅくしょう	shukushou
注射	ちゅうしゃ	chuusha
納期	のうき	nouki
供養	くよう	kuyou
幼い	おさない|いとけない	osanai|itokenai
呼びかけ	よびかけ	yobikake
買収	ばいしゅう	baishuu
片付け	かたづけ	kataduke
安値	やすね	yasune
武将	ぶしょう	bushou
視察	しさつ	shisatsu
済む	すむ	sumu
展覧	てんらん	tennrann
郵送	ゆうそう	yuusou
秘書	ひしょ	hisho
広域	こういき	kouiki
警告	けいこく	keikoku
尊重	そんちょう	sonnchou
公認	こうにん	kouninn
視界	しかい	shikai
討論	とうろん	touronn
内装	ないそう	naisou
納豆	なっとう	nattou
補足	ほそく	hosoku
救済	きゅうさい	kyuusai
劇団	げきだん	gekidann
大衆	たいしゅう|だいしゅ	taishuu|daishu
郵政	ゆうせい	yuusei
視覚	しかく	shikaku
遺族	いぞく	izoku
財源	ざいげん	zaigenn
私的	してき	shiteki
脳内	のうない	nounai
圧縮	あっしゅく	asshuku
捨てる	すてる	suteru
創設	そうせつ	sousetsu
忘れる	わすれる	wasureru
座席	ざせき	zaseki
金銭	きんせん	kinnsenn
武装	ぶそう	busou
難い	かたい|がたい|にくい|にきい	katai|gatai|nikui|nikii
世論	せろん|よろん|せいろん	seronn|yoronn|seironn
補強	ほきょう	hokyou
総裁	そうさい	sousai
至って	いたって	itatte
指針	ししん|ゆびばり	shishinn|yubibari
支障	ししょう	shishou
悲劇	ひげき	higeki
就業	しゅうぎょう	shuugyou
蒸し	ふかし|むし	fukashi|mushi
公衆	こうしゅう	koushuu
衆院	しゅういん	shuuinn
洗い	すすい|あらい	susui|arai
収め	おさめ	osame
宝石	ほうせき	houseki
発射	はっしゃ	hassha
処方	しょほう	shohou
納税	のうぜい	nouzei
探検	たんけん	tannkenn
担保	たんぽ	tannpo
割と	わりと	warito
創立	そうりつ	souritsu
大将	たいしょう|だいしょう	taishou|daishou
延期	えんき	ennki
納付	のうふ	noufu
地蔵	じぞう	jizou
認可	にんか	ninnka
貴族	きぞく	kizoku
短縮	たんしゅく	tannshuku
共済	きょうさい	kyousai
生存	せいぞん	seizonn
急激	きゅうげき	kyuugeki
出展	しゅってん	shuttenn
伝承	でんしょう	dennshou
実装	じっそう	jissou
革新	かくしん	kakushinn
座り	すわり|ずわり	suwari|zuwari
裏側	うらがわ	uragawa
探せる	さがせる	sagaseru
日誌	にっし	nisshi
質疑	しつぎ	shitsugi
並べて	なべて	nabete
翌年	よくとし|よくねん	yokutoshi|yokunenn
幕末	ばくまつ	bakumatsu
高値	たかね	takane
進展	しんてん	shinntenn
運賃	うんちん	unnchinn
神秘	しんぴ	shinnpi
作詞	さくし	sakushi
存続	そんぞく	sonnzoku
貧困	ひんこん	hinnkonn
異動	いどう	idou
担う	になう|にのう	ninau|ninou
難し	むずかし|むつかし|がたし	muzukashi|mutsukashi|gatashi
熟成	じゅくせい	jukusei
探る	さぐる	saguru
精密	せいみつ	seimitsu
県庁	けんちょう	kennchou
苦痛	くつう	kutsuu
樹木	じゅもく	jumoku
乱れ	みだれ	midare
起源	きげん	kigenn
視力	しりょく	shiryoku
預かり	あずかり	azukari
降りる	おりる	oriru
損傷	そんしょう	sonnshou
収支	しゅうし	shuushi
地裁	ちさい	chisai
推理	すいり	suiri
遺体	いたい	itai
冊子	さっし|そうし|ぞうし	sasshi|soushi|zoushi
担任	たんにん	tannninn
存じ	ぞんじ	zonnji
骨折	こっせつ	kossetsu
改装	かいそう	kaisou
全域	ぜんいき	zenniki
通訳	つうやく	tsuuyaku
片方	かたえ|かたかた|かたほう	katae|katakata|katahou
批評	ひひょう	hihyou
預け	あずけ	azuke
欲望	よくぼう	yokubou
遺伝	いでん	idenn
難易	なんい	nanni
野党	やとう	yatou
密度	みつど	mitsudo
便秘	べんぴ	bennpi
納め	おさめ	osame
警官	けいかん	keikann
補修	ほしゅう	hoshuu
沿岸	えんがん	enngann
純正	じゅんせい	junnsei
部署	ぶしょ	busho
寸前	すんぜん	sunnzenn
著名	ちょめい	chomei
売れ筋	うれすじ	uresuji
洗面	せんめん	sennmenn
負傷	ふしょう	fushou
異議	いぎ	igi
皇室	こうしつ	koushitsu
座る	すわる	suwaru
内蔵	ないぞう|うちくら	naizou|uchikura
退院	たいいん	taiinn
兄貴	あにき	aniki
警報	けいほう	keihou
臓器	ぞうき	zouki
並木	なみき	namiki
領収	りょうしゅう	ryoushuu
宅地	たくち	takuchi
忠実	ちゅうじつ	chuujitsu
遺言	ゆいごん|いげん|いごん	yuigonn|igenn|igonn
枚数	まいすう	maisuu
純米	じゅんまい	junnmai
賃料	ちんりょう	chinnryou
高層	こうそう	kousou
有り難う	ありがとう	arigatou
一律	いちりつ	ichiritsu
内臓	ないぞう	naizou
陛下	へいか	heika
寸法	すんぽう	sunnpou
名詞	めいし	meishi
難民	なんみん	nannminn
納入	のうにゅう	nounyuu
放射	ほうしゃ	housha
蒸気	じょうき	jouki
民衆	みんしゅう	minnshuu
除外	じょがい	jogai
暮れ	くれ|ぐれ	kure|gure
異様	いよう	iyou
本尊	ほんぞん	honnzonn
値上げ	ねあげ	neage
貴様	きさま	kisama
流域	りゅういき	ryuuiki
値下げ	ねさげ	nesage
無難	ぶなん	bunann
音源	おんげん	onngenn
誠実	せいじつ	seijitsu
納品	のうひん	nouhinn
紅白	こうはく	kouhaku
後退	こうたい	koutai
今晩	こんばん	konnbann
過激	かげき	kageki
皇太子	こうたいし	koutaishi
洗う	あらう|あろう	arau|arou
馬券	ばけん	bakenn
朗読	ろうどく	roudoku
銭湯	せんとう	senntou
首脳	しゅのう	shunou
洗練	せんれん	sennrenn
聖人	せいじん|しょうにん	seijinn|shouninn
町並み	まちなみ	machinami
暖か	あたたか|あったか	atataka|attaka
分担	ぶんたん	bunntann
胃腸	いちょう	ichou
自律	じりつ	jiritsu
差異	さい	sai
毛穴	けあな	keana
転勤	てんきん	tennkinn
密か	ひそか|みそか	hisoka|misoka
創出	そうしゅつ	soushutsu
呼び出し	よびだし	yobidashi
貯蔵	ちょぞう	chozou
女将	おかみ|じょしょう	okami|joshou
頂点	ちょうてん	choutenn
優位	ゆうい	yuui
就活	しゅうかつ	shuukatsu
垂れ	たれ|だれ	tare|dare
国宝	こくほう	kokuhou
映る	うつる	utsuru
理系	りけい	rikei
変革	へんかく	hennkaku
照射	しょうしゃ	shousha
拡散	かくさん	kakusann
宝くじ	たからくじ	takarakuji
厳密	げんみつ	gennmitsu
整骨	せいこつ	seikotsu
産卵	さんらん	sannrann
存分	ぞんぶん	zonnbunn
大腸	だいちょう	daichou
階層	かいそう	kaisou
垂直	すいちょく	suichoku
論議	ろんぎ	ronngi
論争	ろんそう	ronnsou
染色	せんしょく	sennshoku
重宝	ちょうほう|じゅうほう	chouhou|juuhou
お宅	おたく	otaku
翌朝	よくあさ|よくちょう	yokuasa|yokuchou
未熟	みじゅく	mijuku
諸君	しょくん	shokunn
宝物	たからもの|ほうもつ	takaramono|houmotsu
傷害	しょうがい	shougai
退治	たいじ	taiji
創刊	そうかん	soukann
欲求	よっきゅう	yokkyuu
昨晩	さくばん	sakubann
貴女	あなた|きじょ	anata|kijo
誤差	ごさ	gosa
洗顔	せんがん	senngann
主権	しゅけん	shukenn
成熟	せいじゅく	seijuku
幼虫	ようちゅう	youchuu
磁気	じき	jiki
制裁	せいさい	seisai
礼拝	れいはい|らいはい	reihai|raihai
観覧	かんらん	kannrann
特異	とくい	tokui
豆乳	とうにゅう	tounyuu
障がい	しょうがい	shougai
金券	きんけん	kinnkenn
容姿	ようし	youshi
所蔵	しょぞう	shozou
独裁	どくさい	dokusai
優待	ゆうたい	yuutai
洗脳	せんのう	sennnou
操縦	そうじゅう	soujuu
庁舎	ちょうしゃ	chousha
異性	いせい	isei
字幕	じまく	jimaku
聖地	せいち	seichi
権者	ごんじゃ	gonnja
星座	せいざ	seiza
専念	せんねん	sennnenn
相棒	あいぼう	aibou
吸引	きゅういん	kyuuinn
共存	きょうそん|きょうぞん	kyousonn|kyouzonn
従う	したがう|したごう	shitagau|shitagou
個展	こてん	kotenn
乳がん	にゅうがん	nyuugann
幼少	ようしょう	youshou
就労	しゅうろう	shuurou
退会	たいかい	taikai
痛感	つうかん	tsuukann
専業	せんぎょう	senngyou
言論	げんろん	gennronn
論点	ろんてん	ronntenn
現存	げんそん|げんぞん	gennsonn|gennzonn
劇的	げきてき	gekiteki
特権	とっけん	tokkenn
街並み	まちなみ	machinami
夕暮れ	ゆうぐれ	yuugure
日系	にっけい	nikkei
著しい	いちじるしい	ichijirushii
至り	いたり	itari
皇后	こうごう	kougou
創る	つくる|づくる	tsukuru|dukuru
退場	たいじょう	taijou
乱暴	らんぼう	rannbou
敗退	はいたい	haitai
利権	りけん	rikenn
骨格	こっかく	kokkaku
吸う	すう	suu
補完	ほかん	hokann
土砂	どしゃ	dosha
盛大	せいだい	seidai
容認	ようにん	youninn
従前	じゅうぜん	juuzenn
裏面	うらめん|りめん	uramenn|rimenn
海域	かいいき	kaiiki
断層	だんそう	dannsou
血糖	けっとう	kettou
奏者	そうしゃ	sousha
専務	せんむ	sennmu
電磁	でんじ	dennji
補佐	ほさ	hosa
乳幼児	にゅうようじ	nyuuyouji
届け出	とどけで|とどけいで	todokede|todokeide
供述	きょうじゅつ	kyoujutsu
敬意	けいい	keii
新潮	しんちょう	shinnchou
頭脳	ずのう	zunou
開閉	かいへい	kaihei
激減	げきげん	gekigenn
根源	こんげん	konngenn
母乳	ぼにゅう	bonyuu
除け	のけ|よけ|のぞけ	noke|yoke|nozoke
内視	ないし	naishi
探訪	たんぼう	tannbou
並行	へいこう	heikou
方策	ほうさく	housaku
専有	せんゆう	sennyuu
源流	げんりゅう	gennryuu
値引き	ねびき	nebiki
省庁	しょうちょう	shouchou
党首	とうしゅ	toushu
片道	かたみち	katamichi
疑う	うたがう|うたごう	utagau|utagou
語源	ごげん	gogenn
探査	たんさ	tannsa
段差	だんさ	dannsa
格段	かくだん	kakudann
密接	みっせつ	missetsu
探求	たんきゅう	tannkyuu
収縮	しゅうしゅく	shuushuku
若葉	わかば	wakaba
新党	しんとう	shinntou
果樹	かじゅ	kaju
賃借	ちんしゃく	chinnshaku
無論	むろん	muronn
辞退	じたい	jitai
諸島	しょとう	shotou
誠意	せいい	seii
背筋	せすじ|はいきん	sesuji|haikinn
腹部	ふくぶ	fukubu
自我	じが	jiga
接骨	せっこつ	sekkotsu
来訪	らいほう	raihou
成就	じょうじゅ	jouju
神聖	しんせい	shinnsei
傷み	いたみ	itami
新株	しんかぶ	shinnkabu
内訳	うちわけ	uchiwake
文系	ぶんけい	bunnkei
裏切り	うらぎり	uragiri
延べ	のべ	nobe
夜勤	やきん	yakinn
無敵	むてき	muteki
一刻	いっこく	ikkoku
就学	しゅうがく	shuugaku
機密	きみつ	kimitsu
従量	じゅうりょう	juuryou
若年	じゃくねん	jakunenn
晩年	ばんねん	bannnenn
洗車	せんしゃ	sennsha
勤労	きんろう	kinnrou
使い捨て	つかいすて	tsukaisute
臨む	のぞむ	nozomu
水源	すいげん	suigenn
動詞	どうし	doushi
冷蔵	れいぞう	reizou
一筋	ひとすじ	hitosuji
熟練	じゅくれん	jukurenn
家系	かけい	kakei
復刻	ふっこく	fukkoku
川沿い	かわぞい	kawazoi
厳重	げんじゅう	gennjuu
深層	しんそう	shinnsou
切除	せつじょ	setsujo
創建	そうけん	soukenn
穀物	こくもつ	kokumotsu
外装	がいそう	gaisou
手洗い	てあらい	tearai
異例	いれい	irei
一段	いちだん	ichidann
簡潔	かんけつ	kannketsu
必至	ひっし	hisshi
腹筋	ふっきん|はらすじ	fukkinn|harasuji
分権	ぶんけん	bunnkenn
至福	しふく	shifuku
吸着	きゅうちゃく	kyuuchaku
女装	じょそう	josou
最善	さいぜん	saizenn
割り当て	わりあて	wariate
敵対	てきたい	tekitai
圧巻	あっかん	akkann
本誌	ほんし	honnshi
並べる	ならべる	naraberu
専属	せんぞく	sennzoku
刻み	きざみ	kizami
染み	しみ|そみ|じみ	shimi|somi|jimi
降臨	こうりん	kourinn
高砂	たかさご	takasago
梅干	うめぼし	umeboshi
反乱	はんらん	hannrann
専任	せんにん	sennninn
毎晩	まいばん	maibann
宝庫	ほうこ	houko
鉄鋼	てっこう	tekkou
生誕	せいたん	seitann
筋力	きんりょく	kinnryoku
防除	ぼうじょ	boujo
直射	ちょくしゃ	chokusha
満腹	まんぷく	mannpuku
下段	かだん|げだん	kadann|gedann
裏技	うらわざ	urawaza
片岡	かたおか	kataoka
値上がり	ねあがり	neagari
蔵元	くらもと	kuramoto
外傷	がいしょう	gaishou
車窓	しゃそう	shasou
特派	とくは	tokuha
下降	かこう	kakou
難関	なんかん	nannkann
上段	じょうだん	joudann
歌劇	かげき	kageki
授乳	じゅにゅう	junyuu
訪ねる	たずねる	tazuneru
座談	ざだん	zadann
訳あり	わけあり	wakeari
空腹	くうふく	kuufuku
縦走	じゅうそう	juusou
お供	おとも	otomo
暮らせる	くらせる	kuraseru
厳格	げんかく	gennkaku
鉄骨	てっこつ	tekkotsu
巻く	まく	maku
乳児	にゅうじ	nyuuji
難点	なんてん	nanntenn
蒸留	じょうりゅう	jouryuu
観劇	かんげき	kanngeki
官庁	かんちょう	kannchou
異国	いこく	ikoku
段ボール	だんぼーる	dannbo-ru
討ち	うち	uchi
格納	かくのう	kakunou
磁石	じしゃく	jishaku
別冊	べっさつ	bessatsu
至高	しこう	shikou
臨海	りんかい	rinnkai
閣議	かくぎ	kakugi
賛否	さんぴ	sannpi
聖堂	せいどう	seidou
切り捨て	きりすて	kirisute
激戦	げきせん	gekisenn
一寸	ちょっと	chotto
座長	ざちょう	zachou
仏閣	ぶっかく	bukkaku
操る	あやつる	ayatsuru
私鉄	してつ	shitetsu
宗派	しゅうは	shuuha
熟語	じゅくご	jukugo
干物	ひもの|ほしもの	himono|hoshimono
水系	すいけい	suikei
腹痛	ふくつう|はらいた	fukutsuu|haraita
伝染	でんせん	dennsenn
痛む	いたむ	itamu
常勤	じょうきん	joukinn
装い	よそおい|よそい	yosooi|yosoi
善意	ぜんい	zenni
風潮	ふうちょう	fuuchou
操業	そうぎょう	sougyou
障子	しょうじ	shouji
片側	かたがわ	katagawa
降下	こうか	kouka
正論	せいろん	seironn
重傷	おもで|じゅうしょう	omode|juushou
派生	はせい	hasei
断片	だんぺん	dannpenn
脳裏	のうり	nouri
書簡	しょかん	shokann
敬遠	けいえん	keienn
潮流	ちょうりゅう	chouryuu
宣告	せんこく	sennkoku
同署	どうしょ	dousho
植樹	しょくじゅ	shokuju
胸元	むなもと	munamoto
可視	かし	kashi
除雪	じょせつ	josetsu
蔵書	ぞうしょ	zousho
届け日	とどけび	todokebi
砂利	じゃり	jari
補う	おぎなう|おぎのう	oginau|oginou
大盛り	おおもり	oomori
皇族	こうぞく	kouzoku
敬老	けいろう	keirou
筋トレ	きんとれ	kinntore
全巻	ぜんかん	zennkann
降ろし	おろし	oroshi
石段	いしだん	ishidann
皇子	おうじ|こうし|みこ	ouji|koushi|miko
上層	じょうそう	jousou
秘伝	ひでん	hidenn
暮し	くらし|ぐらし	kurashi|gurashi
呼び名	よびな	yobina
異論	いろん	ironn
片づけ	かたづけ	kataduke
延び	のび	nobi
値打ち	ねうち	neuchi
誤字	ごじ	goji
酒蔵	さかぐら	sakagura
居宅	きょたく	kyotaku
論者	ろんしゃ	ronnsha
変異	へんい	henni
敬語	けいご	keigo
盛り合わせ	もりあわせ	moriawase
官公庁	かんこうちょう	kannkouchou
若松	わかまつ	wakamatsu
異変	いへん	ihenn
異物	いぶつ|こともの	ibutsu|kotomono
独創	どくそう	dokusou
会派	かいは	kaiha
背面	はいめん	haimenn
担い手	にないて	ninaite
黒糖	こくとう	kokutou
共著	きょうちょ	kyoucho
届ける	とどける	todokeru
主将	しゅしょう	shushou
忠告	ちゅうこく	chuukoku
射程	しゃてい	shatei
座標	ざひょう	zahyou
難病	なんびょう	nannbyou
退社	たいしゃ	taisha
尊厳	そんげん	sonngenn
遺構	いこう	ikou
卵巣	らんそう	rannsou
和装	わそう	wasou
割安	わりやす	wariyasu
遊覧	ゆうらん	yuurann
優勢	ゆうせい	yuusei
奏でる	かなでる	kanaderu
可否	かひ	kahi
高裁	こうさい	kousai
刻印	こくいん	kokuinn
勤める	つとめる	tsutomeru
供する	きょうする	kyousuru
乱入	らんにゅう	rannnyuu
段取り	だんどり	danndori
蒸発	じょうはつ	jouhatsu
厳禁	げんきん	gennkinn
完熟	かんじゅく	kannjuku
呼ばわり	よばわり	yobawari
穴場	あなば	anaba
散乱	さんらん	sannrann
収束	しゅうそく	shuusoku
難解	なんかい	nannkai
裏付け	うらづけ	uraduke
収まる	おさまる	osamaru
退去	たいきょ	taikyo
王座	おうざ	ouza
模試	もし	moshi
残存	ざんそん|ざんぞん	zannsonn|zannzonn
税収	ぜいしゅう	zeishuu
簡素	かんそ	kannso
喜劇	きげき	kigeki
探り	さぐり	saguri
従軍	じゅうぐん	juugunn
割る	われる|わる	wareru|waru
今晩は	こんばんは	konnbannha
亡命	ぼうめい	boumei
裏話	うらばなし	urabanashi
閣下	かっか	kakka
土俵	どひょう	dohyou
腸内	ちょうない	chounai
泉質	せんしつ	sennshitsu
子宝	こだから	kodakara
劇中	げきちゅう	gekichuu
鉄筋	てっきん	tekkinn
沿革	えんかく	ennkaku
小銭	こぜに	kozeni
土下座	どげざ	dogeza
降水	こうすい	kousui
納車	のうしゃ	nousha
激化	げきか|げっか	gekika|gekka
宝箱	たからばこ	takarabako
短冊	たんざく|たんじゃく	tannzaku|tannjaku
閉会	へいかい	heikai
呼べる	よべる	yoberu
社宅	しゃたく	shataku
除草	じょそう	josou
落とし穴	おとしあな	otoshiana
預言	よげん	yogenn
私服	しふく	shifuku
高専	こうせん	kousenn
干支	えと|かんし	eto|kannshi
降格	こうかく	koukaku
火傷	やけど|かしょう	yakedo|kashou
新装	しんそう	shinnsou
裏表	うらおもて	uraomote
梅干し	うめぼし	umeboshi
貴社	きしゃ	kisha
傷つける	きずつける	kizutsukeru
有り難い	ありがたい	arigatai
府警	ふけい	fukei
至上	しじょう	shijou
連呼	れんこ	rennko
巻末	かんまつ	kannmatsu
裁量	さいりょう	sairyou
雑穀	ざっこく	zakkoku
討議	とうぎ	tougi
党員	とういん	touinn
映り	うつり	utsuri
密集	みっしゅう	misshuu
破片	はへん	hahenn
波乱	はらん	harann
段落	だんらく	dannraku
干潟	ひがた	higata
映え	はえ|ばえ	hae|bae
軽視	けいし	keishi
裏腹	うらはら	urahara
道筋	みちすじ	michisuji
親善	しんぜん	shinnzenn
改憲	かいけん	kaikenn
並列	へいれつ	heiretsu
王将	おうしょう	oushou
縦断	じゅうだん	juudann
所存	しょぞん	shozonn
絶頂	ぜっちょう	zecchou
出納	すいとう	suitou
届け先	とどけさき	todokesaki
結納	ゆいのう	yuinou
度胸	どきょう	dokyou
水域	すいいき	suiiki
幼女	ようじょ	youjo
苦難	くなん	kunann
皇居	こうきょ	koukyo
激動	げきどう	gekidou
異色	いしょく	ishoku
秘境	ひきょう	hikyou
洗礼	せんれい	sennrei
遺物	いぶつ	ibutsu
染まる	そまる	somaru
首筋	くびすじ	kubisuji
博覧	はくらん	hakurann
樹林	じゅりん	jurinn
中将	ちゅうじょう	chuujou
宅建	たっけん	takkenn
編著	へんちょ	henncho
巻頭	かんとう	kanntou
映える	はえる	haeru
有難い	ありがたい	arigatai
蒸し暑い	むしあちい|むしあつい	mushiachii|mushiatsui
電脳	でんのう	dennnou
規律	きりつ	kiritsu
収める	おさめる	osameru
将校	しょうこう	shoukou
至極	しごく	shigoku
重奏	じゅうそう	juusou
遺品	いひん	ihinn
飛び降り	とびおり|とびくだり	tobiori|tobikudari
欠片	かけら|けっぺん	kakera|keppenn
大蔵	おおくら|だいぞう	ookura|daizou
密教	みっきょう	mikkyou
臨場	りんじょう	rinnjou
遺骨	いこつ	ikotsu
退任	たいにん	taininn
樹立	じゅりつ|こだち	juritsu|kodachi
退散	たいさん	taisann
忠誠	ちゅうせい	chuusei
創始	そうし	soushi
豊胸	ほうきょう	houkyou
中腹	ちゅうふく|なかはら	chuufuku|nakahara
大樹	たいじゅ	taiju
終値	おわりね	owarine
射殺	しゃさつ	shasatsu
水洗い	みずあらい	mizuarai
登頂	とうちょう|とちょう	touchou|tochou
亡くなる	なくなる	nakunaru
若返り	わかがえり	wakagaeri
石灰	せっかい|いしばい	sekkai|ishibai
論外	ろんがい	ronngai
最盛	さいせい	saisei
中退	ちゅうたい	chuutai
朝晩	あさばん	asabann
胸部	きょうぶ	kyoubu
否認	ひにん	hininn
優美	ゆうび	yuubi
正座	せいざ	seiza
三蔵	さんぞう	sannzou
極秘	ごくひ	gokuhi
推察	すいさつ	suisatsu
幼なじみ	おさななじみ	osananajimi
肺がん	はいがん	haigann
地層	ちそう	chisou
夕刻	ゆうこく	yuukoku
激痛	げきつう	gekitsuu
教皇	きょうこう	kyoukou
割高	わりだか	waridaka
恩返し	おんがえし	onngaeshi
垂れ流し	たれながし	tarenagashi
磁場	じば|じじょう	jiba|jijou
背骨	せぼね	sebone
至近	しきん	shikinn
署長	しょちょう	shochou
真紅	しんく	shinnku
訳者	やくしゃ	yakusha
傷口	きずぐち	kizuguchi
裏手	うらて	urate
推計	すいけい	suikei
下層	かそう	kasou
警部	けいぶ	keibu
延命	えんめい	ennmei
密室	みっしつ	misshitsu
秘湯	ひとう	hitou
絵巻	えまき	emaki
異質	いしつ	ishitsu
尊い	たっとい|とうとい	tattoi|toutoi
染料	せんりょう	sennryou
窓際	まどぎわ	madogiwa
温存	おんぞん	onnzonn
忘れ物	わすれもの	wasuremono
翌月	よくげつ	yokugetsu
恩師	おんし	onnshi
弁済	べんさい	bennsai
就いて	ついて	tsuite
聖母	せいぼ	seibo
盛り付け	もりつけ	moritsuke
疑似	ぎじ	giji
刻む	きざむ	kizamu
表層	ひょうそう	hyousou
気密	きみつ	kimitsu
拝観	はいかん	haikann
裏返し	うらがえし	uragaeshi
退学	たいがく	taigaku
災難	さいなん	sainann
推し	すいし|おし	suishi|oshi
秘話	ひわ	hiwa
権現	ごんげん	gonngenn
収蔵	しゅうぞう	shuuzou
至急	しきゅう	shikyuu
足裏	あしうら	ashiura
光源	こうげん	kougenn
沿道	えんどう	enndou
死傷	ししょう	shishou
朗報	ろうほう	rouhou
密閉	みっぺい	mippei
降雨	こうう	kouu
党内	とうない	tounai
合奏	がっそう	gassou
流派	りゅうは	ryuuha
切腹	せっぷく	seppuku
純一	じゅんいつ	junnitsu
内覧	ないらん	nairann
帯域	たいいき	taiiki
両論	りょうろん	ryouronn
吸入	きゅうにゅう	kyuunyuu
純情	じゅんじょう	junnjou
台座	だいざ	daiza
卒論	そつろん	sotsuronn
後ろ姿	うしろすがた	ushirosugata
系図	けいず	keizu
脳死	のうし	noushi
乱立	らんりつ	rannritsu
殺傷	さっしょう	sasshou
担ぎ	かつぎ	katsugi
片足	かたあし	kataashi
下巻	げかん	gekann
割増	わりまし	warimashi
収まり	おさまり	osamari
男優	だんゆう	dannyuu
正絹	しょうけん	shoukenn
高貴	こうき	kouki
善悪	ぜんあく	zennaku
ひび割れ	ひびわれ	hibiware
月収	げっしゅう	gesshuu
砂防	さぼう	sabou
探知	たんち	tannchi
垂水	たるみ	tarumi
背負う	せおう|しょう	seou|shou
縮尺	しゅくしゃく	shukushaku
降板	こうばん	koubann
割れる	われる	wareru
乗降	じょうこう	joukou
私学	しがく	shigaku
低脳	ていのう	teinou
株券	かぶけん	kabukenn
預ける	あずける	azukeru
尺八	しゃくはち	shakuhachi
君臨	くんりん	kunnrinn
海沿い	うみぞい	umizoi
鋼板	こうはん	kouhann
お供え	おそなえ	osonae
仮装	かそう	kasou
晩秋	ばんしゅう	bannshuu
支庁	しちょう	shichou
探究	たんきゅう	tannkyuu
一巻	いっかん	ikkann
紅い	あかい	akai
片思い	かたおもい	kataomoi
物欲	ぶつよく	butsuyoku
裏金	うらがね	uragane
熟し	じゅくし|こなし	jukushi|konashi
歯並び	はならび	hanarabi
就く	つく|づく	tsuku|duku
画策	かくさく	kakusaku
納める	おさめる	osameru
割愛	かつあい	katsuai
弁論	べんろん	bennronn
遺書	いしょ	isho
陽射し	ひざし	hizashi
近視	きんし	kinnshi
否決	ひけつ	hiketsu
厳守	げんしゅ	gennshu
裏切る	うらぎる	uragiru
染める	そめる	someru
鋼鉄	こうてつ	koutetsu
派兵	はへい	hahei
灰皿	はいざら	haizara
臨界	りんかい	rinnkai
山系	さんけい	sannkei
異名	いみょう|いめい	imyou|imei
痛快	つうかい	tsuukai
黒潮	くろしお	kuroshio
退団	たいだん	taidann
裏山	うらやま	urayama
憲章	けんしょう	kennshou
純度	じゅんど	junndo
割当	わりあて	wariate
吸水	きゅうすい	kyuusui
創意	そうい	soui
権益	けんえき	kenneki
体裁	ていさい	teisai
純白	じゅんぱく	junnpaku
賃貸借	ちんたいしゃく	chinntaishaku
別段	べつだん	betsudann
版権	はんけん	hannkenn
乱用	らんよう	rannyou
傷つく	きずつく	kizutsuku
直視	ちょくし	chokushi
就航	しゅうこう	shuukou
裁き	さばき	sabaki
国策	こくさく	kokusaku
危害	きがい	kigai
縦横	じゅうおう|たてよこ	juuou|tateyoko
背負い	せおい|しょい	seoi|shoi
強敵	きょうてき|ごうてき	kyouteki|gouteki
衆生	しゅじょう	shujou
裏地	うらじ	uraji
注視	ちゅうし	chuushi
我家	わがや	wagaya
幕開け	まくあけ	makuake
誤認	ごにん	goninn
磁性	じせい	jisei
客層	きゃくそう	kyakusou
晩飯	ばんめし	bannmeshi
傷病	しょうびょう	shoubyou
親密	しんみつ	shinnmitsu
穴子	あなご	anago
古泉	こせん	kosenn
潮風	しおかぜ	shiokaze
専ら	もっぱら	moppara
降雪	こうせつ	kousetsu
綿密	めんみつ	mennmitsu
善良	ぜんりょう	zennryou
済ませる	すませる	sumaseru
従兄弟	いとこ|じゅうけいてい	itoko|juukeitei
供用	きょうよう	kyouyou
持論	じろん	jironn
論じる	ろんじる	ronnjiru
積層	せきそう	sekisou
尺度	しゃくど	shakudo
黒幕	くろまく	kuromaku
天敵	てんてき	tennteki
悪党	あくとう	akutou
秘宝	ひほう	hihou
目視	もくし	mokushi
机上	きじょう	kijou
納骨	のうこつ	noukotsu
激変	げきへん	gekihenn
上値	うわね	uwane
値動き	ねうごき	neugoki
聖域	せいいき	seiiki
私見	しけん	shikenn
装束	しょうぞく	shouzoku
和訳	わやく	wayaku
閉館	へいかん	heikann
退け	しりぞけ|どけ|のけ|ひけ	shirizoke|doke|noke|hike
皮革	ひかく	hikaku
簡略	かんりゃく	kannryaku
痛風	つうふう	tsuufuu
連射	れんしゃ	rennsha
裁定	さいてい	saitei
純愛	じゅんあい	junnai
無痛	むつう	mutsuu
下腹	かふく|したはら	kafuku|shitahara
補欠	ほけつ	hoketsu
一派	いっぱ	ippa
晩ご飯	ばんごはん	banngohann
熟知	じゅくち	jukuchi
危うい	あやうい	ayaui
書誌	しょし	shoshi
片付ける	かたづける	katadukeru
洗える	あらえる	araeru
後姿	うしろすがた	ushirosugata
厳正	げんせい	gennsei
勤続	きんぞく	kinnzoku
閉める	しめる	shimeru
異形	いぎょう|いけい	igyou|ikei
呼び捨て	よびすて	yobisute
本庁	ほんちょう	honnchou
糖質	とうしつ	toushitsu
拝借	はいしゃく	haishaku
宣戦	せんせん	sennsenn
敬愛	けいあい	keiai
名著	めいちょ	meicho
従属	じゅうぞく	juuzoku
値下がり	ねさがり	nesagari
人並み	ひとなみ	hitonami
欲張り	よくばり	yokubari
糖度	とうど	toudo
鋼材	こうざい	kouzai
利己	りこ	riko
専修	せんしゅう	sennshuu
裁断	さいだん	saidann
皇女	おうじょ|こうじょ|ひめみこ|みこ	oujo|koujo|himemiko|miko
除名	じょめい	jomei
勤勉	きんべん	kinnbenn
糖分	とうぶん	toubunn
聖火	せいか	seika
論調	ろんちょう	ronnchou
増収	ぞうしゅう	zoushuu
操り	あやつり	ayatsuri
真っ盛り	まっさかり	massakari
揮発	きはつ	kihatsu
班長	はんちょう	hannchou
真宗	しんしゅう	shinnshuu
補習	ほしゅう	hoshuu
黄砂	こうさ	kousa
服従	ふくじゅう	fukujuu
疑念	ぎねん	ginenn
磁器	じき	jiki
未納	みのう	minou
視認	しにん	shininn
決裁	けっさい	kessai
収量	しゅうりょう	shuuryou
純金	じゅんきん	junnkinn
論説	ろんせつ	ronnsetsu
右脳	うのう	unou
加担	かたん	katann
追従	ついじゅう|ついしょう	tsuijuu|tsuishou
中段	ちゅうだん	chuudann
英訳	えいやく	eiyaku
山並み	やまなみ	yamanami
黄泉	こうせん|よみ	kousenn|yomi
専科	せんか	sennka
仲裁	ちゅうさい	chuusai
便座	べんざ	bennza
俳人	はいじん	haijinn
胃がん	いがん	igann
私大	しだい	shidai
巻き上げ	まきあげ	makiage
看病	かんびょう	kannbyou
左派	さは	saha
半熟	はんじゅく	hannjuku
延びる	のびる	nobiru
呼応	こおう	koou
仁義	じんぎ	jinngi
私事	しじ|わたくしごと	shiji|watakushigoto
若宮	わかみや	wakamiya
難航	なんこう	nannkou
諸説	しょせつ	shosetsu
難題	なんだい	nanndai
巻物	まきもの	makimono
雨降り	あめふり	amefuri
策略	さくりゃく	sakuryaku
乳酸	にゅうさん	nyuusann
暖冬	だんとう	danntou
一樹	いちじゅ	ichiju
推論	すいろん	suironn
宗家	そうけ	souke
公私	こうし	koushi
口紅	くちべに	kuchibeni
針金	はりがね	harigane
上巻	じょうかん	joukann
裏方	うらかた	urakata
帰郷	ききょう	kikyou
無傷	むきず	mukizu
収拾	しゅうしゅう	shuushuu
樹海	じゅかい	jukai
干す	ほす	hosu
善人	ぜんにん	zennninn
卵黄	らんおう	rannou
減退	げんたい	genntai
心肺	しんぱい	shinnpai
難問	なんもん	nannmonn
低層	ていそう	teisou
券売	けんばい	kennbai
供え	そなえ	sonae
親権	しんけん	shinnkenn
簡便	かんべん	kannbenn
己が	おのが	onoga
発券	はっけん	hakkenn
紅色	こうしょく|べにいろ	koushoku|beniiro
装丁	そうてい	soutei
沿う	そう	sou
映す	うつす	utsusu
優れもの	すぐれもの	suguremono
私物	しぶつ	shibutsu
私設	しせつ	shisetsu
少将	しょうしょう	shoushou
乱れる	みだれる	midareru
密約	みつやく	mitsuyaku
変装	へんそう	hennsou
秘蔵	ひぞう|ひぞ	hizou|hizo
直腸	ちょくちょう	chokuchou
片面	かためん	katamenn
山盛り	やまもり	yamamori
疑わしい	うたがわしい	utagawashii
屋根裏	やねうら	yaneura
論破	ろんぱ	ronnpa
至難	しなん	shinann
砂地	すなじ|すなち	sunaji|sunachi
増補	ぞうほ	zouho
至る所	いたるところ	itarutokoro
若菜	わかな	wakana
訪日	ほうにち	hounichi
心筋	しんきん	shinnkinn
感傷	かんしょう	kannshou
乳頭	にゅうとう	nyuutou
街宣	がいせん	gaisenn
忠義	ちゅうぎ	chuugi
署員	しょいん	shoinn
源平	げんぺい	gennpei
舌打ち	したうち	shitauchi
難なく	なんなく	nannnaku
窓辺	まどべ	madobe
特段	とくだん	tokudann
清純	せいじゅん	seijunn
従順	じゅうじゅん	juujunn
糖類	とうるい	tourui
装具	そうぐ	sougu
自腹	じばら	jibara
縮毛	しゅくもう	shukumou
戦乱	せんらん	sennrann
音域	おんいき	onniki
定刻	ていこく	teikoku
熟年	じゅくねん	jukunenn
警護	けいご	keigo
暮れる	くれる	kureru
ゆで卵	ゆでたまご	yudetamago
毒舌	どくぜつ	dokuzetsu
一座	いちざ	ichiza
射出	しゃしゅつ	shashutsu
密輸	みつゆ	mitsuyu
減収	げんしゅう	gennshuu
土砂降り	どしゃぶり	doshaburi
聖戦	せいせん	seisenn
水洗	すいせん	suisenn
下値	したね	shitane
持株	もちかぶ	mochikabu
背もたれ	せもたれ	semotare
直系	ちょっけい	chokkei
乳液	にゅうえき	nyuueki
難所	なんしょ	nannsho
受難	じゅなん	junann
観衆	かんしゅう	kannshuu
完済	かんさい	kannsai
野暮	やぼ	yabo
口論	こうろん	kouronn
預かる	あずかる	azukaru
穴あけ	あなあけ	anaake
専売	せんばい	sennbai
鋼管	こうかん	koukann
目処	めど	medo
奮戦	ふんせん	funnsenn
郷里	きょうり|ごうり	kyouri|gouri
降順	こうじゅん	koujunn
諸氏	しょし	shoshi
てんこ盛り	てんこもり	tennkomori
家宅	かたく	kataku
激務	げきむ	gekimu
鉱泉	こうせん	kousenn
都庁	とちょう	tochou
拝読	はいどく	haidoku
本筋	ほんすじ	honnsuji
全盛	ぜんせい	zennsei
皇位	こうい	koui
冬至	とうじ	touji
持ち株	もちかぶ	mochikabu
創世	そうせい	sousei
日勤	にっきん	nikkinn
敵国	てきこく|てっこく	tekikoku|tekkoku
割れ目	われめ	wareme
小刻み	こきざみ	kokizami
脳波	のうは	nouha
就農	しゅうのう	shuunou
家宝	かほう	kahou
宣教	せんきょう	sennkyou
春巻き	はるまき	harumaki
論評	ろんぴょう	ronnpyou
骨太	ほねぶと	honebuto
裏打ち	うらうち	urauchi
習熟	しゅうじゅく	shuujuku
土蔵	どぞう	dozou
復権	ふっけん	fukkenn
誤用	ごよう	goyou
道沿い	みちぞい	michizoi
安否	あんぴ	annpi
群衆	ぐんしゅう	gunnshuu
合否	ごうひ	gouhi
聖職	せいしょく	seishoku
歯痛	しつう|はいた	shitsuu|haita
樹皮	じゅひ	juhi
敵意	てきい	tekii
存する	そんする	sonnsuru
若し	もし|わかし	moshi|wakashi
宝島	たからじま	takarajima
手探り	てさぐり	tesaguri
市域	しいき	shiiki
再訪	さいほう	saihou
従者	じゅうしゃ	juusha
大層	たいそう	taisou
片目	かため	katame
悲痛	ひつう	hitsuu
高座	こうざ	kouza
裏庭	うらにわ	uraniwa
調律	ちょうりつ	chouritsu
激増	げきぞう	gekizou
目論見	もくろみ	mokuromi
しきい値	しきいち	shikiichi
処する	しょする	shosuru
小腸	しょうちょう	shouchou
裁決	さいけつ	saiketsu
恩給	おんきゅう	onnkyuu
吸気	きゅうき	kyuuki
吸い物	すいもの	suimono
水郷	すいきょう|すいごう	suikyou|suigou
異種	いしゅ	ishu
血筋	ちすじ	chisuji
紅梅	こうばい	koubai
直訳	ちょくやく	chokuyaku
敬礼	けいれい	keirei
洗い場	あらいば	araiba
蔵人	くらびと|くろうど|くらうどの|くらんど	kurabito|kuroudo|kuraudono|kuranndo
取り巻き	とりまき	torimaki
一党	いっとう	ittou
誌面	しめん	shimenn
裁く	さばく	sabaku
未亡人	みぼうじん	miboujinn
裏付ける	うらづける	uradukeru
同窓	どうそう	dousou
誤算	ごさん	gosann
誌上	しじょう	shijou
若草	わかくさ	wakakusa
返納	へんのう	hennnou
聖歌	せいか	seika
動乱	どうらん	dourann
大脳	だいのう	dainou
射手	いて|いで|しゃしゅ	ite|ide|shashu
助詞	じょし	joshi
腸管	ちょうかん	choukann
表裏	ひょうり|おもてうら	hyouri|omoteura
律法	りっぽう	rippou
物干し	ものほし	monohoshi
探し物	さがしもの	sagashimono
初段	しょだん	shodann
回覧	かいらん	kairann
退化	たいか	taika
裏目	うらめ	urame
預入	あずけいれ	azukeire
表敬	ひょうけい	hyoukei
総論	そうろん	souronn
砂場	すなば	sunaba
骨子	こっし	kosshi
退出	たいしゅつ	taishutsu
善行	ぜんこう	zennkou
工賃	こうちん	kouchinn
翌週	よくしゅう	yokushuu
名将	めいしょう	meishou
腹ごしらえ	はらごしらえ	haragoshirae
痛み止め	いたみどめ	itamidome
財宝	ざいほう	zaihou
上皇	じょうこう	joukou
ポイ捨て	ぽいすて	poisute
夏至	げし	geshi
割引き	わりびき	waribiki
幼年	ようねん	younenn
前段	ぜんだん	zenndann
前奏	ぜんそう	zennsou
町域	ちょういき	chouiki
射す	さす	sasu
著作権	ちょさくけん	chosakukenn
誕生日	たんじょうび	tannjoubi
障害者	しょうがいしゃ	shougaisha
看護師	かんごし	kanngoshi
私達	わたしたち	watashitachi
専門店	せんもんてん	sennmonntenn
担当者	たんとうしゃ	tanntousha
専門家	せんもんか	sennmonnka
容疑者	ようぎしゃ	yougisha
遺伝子	いでんし	idennshi
従業員	じゅうぎょういん	juugyouinn
温暖化	おんだんか	onndannka
郵便局	ゆうびんきょく	yuubinnkyoku
裁判所	さいばんしょ|さいばんじょ	saibannsho|saibannjo
大規模	だいきぼ	daikibo
冷蔵庫	れいぞうこ	reizouko
子供達	こどもたち	kodomotachi
選手権	せんしゅけん	sennshukenn
経済的	けいざいてき	keizaiteki
私自身	わたしじしん	watashijishinn
補助金	ほじょきん	hojokinn
価値観	かちかん	kachikann
航空券	こうくうけん	koukuukenn
放射線	ほうしゃせん	houshasenn
展覧会	てんらんかい	tennrannkai
衆議院	しゅうぎいん	shuugiinn
展示会	てんじかい	tennjikai
映画館	えいがかん	eigakann
存在感	そんざいかん	sonnzaikann
検討中	けんとうちゅう	kenntouchuu
危険性	きけんせい	kikennsei
専門医	せんもんい	sennmonni
候補者	こうほしゃ	kouhosha
演奏会	えんそうかい	ennsoukai
警察官	けいさつかん	keisatsukann
著作物	ちょさくぶつ	chosakubutsu
小規模	しょうきぼ	shoukibo
時刻表	じこくひょう	jikokuhyou
同窓会	どうそうかい	dousoukai
難易度	なんいど	nannido
裁判官	さいばんかん	saibannkann
経済学	けいざいがく	keizaigaku
宅配便	たくはいびん	takuhaibinn
評論家	ひょうろんか	hyouronnka
住宅街	じゅうたくがい	juutakugai
警察署	けいさつしょ	keisatsusho
住宅地	じゅうたくち	juutakuchi
映画化	えいがか	eigaka
領収書	りょうしゅうしょ	ryoushuusho
専門的	せんもんてき	sennmonnteki
忘年会	ぼうねんかい	bounennkai
勤務地	きんむち	kinnmuchi
情報誌	じょうほうし	jouhoushi
看護婦	かんごふ	kanngofu
立候補	りっこうほ	rikkouho
裁判員	さいばんいん	saibanninn
論理的	ろんりてき	ronnriteki
時代劇	じだいげき	jidaigeki
筋肉痛	きんにくつう	kinnnikutsuu
映画祭	えいがさい	eigasai
最高裁	さいこうさい	saikousai
展示場	てんじじょう	tennjijou
将来的	しょうらいてき	shouraiteki
灰色	はいいろ	haiiro
所有権	しょゆうけん	shoyuukenn
翌営業日	よくえいぎょうび	yokueigyoubi
非常勤	ひじょうきん	hijoukinn
生態系	せいたいけい	seitaikei
写真展	しゃしんてん	shashinntenn
危機感	ききかん	kikikann
一覧表	いちらんひょう	ichirannhyou
退職金	たいしょくきん	taishokukinn
内視鏡	ないしきょう	naishikyou
経験値	けいけんち	keikennchi
呼吸器	こきゅうき	kokyuuki
指揮者	しきしゃ	shikisha
神経痛	しんけいつう	shinnkeitsuu
週刊誌	しゅうかんし	shuukannshi
電磁波	でんじは	dennjiha
加盟店	かめいてん	kameitenn
税務署	ぜいむしょ	zeimusho
有権者	ゆうけんしゃ	yuukennsha
障害児	しょうがいじ	shougaiji
外資系	がいしけい	gaishikei
従量制	じゅうりょうせい	juuryousei
最優先	さいゆうせん	saiyuusenn
会員権	かいいんけん	kaiinnkenn
参政権	さんせいけん	sannseikenn
従事者	じゅうじしゃ	juujisha
何枚	なんまい	nannmai
理論的	りろんてき	rironnteki
解決策	かいけつさく	kaiketsusaku
準優勝	じゅんゆうしょう	junnyuushou
温泉郷	おんせんきょう	onnsennkyou
乗車券	じょうしゃけん	joushakenn
訪問者	ほうもんしゃ	houmonnsha
特派員	とくはいん	tokuhainn
宗教的	しゅうきょうてき	shuukyouteki
神秘的	しんぴてき	shinnpiteki
接骨院	せっこついん	sekkotsuinn
予約権	よやくけん	yoyakukenn
財産権	ざいさんけん	zaisannkenn
座談会	ざだんかい	zadannkai
衆院選	しゅういんせん	shuuinnsenn
警備員	けいびいん	keibiinn
否定的	ひていてき	hiteiteki
作品展	さくひんてん	sakuhinntenn
貴金属	ききんぞく	kikinnzoku
勤務先	きんむさき	kinnmusaki
再認識	さいにんしき	saininnshiki
背番号	せばんごう	sebanngou
再就職	さいしゅうしょく	saishuushoku
負担金	ふたんきん	futannkinn
温泉街	おんせんがい	onnsenngai
一段落	いちだんらく	ichidannraku
消防署	しょうぼうしょ	shoubousho
子供服	こどもふく	kodomofuku
対処法	たいしょほう	taishohou
放射性	ほうしゃせい	houshasei
高収入	こうしゅうにゅう	koushuunyuu
批判的	ひはんてき	hihannteki
指揮官	しきかん	shikikann
小冊子	しょうさっし	shousasshi
協奏曲	きょうそうきょく	kyousoukyoku
商品券	しょうひんけん	shouhinnkenn
座布団	ざぶとん	zabutonn
専門職	せんもんしょく	sennmonnshoku
方法論	ほうほうろん	houhouronn
郵便物	ゆうびんぶつ	yuubinnbutsu
創業者	そうぎょうしゃ	sougyousha
代名詞	だいめいし	daimeishi
操作性	そうさせい	sousasei
裁判長	さいばんちょう	saibannchou
脳卒中	のうそっちゅう	nousocchuu
情報源	じょうほうげん	jouhougenn
収容所	しゅうようじょ	shuuyoujo
脳神経	のうしんけい	noushinnkei
展示室	てんじしつ	tennjishitsu
反対派	はんたいは	hanntaiha
放射能	ほうしゃのう	houshanou
重要視	じゅうようし	juuyoushi
入場券	にゅうじょうけん	nyuujoukenn
血糖値	けっとうち	kettouchi
宇宙船	うちゅうせん	uchuusenn
全盛期	ぜんせいき	zennseiki
洗面所	せんめんじょ	sennmennjo
整理券	せいりけん	seirikenn
異世界	いせかい	isekai
危険物	きけんぶつ	kikennbutsu
権力者	けんりょくしゃ	kennryokusha
純利益	じゅんりえき	junnrieki
上映会	じょうえいかい	joueikai
優先的	ゆうせんてき	yuusennteki
専門性	せんもんせい	sennmonnsei
博覧会	はくらんかい	hakurannkai
法律上	ほうりつじょう	houritsujou
乳製品	にゅうせいひん	nyuuseihinn
少数派	しょうすうは	shousuuha
諸外国	しょがいこく	shogaikoku
開幕戦	かいまくせん	kaimakusenn
時系列	じけいれつ	jikeiretsu
最盛期	さいせいき	saiseiki
平均値	へいきんち	heikinnchi
金銭的	きんせんてき	kinnsennteki
臨場感	りんじょうかん	rinnjoukann
感染者	かんせんしゃ	kannsennsha
特別展	とくべつてん	tokubetsutenn
深呼吸	しんこきゅう	shinnkokyuu
就職先	しゅうしょくさき	shuushokusaki
納税者	のうぜいしゃ	nouzeisha
異文化	いぶんか	ibunnka
諸事情	しょじじょう	shojijou
水蒸気	すいじょうき	suijouki
障害物	しょうがいぶつ	shougaibutsu
再検討	さいけんとう	saikenntou
天皇制	てんのうせい	tennnousei
純米酒	じゅんまいしゅ	junnmaishu
正統派	せいとうは	seitouha
染色体	せんしょくたい	sennshokutai
私生活	しせいかつ	shiseikatsu
主導権	しゅどうけん	shudoukenn
段階的	だんかいてき	dannkaiteki
選挙権	せんきょけん	sennkyokenn
未確認	みかくにん	mikakuninn
優勝者	ゆうしょうしゃ	yuushousha
議決権	ぎけつけん	giketsukenn
天守閣	てんしゅかく	tennshukaku
心臓病	しんぞうびょう	shinnzoubyou
基準値	きじゅんち	kijunnchi
疑問点	ぎもんてん	gimonntenn
意欲的	いよくてき	iyokuteki
死亡率	しぼうりつ	shibouritsu
将来性	しょうらいせい	shouraisei
可視化	かしか	kashika
割引券	わりびきけん	waribikikenn
対応策	たいおうさく	taiousaku
処分場	しょぶんじょう	shobunnjou
観覧車	かんらんしゃ	kannrannsha
演奏家	えんそうか	ennsouka
革新的	かくしんてき	kakushinnteki
合衆国	がっしゅうこく	gasshuukoku
大聖堂	だいせいどう	daiseidou
独創的	どくそうてき	dokusouteki
問題視	もんだいし	monndaishi
備忘録	びぼうろく	bibouroku
討論会	とうろんかい	touronnkai
純資産	じゅんしさん	junnshisann
月刊誌	げっかんし	gekkannshi
創造性	そうぞうせい	souzousei
従業者	じゅうぎょうしゃ	juugyousha
創造的	そうぞうてき	souzouteki
視覚的	しかくてき	shikakuteki
体系的	たいけいてき	taikeiteki
勤労者	きんろうしゃ	kinnrousha
法律案	ほうりつあん	houritsuann
優等生	ゆうとうせい	yuutousei
届出書	とどけでしょ	todokedesho
太陽系	たいようけい	taiyoukei
実力派	じつりょくは	jitsuryokuha
形容詞	けいようし	keiyoushi
親孝行	おやこうこう	oyakoukou
広葉樹	こうようじゅ	kouyouju
映像化	えいぞうか	eizouka
加盟国	かめいこく	kameikoku
伝染病	でんせんびょう	dennsennbyou
遊覧船	ゆうらんせん	yuurannsenn
反射的	はんしゃてき	hannshateki
探査機	たんさき	tannsaki
優位性	ゆういせい	yuuisei
創始者	そうししゃ	soushisha
進化論	しんかろん	shinnkaronn
定期券	ていきけん	teikikenn
生演奏	なまえんそう	namaennsou
預言者	よげんしゃ	yogennsha
小論文	しょうろんぶん	shouronnbunn
経済力	けいざいりょく	keizairyoku
果樹園	かじゅえん	kajuenn
深刻化	しんこくか	shinnkokuka
洗面台	せんめんだい	sennmenndai
危険度	きけんど	kikenndo
生理痛	せいりつう	seiritsuu
不純物	ふじゅんぶつ	fujunnbutsu
人形劇	にんぎょうげき	ninngyougeki
将軍家	しょうぐんけ	shougunnke
危機的	ききてき	kikiteki
物産展	ぶっさんてん	bussanntenn
著作者	ちょさくしゃ	chosakusha
街路樹	がいろじゅ	gairoju
再処理	さいしょり	saishori
退職後	たいしょくご	taishokugo
特許権	とっきょけん	tokkyokenn
宣教師	せんきょうし	sennkyoushi
看護士	かんごし	kanngoshi
雨模様	あめもよう	amemoyou
下腹部	かふくぶ	kafukubu
神経系	しんけいけい	shinnkeikei
借地権	しゃくちけん	shakuchikenn
高密度	こうみつど	koumitsudo
熱処理	ねつしょり	netsushori
来訪者	らいほうしゃ	raihousha
負傷者	ふしょうしゃ	fushousha
総裁選	そうさいせん	sousaisenn
退職者	たいしょくしゃ	taishokusha
独裁者	どくさいしゃ	dokusaisha
四重奏	しじゅうそう	shijuusou
誕生会	たんじょうかい	tannjoukai
創造力	そうぞうりょく	souzouryoku
貴重品	きちょうひん	kichouhinn
券売機	けんばいき	kennbaiki
多数派	たすうは	tasuuha
訪問着	ほうもんぎ	houmonngi
演奏者	えんそうしゃ	ennsousha
過激派	かげきは	kagekiha
延長線	えんちょうせん	ennchousenn
当日券	とうじつけん	toujitsukenn
自尊心	じそんしん	jisonnshinn
広報誌	こうほうし	kouhoushi
保存料	ほぞんりょう	hozonnryou
勤務医	きんむい	kinnmui
異次元	いじげん	ijigenn
展開中	てんかいちゅう	tennkaichuu
呼吸法	こきゅうほう	kokyuuhou
革命的	かくめいてき	kakumeiteki
経済性	けいざいせい	keizaisei
担当相	たんとうしょう	tanntoushou
参拝者	さんぱいしゃ	sannpaisha
経済界	けいざいかい	keizaikai
拡張子	かくちょうし	kakuchoushi
死亡者	しぼうしゃ	shibousha
幼少期	ようしょうき	youshouki
大納言	だいなごん	dainagonn
針葉樹	しんようじゅ	shinnyouju
横断幕	おうだんまく	oudannmaku
背景色	はいけいしょく	haikeishoku
簡素化	かんそか	kannsoka
負担額	ふたんがく	futanngaku
幼児期	ようじき	youjiki
回数券	かいすうけん	kaisuukenn
自衛権	じえいけん	jieikenn
批評家	ひひょうか	hihyouka
担当医	たんとうい	tanntoui
水資源	みずしげん	mizushigenn
深層水	しんそうすい	shinnsousui
降水量	こうすいりょう	kousuiryou
保守派	ほしゅは	hoshuha
展示物	てんじぶつ	tennjibutsu
用心棒	ようじんぼう	youjinnbou
同盟国	どうめいこく	doumeikoku
商標権	しょうひょうけん	shouhyoukenn
技術系	ぎじゅつけい	gijutsukei