紹介	しょうかい	shoukai
及び	および	oyobi
販売	はんばい	hannbai
投稿	とうこう	toukou
環境	かんきょう	kannkyou
詳細	しょうさい	shousai
違う	ちがう|たがう|ちごう|たごう	chigau|tagau|chigou|tagou
状況	じょうきょう	joukyou
変更	へんこう	hennkou
含む	ふくむ|ぐむ	fukumu|gumu
普通	ふつう	futsuu
詳しい	くわしい	kuwashii
一般	いっぱん	ippann
医療	いりょう	iryou
連絡	れんらく	rennraku
彼女	かのじょ	kanojo
店舗	てんぽ	tennpo
支援	しえん	shienn
治療	ちりょう	chiryou
皆さん	みなさん	minasann
違い	ちがい|たがい	chigai|tagai
描く	えがく|かく|がく	egaku|kaku|gaku
影響	えいきょう	eikyou
致す	いたす	itasu
応援	おうえん	ouenn
皆様	みなさま	minasama
与える	あたえる	ataeru
攻撃	こうげき	kougeki
結婚	けっこん	kekkonn
宿泊	しゅくはく	shukuhaku
比較	ひかく	hikaku
是非	ぜひ	zehi
押す	おす	osu
記憶	きおく	kioku
行為	こうい	koui
大丈夫	だいじょうぶ|だいじょぶ	daijoubu|daijobu
介護	かいご	kaigo
事項	じこう	jikou
特徴	とくちょう	tokutyou
被害	ひがい	higai
活躍	かつやく	katsuyaku
間違い	まちがい	machigai
迎える	むかえる	mukaeru
記載	きさい	kisai
項目	こうもく	koumoku
派遣	はけん	hakenn
疲れ	つかれ|づかれ|つかれれ	tsukare|dukare|tsukarere
彼ら	かれら	karera
含める	ふくめる	fukumeru
到着	とうちゃく	toutyaku
依頼	いらい	irai
離れる	はなれる|ばなれる	hanareru|banareru
書き込み	かきこみ	kakikomi
勧める	すすめる	susumeru
支払い	しはらい	shiharai
遅い	おそい	osoi
怖い	こわい	kowai
香り	かおり	kaori
距離	きょり	kyori
範囲	はんい	hanni
払う	はらう|ばらう|ぱらう|はろう|ばろう|ぱろう	harau|barau|parau|harou|barou|parou
繰り返す	くりかえす	kurikaesu
趣味	しゅみ	shumi
申し込み	もうしこみ	moushikomi
通販	つうはん	tsuuhann
年齢	ねんれい	nennrei
満載	まんさい	mannsai
更に	さらに	sarani
普段	ふだん	fudann
悩み	なやみ	nayami
指摘	してき	shiteki
取り扱い	とりあつかい	toriatsukai
瞬間	しゅんかん	shunnkann
驚く	おどろく	odoroku
地震	じしん	jishinn
高齢	こうれい	kourei
転載	てんさい	tennsai
維持	いじ	iji
抜ける	ぬける	nukeru
先輩	せんぱい	sennpai
忙しい	いそがしい|せわしい	isogashii|sewashii
引越し	ひっこし	hikkoshi
突然	とつぜん	totsuzenn
渡る	わたる	wataru
隠す	かくす	kakusu
違反	いはん	ihann
迷惑	めいわく	meiwaku
甘い	あまい|うまい	amai|umai
咲く	さく|ざく	saku|zaku
越える	こえる|ごえる	koeru|goeru
珍しい	めずらしい	mezurashii
扱い	あつかい|こい|しごい	atsukai|koi|shigoi
継続	けいぞく	keizoku
悩む	なやむ	nayamu
戦闘	せんとう	senntou
避ける	さける|よける	sakeru|yokeru
恋愛	れんあい	rennai
間違う	まちがう|まちごう	machigau|machigou
遅れ	おくれ	okure
自慢	じまん	jimann
微妙	びみょう	bimyou
獲得	かくとく	kakutoku
歓迎	かんげい	kanngei
抱く	いだく|だく	idaku|daku
傾向	けいこう	keikou
破壊	はかい	hakai
お互い	おたがい	otagai
扱う	あつかう|あつこう	atsukau|atsukou
載る	のる	noru
怒る	いかる|おこる	ikaru|okoru
書き込む	かきこむ	kakikomu
薄い	うすい|うしい	usui|ushii
恥ずかしい	はずかしい	hazukashii
逃げ	にげ	nige
触れ	ふれ|さわれ|ぶれ	fure|saware|bure
抜く	ぬく	nuku
狭い	せまい	semai
皮膚	ひふ	hifu
名称	めいしょう	meishou
替える	かえる|がえる	kaeru|gaeru
吹く	ふく|ぶく	fuku|buku
込み	こみ|ごみ	komi|gomi
療法	りょうほう	ryouhou
乾燥	かんそう	kannsou
新鮮	しんせん	shinnsenn
巨大	きょだい	kyodai
一瞬	いっしゅん	isshunn
眠る	ねむる|ねる|ねぶる	nemuru|neru|neburu
申込	もうしこみ|もうしこめ	moushikomi|moushikome
抵抗	ていこう	teikou
汚れ	けがれ|よごれ|けがれれ	kegare|yogore|kegarere
驚き	おどろき|きょうき	odoroki|kyouki
箇所	かしょ	kasho
寂しい	さびしい|さみしい	sabishii|samishii
結婚式	けっこんしき	kekkonnshiki
頼る	たよる	tayoru
売却	ばいきゃく	baikyaku
制御	せいぎょ	seigyo
巡る	めぐる	meguru
証拠	しょうこ	shouko
刺激	しげき	shigeki
振る	ふる|ぶる	furu|buru
お菓子	おかし	okashi
普及	ふきゅう	fukyuu
迫る	せまる|せる	semaru|seru
載せる	のせる	noseru
連載	れんさい	rennsai
一致	いっち	icchi
幅広い	はばひろい	habahiroi
面倒	めんどう|めんど	menndou|menndo
贈る	おくる	okuru
倒す	たおす	taosu
大幅	おおはば	oohaba
間違える	まちがえる	machigaeru
振り	ふり|ぶり|ぷり	furi|buri|puri
占い	うらない	uranai
取扱い	とりあつかい	toriatsukai
拠点	きょてん	kyotenn
解釈	かいしゃく	kaishaku
込める	こめる|ごめる	komeru|gomeru
振り返る	ふりかえる	furikaeru
お疲れ様	おつかれさま	otsukaresama
比較的	ひかくてき	hikakuteki
我慢	がまん	gamann
怒り	いかり|おこり	ikari|okori
考慮	こうりょ	kouryo
寝る	ねる|しずまる|ぬる	neru|shizumaru|nuru
用途	ようと	youto
倒れる	たおれる|だおれる	taoreru|daoreru
壊れる	こわれる	kowareru
越す	こす	kosu
恋人	こいびと	koibito
配慮	はいりょ	hairyo
訴え	うったえ	uttae
支払	しはらい|しはらえ	shiharai|shiharae
輝く	かがやく	kagayaku
込む	こむ|ごむ	komu|gomu
濃い	こい	koi
踊り	おどり	odori
飾る	かざる	kazaru
回避	かいひ	kaihi
踊る	おどる	odoru
透明	とうめい	toumei
踏む	ふむ|ぶむ	fumu|bumu
抱え	かかえ	kakae
襲う	おそう	osou
別途	べっと	betto
恐れ	おそれ|おそれれ	osore|osorere
荒らす	あらす	arasu
爆発	ばくはつ	bakuhatsu
振込	ふりこみ	furikomi
抜き	ぬき	nuki
弾く	はじく|ひく|びく	hajiku|hiku|biku
需要	じゅよう	juyou
渡し	わたし	watashi
頼む	たのむ	tanomu
恐怖	きょうふ	kyoufu
執行	しっこう|とりおこなえ	shikkou|toriokonae
信仰	しんこう	shinnkou
叫ぶ	さけぶ	sakebu
被告	ひこく	hikoku
脂肪	しぼう	shibou
攻略	こうりゃく	kouryaku
根拠	こんきょ	konnkyo
絡む	からむ	karamu
遺跡	いせき	iseki
全般	ぜんぱん	zennpann
離婚	りこん	rikonn
恐ろしい	おそろしい	osoroshii
給与	きゅうよ	kyuuyo
冒険	ぼうけん	boukenn
隠れ	かくれ|こもれ|かくれれ|がくれ	kakure|komore|kakurere|gakure
監視	かんし	kannshi
優秀	ゆうしゅう	yuushuu
及ぶ	およぶ	oyobu
伺い	うかがい	ukagai
占める	しめる|じめる	shimeru|jimeru
攻め	せめ|ぜめ	seme|zeme
臨床	りんしょう	rinnshou
取扱	とりあつかい|とりあつかえ	toriatsukai|toriatsukae
柔らかい	やわらかい	yawarakai
耐え	たえ	tae
誇る	ほこる	hokoru
恵まれる	めぐまれる	megumareru
基盤	きばん	kibann
吐く	はく|つく	haku|tsuku
申込む	もうしこむ	moushikomu
近隣	きんりん	kinnrinn
黙る	だまる	damaru
圧倒的	あっとうてき	attouteki
依存	いぞん|いそん	izonn|isonn
添える	そえる|ぞえる	soeru|zoeru
抜群	ばつぐん	batsugunn
浮かぶ	うかぶ	ukabu
狩り	かり|がり	kari|gari
閉鎖	へいさ	heisa
飾り	かざり	kazari
援助	えんじょ	ennjo
支払う	しはらう|しはろう	shiharau|shiharou
違和感	いわかん	iwakann
執筆	しっぴつ	shippitsu
薬剤師	やくざいし	yakuzaishi
握る	にぎる	nigiru
奥さん	おくさん	okusann
監査	かんさ	kannsa
触る	さわる|ふる	sawaru|furu
鑑賞	かんしょう	kannshou
尽くす	つくす	tsukusu
掘る	ほる	horu
避難	ひなん	hinann
原稿	げんこう	gennkou
遠慮	えんりょ	ennryo
添加	てんか	tennka
壊す	こわす	kowasu
祈る	いのる	inoru
お越し	おこし	okoshi
取り扱う	とりあつかう|とりあつこう	toriatsukau|toriatsukou
咲き	さき|ざき	saki|zaki
奇跡	きせき	kiseki
名誉	めいよ	meiyo
分離	ぶんり	bunnri
突っ込む	つっこむ	tsukkomu
祈り	いのり	inori
御座る	ござる	gozaru
詰め	つめ|づめ	tsume|dume
汚染	おせん	osenn
禁煙	きんえん	kinnenn
象徴	しょうちょう	shoutyou
対抗	たいこう	taikou
尋ねる	たずねる	tazuneru
違法	いほう	ihou
為替	かわせ|がわせ	kawase|gawase
拍手	はくしゅ	hakushu
荒れる	あれる	areru
太鼓	たいこ|だいこ	taiko|daiko
彼氏	かれし	kareshi
踏まえる	ふまえる	fumaeru
突入	とつにゅう	totsunyuu
響く	ひびく	hibiku
休暇	きゅうか	kyuuka
及ぼす	およぼす	oyobosu
税込	ぜいこみ	zeikomi
抗議	こうぎ	kougi
響き	ひびき	hibiki
描写	びょうしゃ	byousha
先端	せんたん	senntann
巻き込む	まきこむ	makikomu
前項	ぜんこう	zennkou
経緯	いきさつ|けいい|たてぬき	ikisatsu|keii|tatenuki
泊まる	とまる	tomaru
慎重	しんちょう	shinntyou
汚い	きたない|ぎたない	kitanai|gitanai
渡す	わたす	watasu
接触	せっしょく	sesshoku
継承	けいしょう	keishou
添付	てんぷ	tennpu
被る	かぶる|こうむる|かむる	kaburu|koumuru|kamuru
趣旨	しゅし	shushi
切り替え	きりかえ	kirikae
鑑定	かんてい	kanntei
多彩	たさい	tasai
野郎	やろう	yarou
芝居	しばい	shibai
迫力	はくりょく	hakuryoku
鮮やか	あざやか	azayaka
撃つ	うつ|ぶつ	utsu|butsu
誇り	ほこり|ぼこり	hokori|bokori
詰まる	つまる|づまる	tsumaru|dumaru
疲労	ひろう	hirou
今更	いまさら	imasara
矛盾	むじゅん	mujunn
樹脂	じゅし	jushi
濃度	のうど	noudo
刺身	さしみ	sashimi
皆さま	みなさま	minasama
振動	しんどう	shinndou
騒ぐ	さわぐ	sawagu
侵害	しんがい	shinngai
お盆	おぼん	obonn
不況	ふきょう	fukyou
実況	じっきょう	jikkyou
引っ越し	ひっこし	hikkoshi
警戒	けいかい	keikai
恒例	こうれい	kourei
侵入	しんにゅう	shinnnyuu
徴収	ちょうしゅう	tyoushuu
旨い	うまい	umai
眠い	ねむい|ねみい	nemui|nemii
老舗	しにせ|ろうほ	shinise|rouho
隣接	りんせつ	rinnsetsu
後輩	こうはい	kouhai
仲介	ちゅうかい	tyuukai
触れる	ふれる|ぶれる|さわれる	fureru|bureru|sawareru
贈り物	おくりもの	okurimono
舞う	まう|もう	mau|mou
召し上がる	めしあがる	meshiagaru
脚本	きゃくほん	kyakuhonn
端末	たんまつ	tannmatsu
強烈	きょうれつ	kyouretsu
爆笑	ばくしょう	bakushou
極端	きょくたん	kyokutann
防御	ぼうぎょ	bougyo
逃げる	にげる	nigeru
脱ぐ	ぬぐ	nugu
浮かべる	うかべる	ukaberu
中旬	ちゅうじゅん	tyuujunn
頼り	たより|だより	tayori|dayori
冒頭	ぼうとう	boutou
伺う	うかがう|うかごう	ukagau|ukagou
輝き	かがやき	kagayaki
曇る	くもる	kumoru
称す	しょうす	shousu
腐る	くさる	kusaru
沈む	しずむ	shizumu
押さえ	おさえ	osae
発掘	はっくつ	hakkutsu
乗り越える	のりこえる	norikoeru
眠り	ねむり|ねぶり	nemuri|neburi
兼ねる	かねる	kaneru
鋭い	するどい|すすどい|とい	surudoi|susudoi|toi
恐らく	おそらく	osoraku
敷金	しききん	shikikinn
脱出	だっしゅつ	dasshutsu
離す	はなす	hanasu
関与	かんよ	kannyo
市販	しはん	shihann
下旬	げじゅん	gejunn
開拓	かいたく	kaitaku
慢性	まんせい	mannsei
耐震	たいしん	taishinn
奴ら	やつら	yatsura
浮く	うく	uku
中途半端	ちゅうとはんぱ	tyuutohannpa
微笑む	ほほえむ|ほおえむ	hohoemu|hooemu
到達	とうたつ	toutatsu
濃厚	のうこう	noukou
一環	いっかん	ikkann
浸透	しんとう	shinntou
送迎	そうげい	sougei
言及	げんきゅう	gennkyuu
奥様	おくさま	okusama
爆弾	ばくだん	bakudann
繰り広げる	くりひろげる	kurihirogeru
含み	ふくみ|ぶくみ|ぐみ	fukumi|bukumi|gumi
叫び	さけび	sakebi
斜め	ななめ	naname
敷く	しく	shiku
倒産	とうさん	tousann
浮気	うわき	uwaki
腰痛	ようつう	youtsuu
闘争	とうそう	tousou
耐久	たいきゅう	taikyuu
図鑑	ずかん	zukann
蓄積	ちくせき	chikuseki
与党	よとう	yotou
目撃	もくげき	mokugeki
振替	ふりかえ	furikae
通称	つうしょう	tsuushou
劣化	れっか	rekka
疑惑	ぎわく	giwaku
持ち込む	もちこむ	mochikomu
乗り込む	のりこむ	norikomu
受け継ぐ	うけつぐ	uketsugu
斜面	しゃめん	shamenn
柔らか	やわらか	yawaraka
独占	どくせん	dokusenn
魚介	ぎょかい	gyokai
風俗	ふうぞく	fuuzoku
療養	りょうよう	ryouyou
投与	とうよ	touyo
名刺	めいし	meishi
着替え	きがえ|きかえ	kigae|kikae
見込み	みこみ	mikomi
感触	かんしょく	kannshoku
打撃	だげき	dageki
侵略	しんりゃく	shinnryaku
露出	ろしゅつ	roshutsu
狂う	くるう	kuruu
互いに	たがいに	tagaini
偉大	いだい	idai
逃す	にがす|のがす	nigasu|nogasu
駆ける	かける|がける	kakeru|gakeru
髪の毛	かみのけ	kaminoke
代替	だいたい|だいがえ	daitai|daigae
騒ぎ	さわぎ	sawagi
飛び込む	とびこむ	tobikomu
奴隷	どれい	dorei
格闘	かくとう	kakutou
お祈り	おいのり	oinori
祈願	きがん	kigann
溶け	とけ|どけ	toke|doke
柔道	じゅうどう	juudou
占領	せんりょう	sennryou
見逃し	みのがし	minogashi
威力	いりょく	iryoku
奇妙	きみょう	kimyou
奮闘	ふんとう	funntou
騒動	そうどう	soudou
粒子	りゅうし	ryuushi
捕まる	つかまる|づかまる	tsukamaru|dukamaru
選抜	せんばつ|よりぬけ	sennbatsu|yorinuke
刺す	さす	sasu
大抵	たいてい	taitei
見舞い	みまい	mimai
脱毛	だつもう	datsumou
原爆	げんばく	gennbaku
海鮮	かいせん	kaisenn
闘い	たたかい	tatakai
幾つ	いくつ	ikutsu
途端	とたん	totann
お陰	おかげ	okage
自称	じしょう	jishou
枯れる	かれる|がれる	kareru|gareru
和菓子	わがし	wagashi
震え	ふるえ	furue
遠征	えんせい	ennsei
紫外線	しがいせん	shigaisenn
精一杯	せいいっぱい	seiippai
装飾	そうしょく	soushoku
被災	ひさい	hisai
偉い	えらい	erai
惑星	わくせい	wakusei
印鑑	いんかん	innkann
落ち込む	おちこむ	ochikomu
絶妙	ぜつみょう	zetsumyou
外壁	がいへき|そとかべ	gaiheki|sotokabe
含有	がんゆう	gannyuu
劣る	おとる	otoru
悲惨	ひさん	hisann
敏感	びんかん	binnkann
付与	ふよ	fuyo
入れ替え	いれかえ	irekae
訴える	うったえる	uttaeru
後継	こうけい|あとつぎ	koukei|atotsugi
駆使	くし	kushi
頼み	たのみ|だのみ	tanomi|danomi
起訴	きそ	kiso
恵み	めぐみ	megumi
一般人	いっぱんじん	ippannjinn
壁紙	かべがみ	kabegami
刺し	さし|ざし	sashi|zashi
沈黙	ちんもく	chinnmoku
理屈	りくつ	rikutsu
玄米	げんまい|くろごめ	gennmai|kurogome
髪型	かみがた	kamigata
薬剤	やくざい	yakuzai
上旬	じょうじゅん	joujunn
乾く	かわく	kawaku
捕まえる	つかまえる|づかまえる|とらまえる	tsukamaeru|dukamaeru|toramaeru
舗装	ほそう	hosou
色彩	しきさい	shikisai
駆除	くじょ	kujo
足跡	あしあと|そくせき	ashiato|sokuseki
お迎え	おむかえ	omukae
終盤	しゅうばん	shuubann
増殖	ぞうしょく	zoushoku
甘味	あまみ|かんみ	amami|kannmi
専攻	せんこう	sennkou
煙草	たばこ	tabako
昼寝	ひるね	hirune
騒音	そうおん	souonn
傾ける	かたぶける|かたむける	katabukeru|katamukeru
甘え	あまえ|あめえ|うめえ	amae|amee|umee
闘う	たたかう|たたこう	tatakau|tatakou
彩る	いろどる	irodoru
申し込む	もうしこむ	moushikomu
取り込む	とりこむ	torikomu
継ぐ	つぐ	tsugu
振込む	ふりこむ	furikomu
突き	つき|とっき|つつき|づき|ずき	tsuki|tokki|tsutsuki|duki|zuki
抱きしめる	だきしめる	dakishimeru
寄与	きよ	kiyo
握り	にぎり	nigiri
到来	とうらい	tourai
引き継ぐ	ひきつぐ	hikitsugu
入り込む	いりこむ|はいりこむ	irikomu|hairikomu
調剤	ちょうざい	tyouzai
追い込む	おいこむ	oikomu
打ち込む	うちこむ|ぶちこむ	uchikomu|buchikomu
握手	あくしゅ	akushu
途上	とじょう	tojou
現況	げんきょう	gennkyou
洗剤	せんざい	sennzai
お疲れさま	おつかれさま	otsukaresama
駆けつける	かけつける	kaketsukeru
剣道	けんどう	kenndou
押し付ける	おしつける	oshitsukeru
勧告	かんこく	kannkoku
中盤	ちゅうばん	tyuubann
泊まり	とまり|どまり	tomari|domari
小遣い	こづかい	kodukai
お尋ね	おたずね	otazune
甘み	あまみ|うまみ	amami|umami
冷却	れいきゃく	reikyaku
振り回す	ふりまわす	furimawasu
盗る	とる|ぬすめる|どる	toru|nusumeru|doru
仕込み	しこみ|じこみ	shikomi|jikomi
民俗	みんぞく	minnzoku
突っ込み	つっこみ	tsukkomi
肩こり	かたこり	katakori
駆動	くどう	kudou
運搬	うんぱん	unnpann
強盗	ごうとう	goutou
右翼	うよく	uyoku
追及	ついきゅう	tsuikyuu
圧倒	あっとう	attou
後援	こうえん	kouenn
史跡	しせき	shiseki
最先端	さいせんたん	saisenntann
捕獲	ほかく	hokaku
遅れる	おくれる	okureru
彼等	かれら	karera
跡地	あとち	atochi
盗む	ぬすむ	nusumu
介入	かいにゅう	kainyuu
突く	つく|つつく|づく	tsuku|tsutsuku|duku
見込む	みこむ	mikomu
坊主	ぼうず	bouzu
音響	おんきょう	onnkyou
圧迫	あっぱく	appaku
序盤	じょばん	jobann
描ける	えがける|かける	egakeru|kakeru
浮上	ふじょう	fujou
替わる	かわる	kawaru
権威	けんい	kenni
飛躍	ひやく	hiyaku
抱える	かかえる	kakaeru
格闘技	かくとうぎ	kakutougi
反撃	はんげき	hanngeki
持ち込み	もちこみ	mochikomi
淡い	あわい	awai
巡回	じゅんかい	junnkai
御礼	おれい|おんれい	orei|onnrei
左翼	さよく	sayoku
咲かせる	さかせる	sakaseru
搬送	はんそう	hannsou
傾斜	けいしゃ	keisha
乾杯	かんぱい	kannpai
退屈	たいくつ	taikutsu
振り向く	ふりむく	furimuku
即日	そくじつ	sokujitsu
恐い	こわい	kowai
遅刻	ちこく	chikoku
介す	かいす	kaisu
相違	そうい	soui
離脱	りだつ	ridatsu
恋しい	こいしい	koishii
繁栄	はんえい	hannei
骨盤	こつばん	kotsubann
即ち	すなわち	sunawachi
溶接	ようせつ	yousetsu
襲撃	しゅうげき	shuugeki
皆無	かいむ	kaimu
思い込む	おもいこむ	omoikomu
射撃	しゃげき	shageki
微生物	びせいぶつ	biseibutsu
監修	かんしゅう	kannshuu
出迎え	でむかえ	demukae
組み込む	くみこむ	kumikomu
疲れる	つかれる|づかれる	tsukareru|dukareru
浸る	ひたる|びたる	hitaru|bitaru
突撃	とつげき	totsugeki
転倒	てんとう	tenntou
恐縮	きょうしゅく	kyoushuku
逃れ	のがれ|にげれ	nogare|nigere
暴露	ばくろ|ばれ	bakuro|bare
長距離	ちょうきょり	tyoukyori
事柄	ことがら	kotogara
隠れ家	かくれが	kakurega
税込み	ぜいこみ	zeikomi
追跡	ついせき	tsuiseki
荒い	あらい	arai
驚異	きょうい	kyoui
溶かす	とかす	tokasu
澄む	すむ|ずむ	sumu|zumu
養殖	ようしょく	youshoku
尽き	つき	tsuki
圏内	けんない	kennnai
堅い	かたい|がたい	katai|gatai
見渡す	みわたす	miwatasu
吸い込む	すいこむ	suikomu
大騒ぎ	おおさわぎ	oosawagi
刈る	かる|がる	karu|garu
仰る	おっしゃる|おおせる	ossharu|ooseru
速攻	そっこう	sokkou
人柄	ひとがら	hitogara
逃げ出す	にげだす	nigedasu
鮮明	せんめい	sennmei
中堅	ちゅうけん	tyuukenn
久し振り	ひさしぶり	hisashiburi
交響	こうきょう	koukyou
吹奏楽	すいそうがく	suisougaku
半端	はんぱ	hannpa
御飯	ごはん	gohann
遅延	ちえん	chienn
直撃	ちょくげき	tyokugeki
婚約	こんやく	konnyaku
引き込む	ひきこむ	hikikomu
噴火	ふんか	funnka
歌謡	かよう	kayou
連鎖	れんさ	rennsa
抱っこ	だっこ	dakko
豪雨	ごうう	gouu
愛称	あいしょう	aishou
返却	へんきゃく	hennkyaku
旨み	うまみ	umami
露天	ろてん	rotenn
盛況	せいきょう	seikyou
岩盤	がんばん	gannbann
煮込み	にこみ	nikomi
搬入	はんにゅう	hannnyuu
腕時計	うでどけい	udedokei
新婚	しんこん	shinnkonn
端子	たんし	tannshi
耐性	たいせい	taisei
苦悩	くのう	kunou
罰金	ばっきん	bakkinn
捕らえる	とらえる	toraeru
浸かる	つかる	tsukaru
倒せる	たおせる	taoseru
香具師	こうぐし|やし	kougushi|yashi
救援	きゅうえん	kyuuenn
被爆	ひばく	hibaku
大震災	だいしんさい	daishinnsai
盛り込む	もりこむ	morikomu
互い	たがい	tagai
授与	じゅよ	juyo
仰ぐ	あおぐ	aogu
怒鳴る	どなる	donaru
奥深い	おくふかい|おくぶかい	okufukai|okubukai
礼儀	れいぎ	reigi
煮物	にもの	nimono
お隣	おとなり	otonari
縁起	えんぎ	enngi
鉛筆	えんぴつ	ennpitsu
舞踊	ぶよう	buyou
絵柄	えがら	egara
交互	こうご	kougo
到底	とうてい	toutei
総称	そうしょう	soushou
盗難	とうなん	tounann
抜け出す	ぬけだす	nukedasu
中途	ちゅうと	tyuuto
彩り	いろどり	irodori
陰陽	いんよう|おんみょう|おんよう	innyou|onnmyou|onnyou
殺到	さっとう	sattou
震災	しんさい	shinnsai
スレ違う	すれちがう|すれちごう	surechigau|surechigou
豪快	ごうかい	goukai
振るう	ふるう	furuu
漫才	まんざい	mannzai
傍ら	かたわら	katawara
震度	しんど	shinndo
平凡	へいぼん	heibonn
歓声	かんせい	kannsei
吐き出す	はきだす|ほきだす	hakidasu|hokidasu
旨味	うまみ	umami
環状	かんじょう	kannjou
猛暑	もうしょ	mousho
贈答	ぞうとう	zoutou
思惑	おもわく|しわく	omowaku|shiwaku
民謡	みんよう	minnyou
逃亡	とうぼう	toubou
日替わり	ひがわり	higawari
弾圧	だんあつ	dannatsu
地雷	じらい	jirai
寝具	しんぐ	shinngu
途切れる	とぎれる	togireru
巡礼	じゅんれい	junnrei
過払い	かばらい	kabarai
声援	せいえん	seienn
撃破	げきは	gekiha
繁盛	はんじょう	hannjou
悩ます	なやます	nayamasu
近況	きんきょう	kinnkyou
仕込む	しこむ	shikomu
最高峰	さいこうほう	saikouhou
就寝	しゅうしん	shuushinn
絡める	からめる	karameru
承継	しょうけい	shoukei
爆撃	ばくげき	bakugeki
傾く	かたぶく|かたむく	katabuku|katamuku
侵攻	しんこう	shinnkou
三振	さんしん	sannshinn
唐突	とうとつ	toutotsu
屈指	くっし	kusshi
戸惑う	とまどう	tomadou
浮かび上がる	うかびあがる	ukabiagaru
反響	はんきょう	hannkyou
不振	ふしん	fushinn
手抜き	てぬき	tenuki
金髪	きんぱつ	kinnpatsu
電撃	でんげき	denngeki
振り込み	ふりこみ	furikomi
踏み込む	ふみこむ	fumikomu
嘆く	なげく	nageku
思い込み	おもいこみ	omoikomi
差し込む	さしこむ	sashikomu
自爆	じばく	jibaku
抗体	こうたい	koutai
最優秀	さいゆうしゅう	saiyuushuu
紫色	むらさきいろ	murasakiiro
誉める	ほめる	homeru
多忙	たぼう	tabou
思い浮かべる	おもいうかべる	omoiukaberu
弾力	だんりょく	dannryoku
踏み出す	ふみだす	fumidasu
鈍い	にぶい|のろい|にびい	nibui|noroi|nibii
鮮度	せんど	senndo
寝室	しんしつ	shinnshitsu
悪影響	あくえいきょう	akueikyou
追い詰める	おいつめる	oitsumeru
幾ら	いくら	ikura
即座	そくざ	sokuza
出撃	しゅつげき	shutsugeki
援護	えんご	enngo
お忙しい	おいそがしい	oisogashii
見抜く	みぬく	minuku
呼称	こしょう	koshou
寄贈	きぞう	kizou
書込み	かきこみ	kakikomi
遠慮ない	えんりょない	ennryonai
包み込む	つつみこむ|くるみこむ	tsutsumikomu|kurumikomu
逃走	とうそう	tousou
踏切	ふみきり|ふみき	fumikiri|fumiki
称号	しょうごう	shougou
獣医	じゅうい	juui
瞬時	しゅんじ	shunnji
捕る	とる|どる	toru|doru
城跡	じょうせき|しろあと	jouseki|shiroato
規範	きはん	kihann
却下	きゃっか	kyakka
無縁	むえん	muenn
薄れる	うすれる	usureru
すれ違う	すれちがう|すれちごう	surechigau|surechigou
隣る	となる	tonaru
尽力	じんりょく	jinnryoku
読み込み	よみこみ	yomikomi
腐敗	ふはい	fuhai
焼却	しょうきゃく	shoukyaku
製剤	せいざい	seizai
要項	ようこう	youkou
香ばしい	こうばしい	koubashii
条項	じょうこう	joukou
必需	ひつじゅ	hitsuju
起床	きしょう	kishou
殿下	でんか	dennka
閉じ込める	とじこめる	tojikomeru
遣い	つかい|づかい	tsukai|dukai
遣る	やる	yaru
薄暗い	うすぐらい|うすくらい	usugurai|usukurai
猛烈	もうれつ	mouretsu
吹っ飛ぶ	ふっとぶ	futtobu
狂気	きょうき	kyouki
御覧	ごらん	gorann
吐き気	はきけ	hakike
陣営	じんえい	jinnei
仮称	かしょう	kashou
浮き	うき|うわき	uki|uwaki
召す	めす	mesu
贈与	ぞうよ	zouyo
驚かす	おどろかす	odorokasu
為す	なす	nasu
壁面	へきめん	hekimenn
面倒くさい	めんどうくさい	menndoukusai
量販	りょうはん	ryouhann
噴出	ふんしゅつ	funnshutsu
煮込む	にこむ	nikomu
逃がす	にがす|のがす	nigasu|nogasu
点滴	てんてき	tennteki
介助	かいじょ	kaijo
執着	しゅうじゃく|しゅうちゃく	shuujaku|shuutyaku
透ける	すける	sukeru
耐える	たえる	taeru
攻防	こうぼう	koubou
要旨	ようし	youshi
自販機	じはんき	jihannki
広範囲	こうはんい	kouhanni
改称	かいしょう	kaishou
強豪	きょうごう	kyougou
跳ぶ	とぶ	tobu
恋する	こいする	koisuru
静寂	しじま|せいじゃく	shijima|seijaku
怖がる	こわがる	kowagaru
見舞う	みまう|みもう	mimau|mimou
吹き飛ばす	ふきとばす	fukitobasu
泊り	とまり|どまり	tomari|domari
線香	せんこう	sennkou
脱線	だっせん	dassenn
攻める	せめる	semeru
貯蓄	ちょちく	tyochiku
余儀ない	よぎない	yoginai
詰め込む	つめこむ	tsumekomu
寝台	しんだい|ねだい	shinndai|nedai
百姓	ひゃくしょう|びゃくしょう|ひゃくせい	hyakushou|byakushou|hyakusei
刺さる	ささる	sasaru
即時	そくじ	sokuji
眠気	ねむけ	nemuke
占い師	うらないし	uranaishi
見逃す	みのがす	minogasu
因縁	いんねん	innnenn
濃縮	のうしゅく	noushuku
空襲	くうしゅう	kuushuu
反抗	はんこう	hannkou
殿堂	でんどう	denndou
彼岸	ひがん	higann
新郎	しんろう	shinnrou
尋常	じんじょう	jinnjou
押し寄せる	おしよせる	oshiyoseru
憶える	おぼえる	oboeru
依然として	いぜんとして	izenntoshite
凶悪	きょうあく	kyouaku
前払い	まえばらい	maebarai
跳ね	はね|ばね	hane|bane
処罰	しょばつ	shobatsu
初恋	はつこい	hatsukoi
致命	ちめい	chimei
遠距離	えんきょり	ennkyori
一端	いったん|いっぱし	ittann|ippashi
引渡し	ひきわたし	hikiwatashi
困惑	こんわく	konnwaku
貸与	たいよ	taiyo
本殿	ほんでん	honndenn
提訴	ていそ	teiso
震える	ふるえる	furueru
歳出	さいしゅつ	saishutsu
執事	しつじ	shitsuji
獲物	えもの	emono
恐る	おそれる|おそる	osoreru|osoru
特攻	とっこう	tokkou
生殖	せいしょく	seishoku
洋菓子	ようがし	yougashi
河川敷	かせんしき	kasennshiki
暇つぶし	ひまつぶし	himatsubushi
右腕	うわん|みぎうで	uwann|migiude
振る舞い	ふるまい|ぶるまい	furumai|burumai
熱狂	ねっきょう	nekkyou
罰則	ばっそく	bassoku
坊さん	ぼうさん	bousann
薄める	うすめる	usumeru
泊まれる	とまれる	tomareru
準拠	じゅんきょ	junnkyo
寝かせる	ねかせる	nekaseru
戸惑い	とまどい	tomadoi
匹敵	ひってき	hitteki
前髪	まえがみ	maegami
微細	びさい	bisai
不透明	ふとうめい	futoumei
激怒	げきど	gekido
手渡し	てわたし	tewatashi
鮮魚	せんぎょ	senngyo
取り替える	とりかえる	torikaeru
絶叫	ぜっきょう	zekkyou
意気込み	いきごみ	ikigomi
健闘	けんとう	kenntou
寄り添う	よりそう	yorisou
沈める	しずめる	shizumeru
狂言	きょうげん	kyougenn
狩る	かる	karu
見渡せる	みわたせる	miwataseru
師範	しはん	shihann
激突	げきとつ	gekitotsu
微か	かすか	kasuka
歳入	さいにゅう	sainyuu
取り込み	とりこみ	torikomi
絶縁	ぜつえん	zetsuenn
爆破	ばくは	bakuha
抗生	こうせい	kousei
絵描き	えかき	ekaki
趣向	しゅこう	shukou
老朽	ろうきゅう	roukyuu
脱退	だったい	dattai
抜本	ばっぽん	bapponn
沈み	しずみ	shizumi
合致	がっち	gacchi
読み込む	よみこむ	yomikomu
征服	せいふく	seifuku
闘病	とうびょう	toubyou
水彩	すいさい	suisai
離せる	はなせる	hanaseru
兼ね備える	かねそなえる	kanesonaeru
後払い	あとばらい|ごばらい	atobarai|gobarai
駆け抜ける	かけぬける	kakenukeru
赤ん坊	あかんぼう|あかんぼ	akannbou|akannbo
すれ違い	すれちがい	surechigai
恐れ入る	おそれいる	osoreiru
寝不足	ねぶそく	nebusoku
歳月	さいげつ	saigetsu
浸す	ひたす|びたす	hitasu|bitasu
脱却	だっきゃく	dakkyaku
尽きる	つきる	tsukiru
溶解	ようかい	youkai
連峰	れんぽう	rennpou
左腕	さわん|ひだりうで	sawann|hidariude
家紋	かもん	kamonn
切り替える	きりかえる	kirikaeru
抱きつく	だきつく	dakitsuku
耐熱	たいねつ	tainetsu
摘み	つまみ|つみ	tsumami|tsumi
更年期	こうねんき	kounennki
書き込める	かきこめる	kakikomeru
逃避	とうひ	touhi
住環境	じゅうかんきょう	juukannkyou
小柄	こがら|こづか	kogara|koduka
脂質	ししつ	shishitsu
詰まり	つまり|づまり	tsumari|dumari
後押し	あとおし	atooshi
先駆け	さきがけ	sakigake
流れ込む	ながれこむ	nagarekomu
増幅	ぞうふく	zoufuku
扇風機	せんぷうき	sennpuuki
占う	うらなう|うらのう	uranau|uranou
香料	こうりょう	kouryou
頼もしい	たのもしい	tanomoshii
買い替え	かいかえ	kaikae
溶液	ようえき	youeki
吸血鬼	きゅうけつき	kyuuketsuki
詰め合わせ	つめあわせ	tsumeawase
出陣	しゅつじん	shutsujinn
弾丸	だんがん	danngann
略称	りゃくしょう	ryakushou
浮遊	ふゆう	fuyuu
狂い	くるい|ぐるい	kurui|gurui
本拠地	ほんきょち	honnkyochi
押し込む	おしこむ	oshikomu
奥行き	おくゆき	okuyuki
溶け込む	とけこむ	tokekomu
盆踊り	ぼんおどり	bonnodori
山奥	やまおく	yamaoku
抜け毛	ぬけげ	nukege
監禁	かんきん	kannkinn
透過	とうか	touka
違える	たがえる|ちがえる	tagaeru|chigaeru
生き抜く	いきぬく	ikinuku
義援金	ぎえんきん	giennkinn
落ち込み	おちこみ	ochikomi
闘士	とうし	toushi
占拠	せんきょ	sennkyo
気遣い	きづかい	kidukai
紋章	もんしょう	monnshou
傾げる	かしげる|かたげる	kashigeru|katageru
歳暮	せいぼ|さいぼ	seibo|saibo
飛び込み	とびこみ	tobikomi
即位	そくい	sokui
腐食	ふしょく	fushoku
離乳食	りにゅうしょく	rinyuushoku
床下	ゆかした	yukashita
未婚	みこん	mikonn
切り替わる	きりかわる	kirikawaru
摘発	てきはつ	tekihatsu
末端	まったん	mattann
吹き出す	ふきだす	fukidasu
童謡	どうよう	douyou
再婚	さいこん	saikonn
微笑ましい	ほほえましい	hohoemashii
戯れる	ざれる|たわむれる|じゃれる	zareru|tawamureru|jareru
過敏	かびん	kabinn
戯言	ざれごと|たわこと|たわごと	zaregoto|tawakoto|tawagoto
称する	しょうする	shousuru
吹き込む	ふきこむ	fukikomu
嘆き	なげき	nageki
輩出	はいしゅつ	haishutsu
飲み込む	のみこむ	nomikomu
撃退	げきたい	gekitai
所為	しょい|せい	shoi|sei
浸水	しんすい	shinnsui
捕手	とりて|ほしゅ	torite|hoshu
需給	じゅきゅう	jukyuu
通り抜ける	とおりぬける	toorinukeru
放り込む	ほうりこむ	hourikomu
撃沈	げきちん	gekichinn
寄稿	きこう	kikou
即決	そっけつ	sokketsu
倒壊	とうかい	toukai
添乗	てんじょう	tennjou
投影	とうえい	touei
突出	とっしゅつ|つきで	tosshutsu|tsukide
肩書き	かたがき	katagaki
発端	ほったん	hottann
隠居	いんきょ	innkyo
人影	ひとかげ	hitokage
露店	ろてん	rotenn
年越し	としこし	toshikoshi
駆る	かる	karu
悪戯	あくぎ|いたずら	akugi|itazura
病床	びょうしょう	byoushou
惨敗	ざんぱい	zannpai
途方	とほう	tohou
触り	さわり|ざわり|ふり	sawari|zawari|furi
露骨	ろこつ	rokotsu
突起	とっき	tokki
占有	せんゆう	sennyuu
心療内科	しんりょうないか	shinnryounaika
御用	ごよう	goyou
樹齢	じゅれい	jurei
脂肪酸	しぼうさん	shibousann
弾性	だんせい	dannsei
見逃せる	みのがせる	minogaseru
姓名	せいめい	seimei
両端	りょうたん|りょうはし|りょうはじ	ryoutann|ryouhashi|ryouhaji
巨額	きょがく	kyogaku
入れ替わる	いれかわる	irekawaru
摘む	つまむ|つむ	tsumamu|tsumu
突きつける	つきつける	tsukitsukeru
躍進	やくしん	yakushinn
胴体	どうたい	doutai
脱衣	だつい	datsui
被写体	ひしゃたい	hishatai
香る	かおる	kaoru
初旬	しょじゅん	shojunn
出稿	しゅっこう	shukkou
乾かす	かわかす	kawakasu
賞与	しょうよ	shouyo
両替	りょうがえ	ryougae
依然	いぜん	izenn
震源	しんげん	shinngenn
隣人	りんじん	rinnjinn
迫害	はくがい	hakugai
告訴	こくそ	kokuso
依る	よる	yoru
振り込む	ふりこむ	furikomu
御社	おんしゃ	onnsha
吹き抜け	ふきぬけ	fukinuke
踏み切る	ふみきる	fumikiru
溶岩	ようがん	yougann
鼓動	こどう	kodou
仮眠	かみん	kaminn
紙芝居	かみしばい	kamishibai
奥義	おうぎ|おくぎ	ougi|okugi
脱税	だつぜい	datsuzei
押しつけ	おしつけ	oshitsuke
屈折	くっせつ	kussetsu
建て替え	たてかえ	tatekae
販売元	はんばいもと	hannbaimoto
迎撃	げいげき	geigeki
異端	いたん	itann
大粒	おおつぶ	ootsubu
微量	びりょう	biryou
押さえる	おさえる	osaeru
傾き	かたむき|かたぶき	katamuki|katabuki
攻勢	こうせい	kousei
先駆	せんく|さきがけ	sennku|sakigake
濁り	にごり	nigori
脱落	だつらく	datsuraku
弾む	はずむ	hazumu
抗争	こうそう	kousou
舞踏	ぶとう	butou
逆襲	ぎゃくしゅう	gyakushuu
市況	しきょう	shikyou
触手	しょくしゅ	shokushu
駆け寄る	かけよる	kakeyoru
皮脂	ひし	hishi
主旨	しゅし	shushi
乗り継ぎ	のりつぎ	noritsugi
抜かす	ぬかす	nukasu
摘出	てきしゅつ	tekishutsu
幾何	きか	kika
脱走	だっそう	dassou
即す	そくす	sokusu
突発	とっぱつ	toppatsu
割り込む	わりこむ	warikomu
拓く	ひらく	hiraku
巡査	じゅんさ	junnsa
恥じる	はじる	hajiru
丹念	たんねん	tannnenn
蓄え	たくわえ	takuwae
隠せる	かくせる	kakuseru
採掘	さいくつ	saikutsu
煮る	にる	niru
対称	たいしょう	taishou
外為	がいため	gaitame
指紋	しもん	shimonn
曇り空	くもりぞら	kumorizora
踏ん張る	ふんばる	funnbaru
描画	びょうが	byouga
通り越す	とおりこす	toorikosu
かけ離れる	かけはなれる	kakehanareru
浮世絵	うきよえ	ukiyoe
右肩	みぎかた	migikata
製菓	せいか	seika
敷居	しきい	shikii
呼び込む	よびこむ	yobikomu
引き渡し	ひきわたし	hikiwatashi
殿様	とのさま	tonosama
脱力	だつりょく	datsuryoku
監理	かんり	kannri
突進	とっしん|つきすすめ	tosshinn|tsukisusume
騒がしい	さわがしい	sawagashii
掘り下げる	ほりさげる	horisageru
舞台裏	ぶたいうら	butaiura
祈念	きねん	kinenn
釈放	しゃくほう	shakuhou
即効	そっこう	sokkou
希薄	きはく	kihaku
透き通る	すきとおる	sukitooru
恐れる	おそれる	osoreru
間抜け	まぬけ	manuke
煙突	えんとつ	enntotsu
旧暦	きゅうれき	kyuureki
憶測	おくそく	okusoku
惑わす	まどわす	madowasu
茶髪	ちゃぱつ	tyapatsu
発狂	はっきょう	hakkyou
西暦	せいれき	seireki
奴等	やつら	yatsura
眠れる	ねむれる	nemureru
波紋	はもん	hamonn
波及	はきゅう	hakyuu
逃れる	のがれる	nogareru
濁る	にごる	nigoru
毛髪	もうはつ	mouhatsu
致死	ちし	chishi
息抜き	いきぬき	ikinuki
壁画	へきが	hekiga
薄型	うすがた	usugata
躍動	やくどう	yakudou
発砲	はっぽう	happou
拠出	きょしゅつ	kyoshutsu
弾ける	はじける|ひける	hajikeru|hikeru
尋問	じんもん	jinnmonn
離職	りしょく	rishoku
三脚	さんきゃく	sannkyaku
即興	そっきょう	sokkyou
漁獲	ぎょかく	gyokaku
寝坊	ねぼう	nebou
珍味	ちんみ	chinnmi
突き進む	つきすすむ	tsukisusumu
踊り子	おどりこ	odoriko
途絶える	とだえる	todaeru
居眠り	いねむり	inemuri
咲き誇る	さきほこる	sakihokoru
抱負	ほうふ	houfu
誤爆	ごばく	gobaku
見込める	みこめる	mikomeru
模範	もはん	mohann
躍る	おどる	odoru
空欄	くうらん	kuurann
社殿	しゃでん	shadenn
失恋	しつれん	shitsurenn
住み替える	すみかえる	sumikaeru
脱水	だっすい	dassui
茂る	しげる	shigeru
再販	さいはん	saihann
富豪	ふごう	fugou
押印	おういん	ouinn
突っ走る	つっぱしる	tsuppashiru
微小	びしょう	bishou
隠れる	かくれる	kakureru
新鋭	しんえい	shinnei
兼用	けんよう	kennyou
即売	そくばい	sokubai
手渡す	てわたす	tewatasu
切り抜き	きりぬき	kirinuki
防波堤	ぼうはてい	bouhatei
繰り出す	くりだす	kuridasu
噴射	ふんしゃ	funnsha
即死	そくし	sokushi
床屋	とこや	tokoya
油脂	ゆし	yushi
騒がせる	さわがせる	sawagaseru
鳴り響く	なりひびく	narihibiku
盆地	ぼんち	bonnchi
偉人	いじん	ijinn
不眠	ふみん	fuminn
語尾	ごび	gobi
突き出し	つきだし	tsukidashi
交替	こうたい	koutai
瞬く	しばたく|しばたたく|またたく|まばたく	shibataku|shibatataku|matataku|mabataku
舞い上がる	まいあがる	maiagaru
盗み	ぬすみ	nusumi
組み込み	くみこみ	kumikomi
稲作	いなさく	inasaku
歳時記	さいじき	saijiki
差し替え	さしかえ	sashikae
追撃	ついげき	tsuigeki
突き刺さる	つきささる	tsukisasaru
出遅れ	でおくれ|でおくれれ	deokure|deokurere
端的	たんてき	tannteki
彩色	さいしき|さいしょく	saishiki|saishoku
抵当	ていとう	teitou
浮かれる	うかれる	ukareru
執念	しゅうねん|しゅうね	shuunenn|shuune
侵す	おかす	okasu
拍車	はくしゃ	hakusha
御用達	ごようたし|ごようたつ	goyoutashi|goyoutatsu
木陰	こかげ	kokage
結露	けつろ	ketsuro
溶剤	ようざい	youzai
決闘	けっとう	kettou
吹き替え	ふきかえ	fukikae
被せる	かぶせる	kabuseru
儀礼	ぎれい	girei
払込	はらいこみ|はらいこめ	haraikomi|haraikome
白髪染め	しらがぞめ	shiragazome
入れ替わり	いれかわり	irekawari
引き抜く	ひきぬく	hikinuku
微分	びぶん	bibunn
鉄塔	てっとう	tettou
敷設	ふせつ	fusetsu
注釈	ちゅうしゃく	tyuushaku
越冬	えっとう	ettou
砲撃	ほうげき	hougeki
素泊まり	すどまり	sudomari
弾き語り	ひきがたり	hikigatari
仰向け	あおむけ	aomuke
乾き	かわき|がわき	kawaki|gawaki
仰天	ぎょうてん	gyoutenn
描き出す	えがきだす	egakidasu
暗黙	あんもく	annmoku
取扱う	とりあつかう|とりあつこう	toriatsukau|toriatsukou
押し出し	おしだし	oshidashi
供与	きょうよ	kyouyo
噴く	ふく	fuku
備蓄	びちく	bichiku
鳥獣	ちょうじゅう|とりけだもの	tyoujuu|torikedamono
惨め	みじめ	mijime
踏み入る	ふみいる	fumiiru
端数	はすう	hasuu
抜歯	ばっし	basshi
広範	こうはん	kouhann
熱烈	ねつれつ	netsuretsu
堅調	けんちょう	kenntyou
遅ればせながら	おくればせながら	okurebasenagara
優越	ゆうえつ	yuuetsu
精鋭	せいえい	seiei
恐る恐る	おそるおそる	osoruosoru
吹き飛ぶ	ふきとぶ	fukitobu
投げ込む	なげこむ	nagekomu
堅実	けんじつ	kennjitsu
耐火	たいか	taika
世襲	せしゅう	seshuu
吐息	といき	toiki
稲刈り	いねかり	inekari
水滴	すいてき	suiteki
遅らせる	おくらせる	okuraseru
詰める	つめる|づめる	tsumeru|dumeru
繰り出し	くりだし	kuridashi
資金繰り	しきんぐり	shikinnguri
襲いかかる	おそいかかる	osoikakaru
車載	しゃさい	shasai
沈下	ちんか	chinnka
切り込む	きりこむ	kirikomu
お座敷	おざしき	ozashiki
離陸	りりく	ririku
引き継ぎ	ひきつぎ	hikitsugi
心拍	しんぱく	shinnpaku
打倒	だとう	datou
駆け引き	かけひき	kakehiki
占星術	せんせいじゅつ	sennseijutsu
追い越し	おいこし	oikoshi
感嘆	かんたん	kanntann
語り継ぐ	かたりつぐ	kataritsugu
溶ける	とける	tokeru
手遅れ	ておくれ	teokure
徴兵	ちょうへい	tyouhei
更正	こうせい	kousei
縁側	えんがわ	enngawa
固執	こしつ|こしゅう	koshitsu|koshuu
繰る	くる|ぐる	kuru|guru
色濃い	いろこい	irokoi
大忙し	おおいそがし	ooisogashi
気遣う	きづかう|きずこう	kidukau|kizukou
振舞う	ふるまう|ふるもう	furumau|furumou
乱舞	らんぶ|らっぷ	rannbu|rappu
甘酸っぱい	あまずっぱい	amazuppai
冷え込む	ひえこむ	hiekomu
貴殿	きでん	kidenn
追い込み	おいこみ	oikomi
汗だく	あせだく	asedaku
軒並み	のきなみ	nokinami
汚職	おしょく	oshoku
読み替える	よみかえる	yomikaeru
微粒子	びりゅうし	biryuushi
脱帽	だつぼう	datsubou
傷跡	きずあと	kizuato
奇麗	きれい|ぎれい	kirei|girei
劣等	れっとう	rettou
幾分	いくぶん	ikubunn
冷え込み	ひえこみ	hiekomi
考え込む	かんがえこむ	kanngaekomu
互角	ごかく	gokaku
空振り	からぶり	karaburi
円盤	えんばん	ennbann
腕前	うでまえ	udemae
執り行う	とりおこなう|とりおこのう	toriokonau|toriokonou
触れ合う	ふれあう|ふれおう	fureau|fureou
親御	おやご	oyago
奇襲	きしゅう	kishuu
着払い	ちゃくばらい	tyakubarai
抵触	ていしょく	teishoku
腐れ	くされ|ぐされ|くたれ	kusare|gusare|kutare
手腕	しゅわん	shuwann
脱皮	だっぴ	dappi
搬出	はんしゅつ	hannshutsu
切り離し	きりはなし	kirihanashi
刺客	しかく|しきゃく|せっかく	shikaku|shikyaku|sekkaku
振り切る	ふりきる	furikiru
敬称	けいしょう	keishou
縁結び	えんむすび	ennmusubi
不詳	ふしょう	fushou
冬眠	とうみん	touminn
勝ち越し	かちこし	kachikoshi
公序良俗	こうじょりょうぞく	koujoryouzoku
爆音	ばくおん	bakuonn
頼める	たのめる	tanomeru
魚雷	ぎょらい	gyorai
生鮮	せいせん	seisenn
城壁	じょうへき	jouheki
詰合せ	つめあわせ	tsumeawase
汚水	おすい	osui
絡み合う	からみあう|からみおう	karamiau|karamiou
人為	じんい	jinni
素振り	そぶり|すぶり	soburi|suburi
違憲	いけん	ikenn
頼れる	たよれる	tayoreru
執る	とる|どる	toru|doru
直販	ちょくはん	tyokuhann
端っこ	はしっこ|はじっこ	hashikko|hajikko
老齢	ろうれい	rourei
下敷き	したじき	shitajiki
一躍	いちやく	ichiyaku
振り込める	ふりこめる	furikomeru
物販	ぶっぱん	buppann
坊ちゃん	ぼっちゃん	bottyann
拝殿	はいでん	haidenn
里芋	さといも	satoimo
甘やかす	あまやかす	amayakasu
弾道	だんどう	danndou
左端	ひだりはし|さたん	hidarihashi|satann
逃げ切る	にげきる	nigekiru
援軍	えんぐん	enngunn
砂丘	さきゅう|しゃきゅう	sakyuu|shakyuu
召集	しょうしゅう	shoushuu
継ぎ	つぎ	tsugi
積載	せきさい	sekisai
寝起き	ねおき	neoki
祝儀	しゅうぎ|しゅくぎ	shuugi|shukugi
与野党	よやとう	yoyatou
思い描く	おもいえがく	omoiegaku
輝かしい	かがやかしい	kagayakashii
目隠し	めかくし	mekakushi
兼任	けんにん	kennninn
隣国	りんごく	rinngoku
雑煮	ぞうに	zouni
寝床	ねどこ	nedoko
短絡	たんらく	tannraku
引き離す	ひきはなす	hikihanasu
震わせる	ふるわせる	furuwaseru
引っ越す	ひっこす	hikkosu
剣術	けんじゅつ	kennjutsu
婚礼	こんれい	konnrei
意気込む	いきごむ	ikigomu
寝込む	ねこむ	nekomu
沈着	ちんちゃく	chinntyaku
取替える	とりかえる	torikaeru
手触り	てざわり	tezawari
縁日	えんにち	ennnichi
突き抜ける	つきぬける	tsukinukeru
目白押し	めじろおし	mejirooshi
敷き詰める	しきつめる	shikitsumeru
草刈り	くさかり	kusakari
進撃	しんげき	shinngeki
振る舞う	ふるまう|ふるもう	furumau|furumou
本稿	ほんこう	honnkou
近距離	きんきょり	kinnkyori
巨木	きょぼく	kyoboku
叫び声	さけびごえ	sakebigoe
池沼	ちしょう	chishou
麗しい	うるわしい	uruwashii
称え	となえ|たたえ|かなえ	tonae|tatae|kanae
問い詰める	といつめる	toitsumeru
煮付け	につけ	nitsuke
寝返り	ねがえり	negaeri
弾み	はずみ	hazumi
追い払う	おいはらう|おいはろう	oiharau|oiharou
戒め	いましめ	imashime
振り付け	ふりつけ	furitsuke
撃てる	うてる	uteru
暇人	ひまじん	himajinn
即刻	そっこく	sokkoku
鈍感	どんかん	donnkann
小紋	こもん	komonn
溶く	とく	toku
更かす	ふかす	fukasu
駆け込み	かけこみ	kakekomi
押入る	おしいる	oshiiru
線維	せんい	senni
豪族	ごうぞく	gouzoku
威圧	いあつ	iatsu
涙す	なみだす	namidasu
彼女ら	かのじょら	kanojora
寝言	ねごと	negoto
復縁	ふくえん	fukuenn
坊や	ぼうや	bouya
図柄	ずがら	zugara
更衣	こうい|ころもがえ	koui|koromogae
振り分け	ふりわけ	furiwake
傍観	ぼうかん	boukann
染み込む	しみこむ	shimikomu
小惑星	しょうわくせい	shouwakusei
逃げ込む	にげこむ	nigekomu
甘口	あまくち	amakuchi
見え隠れ	みえかくれ|みえがくれ	miekakure|miegakure
難儀	なんぎ	nanngi
威張る	いばる|えばる	ibaru|ebaru
折り畳む	おりたたむ	oritatamu
食いしん坊	くいしんぼう|くいしんぼ	kuishinnbou|kuishinnbo
栄誉	えいよ	eiyo
甘酒	あまざけ	amazake
手描き	てがき	tegaki
障壁	しょうへき	shouheki
送り込む	おくりこむ	okurikomu
乗り継ぐ	のりつぐ	noritsugu
薄切り	うすぎり	usugiri
役柄	やくがら	yakugara
普段着	ふだんぎ	fudanngi
咲き乱れる	さきみだれる	sakimidareru
追突	ついとつ	tsuitotsu
侵食	しんしょく	shinnshoku
浮き上がる	うきあがる	ukiagaru
被疑	ひぎ	higi
急斜面	きゅうしゃめん	kyuushamenn
落雷	らくらい	rakurai
血縁	けつえん	ketsuenn
踏襲	とうしゅう	toushuu
心遣い	こころづかい	kokorodukai
威厳	いげん	igenn
突き放す	つきはなす	tsukihanasu
駆け込む	かけこむ	kakekomu
奥歯	おくば	okuba
冷や汗	ひやあせ	hiyaase
水稲	すいとう	suitou
足腰	あしこし	ashikoshi
燃え尽きる	もえつきる	moetsukiru
悩ましい	なやましい	nayamashii
割り込み	わりこみ	warikomi
眠たい	ねむたい|ねぶたい	nemutai|nebutai
箇条	かじょう	kajou
抗原	こうげん	kougenn
凶暴	きょうぼう	kyoubou
鈍る	なまる|にぶる	namaru|niburu
すり抜ける	すりぬける	surinukeru
死闘	しとう	shitou
片っ端	かたっぱし	katappashi
突き刺す	つきさす	tsukisasu
時代遅れ	じだいおくれ	jidaiokure
入れ替える	いれかえる	irekaeru
恥ずかしながら	はずかしながら	hazukashinagara
奥底	おくそこ	okusoko
到る	いたる	itaru
追い抜く	おいぬく	oinuku
盛り沢山	もりだくさん	moridakusann
水溶	すいよう	suiyou
押し切る	おしきる	oshikiru
仰せ	おおせ	oose
脱がす	ぬがす	nugasu
折込	おりこみ|おりこめ	orikomi|orikome
凶器	きょうき	kyouki
刺青	いれずみ|しせい	irezumi|shisei
駆け出し	かけだし	kakedashi
抱き合う	だきあう|だきおう	dakiau|dakiou
一人称	いちにんしょう	ichininnshou
鑑みる	かんがみる	kanngamiru
大奥	おおおく	oooku
前倒し	まえだおし	maedaoshi
寝ぼけ	ねぼけ	neboke
招致	しょうち	shouchi
陣痛	じんつう	jinntsuu
繁忙	はんぼう	hannbou
内需	ないじゅ	naiju
服飾	ふくしょく	fukushoku
着脱	ちゃくだつ	tyakudatsu
小粒	こつぶ	kotsubu
切り離す	きりはなす	kirihanasu
気迫	きはく	kihaku
誇張	こちょう	kotyou
防腐	ぼうふ	boufu
作為	さくい	sakui
空爆	くうばく	kuubaku
惨事	さんじ	sannji
猛毒	もうどく	moudoku
舌鼓	したつづみ	shitatsudumi
二の腕	にのうで	ninoude
大御所	おおごしょ	oogosho
勝ち抜く	かちぬく	kachinuku
注ぎ込む	そそぎこむ|つぎこむ	sosogikomu|tsugikomu
演舞	えんぶ	ennbu
同姓	どうせい	dousei
抱え込む	かかえこむ	kakaekomu
即席	そくせき	sokuseki
行儀	ぎょうぎ	gyougi
引継ぎ	ひきつぎ	hikitsugi
誇れる	ほこれる	hokoreru
額縁	がくぶち	gakubuchi
拠る	よる	yoru
煮詰める	につめる	nitsumeru
力尽きる	ちからつきる	chikaratsukiru
攻め込む	せめこむ	semekomu
滴る	したたる	shitataru
元凶	げんきょう	gennkyou
雷雨	らいう	raiu
療育	りょういく	ryouiku
巡視	じゅんし	junnshi
捕食	ほしょく	hoshoku
刀剣	とうけん	toukenn
添う	そう|ぞう	sou|zou
形跡	けいせき	keiseki
芽吹く	めぶく	mebuku
絡まる	からまる	karamaru
奇形	きけい	kikei
販路	はんろ	hannro
盗作	とうさく	tousaku
水溶液	すいようえき	suiyoueki
未払い	みはらい	miharai
押し上げ	おしあげ	oshiage
抜け出せる	ぬけだせる	nukedaseru
使途	しと	shito
襲来	しゅうらい	shuurai
受け渡し	うけわたし	ukewatashi
威勢	いせい	isei
触発	しょくはつ	shokuhatsu
恐く	きょうく|こわく	kyouku|kowaku
造影	ぞうえい	zouei
悪戦苦闘	あくせんくとう	akusennkutou
乾電池	かんでんち	kanndennchi
発汗	はっかん	hakkann
吹ける	ふける	fukeru
一滴	いってき	itteki
希釈	きしゃく	kishaku
模様替え	もようがえ	moyougae
踏み切り	ふみきり	fumikiri
中継ぎ	なかつぎ	nakatsugi
ひき逃げ	ひきにげ	hikinige
報道陣	ほうどうじん	houdoujinn
恋心	こいごころ	koigokoro
偉業	いぎょう	igyou
張り替える	はりかえる	harikaeru
気兼ね	きがね	kigane
最南端	さいなんたん	sainanntann
弾薬	だんやく	dannyaku
凡例	はんれい	hannrei
陰性	いんせい	innsei
輝度	きど	kido
修飾	しゅうしょく	shuushoku
狩場	かりば	kariba
短距離	たんきょり	tannkyori
押し倒す	おしたおす	oshitaosu
共闘	きょうとう	kyoutou
流し込む	ながしこむ	nagashikomu
お陰様	おかげさま	okagesama
金網	かなあみ	kanaami
執務	しつむ	shitsumu
持ち越し	もちこし	mochikoshi
寝顔	ねがお	negao
柔術	じゅうじゅつ	juujutsu
濁す	にごす	nigosu
押しかける	おしかける	oshikakeru
生い茂る	おいしげる	oishigeru
薄手	うすで	usude
付き添い	つきそい	tsukisoi
脚光	きゃっこう	kyakkou
響かせる	ひびかせる	hibikaseru
余暇	よか	yoka
握りしめる	にぎりしめる	nigirishimeru
掘り出し物	ほりだしもの	horidashimono
五十肩	ごじゅうかた	gojuukata
幾多	いくた	ikuta
突き上げる	つきあげる	tsukiageru
流儀	りゅうぎ	ryuugi
帰途	きと	kito
お辞儀	おじぎ	ojigi
潮干狩り	しおひがり	shiohigari
白濁	はくだく	hakudaku
張替え	はりかえ	harikae
監事	かんじ	kannji
汚物	おぶつ	obutsu
渡米	とべい	tobei
散髪	さんぱつ	sannpatsu
幅広	はばひろ|はばびろ	habahiro|hababiro
分割払い	ぶんかつばらい	bunnkatsubarai
布陣	ふじん	fujinn
濃密	のうみつ	noumitsu
緯度	いど	ido
脱す	だっす	dassu
食い込む	くいこむ	kuikomu
触れ合い	ふれあい	fureai
耐用	たいよう	taiyou
吹き荒れる	ふきあれる	fukiareru
退陣	たいじん	taijinn
見越し	みこし	mikoshi
吹き付ける	ふきつける	fukitsukeru
先払い	さきばらい	sakibarai
狂人	きょうじん	kyoujinn
押収	おうしゅう	oushuu
替り	かわり|がわり	kawari|gawari
乗り遅れ	のりおくれ	noriokure
南端	なんたん	nanntann
離党	りとう	ritou
振り上げる	ふりあげる	furiageru
見込	みこみ	mikomi
我輩	わがはい	wagahai
押さえつける	おさえつける	osaetsukeru
不可抗力	ふかこうりょく	fukakouryoku
陣地	じんち	jinnchi
前途	ぜんと	zennto
つぎ込む	つぎこむ	tsugikomu
泊める	とめる	tomeru
賦課	ふか	fuka
独り占め	ひとりじめ	hitorijime
優劣	ゆうれつ	yuuretsu
引っ込む	ひっこむ	hikkomu
鑑別	かんべつ	kannbetsu
透かし	すかし	sukashi
陣取る	じんどる	jinndoru
渡船	とせん	tosenn
薄っぺら	うすっぺら	usuppera
忘却	ぼうきゃく	boukyaku
香味	こうみ	koumi
赤帽	あかぼう	akabou
突き止める	つきとめる	tsukitomeru
堅持	けんじ	kennji
衣替え	ころもがえ	koromogae
透視	とうし	toushi
ぶち壊す	ぶちこわす	buchikowasu
乱闘	らんとう	ranntou
兼務	けんむ	kennmu
背丈	せたけ	setake
浮かせる	うかせる	ukaseru
罰する	ばっする	bassuru
沈殿	ちんでん	chinndenn
場違い	ばちがい	bachigai
押し出す	おしだす	oshidasu
振り払う	ふりはらう|ふりはろう	furiharau|furiharou
圏外	けんがい	kenngai
見詰める	みつめる	mitsumeru
御大	おんたい	onntai
掘り出し	ほりだし	horidashi
物騒	ぶっそう	bussou
皆殺し	みなごろし	minagoroshi
干拓	かんたく	kanntaku
即答	そくとう	sokutou
却って	かえって	kaette
脱字	だつじ	datsuji
継手	つぎて	tsugite
畳む	たたむ|だたむ	tatamu|datamu
傍点	ぼうてん	boutenn
汚す	けがす|よごす	kegasu|yogosu
共振	きょうしん	kyoushinn
襲名	しゅうめい	shuumei
詰め込み	つめこみ	tsumekomi
光り輝く	ひかりかがやく	hikarikagayaku
万歳	ばんざい|まんざい	bannzai|mannzai
豪雪	ごうせつ	gousetsu
近傍	きんぼう	kinnbou
快眠	かいみん	kaiminn
渡り鳥	わたりどり	wataridori
闘志	とうし	toushi
朽ちる	くちる	kuchiru
拍子抜け	ひょうしぬけ	hyoushinuke
飛び越える	とびこえる	tobikoeru
寝かす	ねかす	nekasu
交尾	こうび	koubi
強迫	きょうはく	kyouhaku
掘り起こし	ほりおこし	horiokoshi
噴霧	ふんむ	funnmu
煮干	にぼし	niboshi
焼き芋	やきいも	yakiimo
倒木	とうぼく	touboku
頭髪	とうはつ	touhatsu
道幅	みちはば	michihaba
丹精	たんせい	tannsei
獲る	える|とる|どる|うる	eru|toru|doru|uru
間柄	あいだがら	aidagara
彼岸花	ひがんばな	higannbana
遣う	つかう|づかう|つこう	tsukau|dukau|tsukou
扱える	あつかえる	atsukaeru
折り込み	おりこみ	orikomi
五重塔	ごじゅうのとう	gojuunotou
沖合	おきあい	okiai
寂れる	さびれる	sabireru
見舞	みまい	mimai
黙示録	もくしろく	mokushiroku
繰越	くりこし	kurikoshi
黙認	もくにん	mokuninn
奇抜	きばつ	kibatsu
鎖国	さこく	sakoku
惨状	さんじょう	sannjou
本拠	ほんきょ	honnkyo
橋脚	きょうきゃく	kyoukyaku
軽微	けいび	keibi
山芋	やまいも|やまのいも	yamaimo|yamanoimo
次項	じこう	jikou
屈し	くっし	kusshi
安眠	あんみん	annminn
足踏み	あしぶみ|あしふみ	ashibumi|ashifumi
ぶち込む	ぶちこむ	buchikomu
付け替える	つけかえる	tsukekaeru
狂犬病	きょうけんびょう	kyoukennbyou
攻守	こうしゅ	koushu
冒す	おかす	okasu
弾幕	だんまく	dannmaku
砲台	ほうだい	houdai
切り抜ける	きりぬける	kirinukeru
奇数	きすう	kisuu
詰め寄る	つめよる	tsumeyoru
汗ばむ	あせばむ	asebamu
行脚	あんぎゃ	anngya
更ける	ふける	fukeru
兼業	けんぎょう	kenngyou
突き当たる	つきあたる	tsukiataru
早寝	はやね	hayane
世俗	せぞく	sezoku
渡せる	わたせる	wataseru
繰り上げる	くりあげる	kuriageru
特攻隊	とっこうたい	tokkoutai
被験者	ひけんしゃ	hikennsha
泣き叫ぶ	なきさけぶ	nakisakebu
振りかぶる	ふりかぶる	furikaburu
抜き出す	ぬきだす	nukidasu
行き渡る	いきわたる|ゆきわたる	ikiwataru|yukiwataru
振付	ふりつけ	furitsuke
突風	とっぷう	toppuu
押さえ込む	おさえこむ	osaekomu
跳ね上がる	はねあがる	haneagaru
踏み台	ふみだい	fumidai
荒波	あらなみ	aranami
踏みにじる	ふみにじる	fuminijiru
致し方	いたしかた	itashikata
小幅	こはば	kohaba
差し込み	さしこみ	sashikomi
売り込み	うりこみ	urikomi
身柄	みがら	migara
差し押さえ	さしおさえ	sashiosae
鮮烈	せんれつ	sennretsu
端午	たんご	tanngo
伺える	うかがえる	ukagaeru
損壊	そんかい	sonnkai
避暑	ひしょ	hisho
甘んじる	あまんじる	amannjiru
砲弾	ほうだん	houdann
路肩	ろかた	rokata
万端	ばんたん	banntann
敗訴	はいそ	haiso
名鑑	めいかん	meikann
甘えん坊	あまえんぼう|あまえんぼ	amaennbou|amaennbo
堅苦しい	かたくるしい	katakurushii
駆け足	かけあし	kakeashi
脚色	きゃくしょく	kyakushoku
別姓	べっせい	bessei
釈明	しゃくめい	shakumei
戒名	かいみょう	kaimyou
騒然	そうぜん	souzenn
替え歌	かえうた	kaeuta
駆け回る	かけまわる	kakemawaru
追い越す	おいこす	oikosu
長髪	ちょうはつ	tyouhatsu
突き落とす	つきおとす	tsukiotosu
逃げ回る	にげまわる	nigemawaru
腕輪	うでわ	udewa
停泊	ていはく	teihaku
野獣	やじゅう	yajuu
拡幅	かくふく	kakufuku
跳躍	ちょうやく	tyouyaku
勝訴	しょうそ	shouso
歓送	かんそう	kannsou
雌雄	しゆう	shiyuu
乾物	かんぶつ|ひもの|ほしもの	kannbutsu|himono|hoshimono
確執	かくしつ	kakushitsu
退避	たいひ	taihi
鬼門	きもん	kimonn
劣悪	れつあく	retsuaku
押し花	おしばな	oshibana
先般	せんぱん	sennpann
お召	おめし	omeshi
噴き出す	ふきだす	fukidasu
仕舞い	しまい|じまい	shimai|jimai
甘える	あまえる	amaeru
組込み	くみこみ	kumikomi
着替える	きがえる|きかえる	kigaeru|kikaeru
連れ込む	つれこむ	tsurekomu
突然変異	とつぜんへんい	totsuzennhenni
風刺	ふうし	fuushi
立ち尽くす	たちつくす	tachitsukusu
気鋭	きえい	kiei
過渡	かと	kato
満杯	まんぱい	mannpai
短剣	たんけん	tannkenn
言い渡す	いいわたす	iiwatasu
鎖骨	さこつ	sakotsu
澄ます	すます	sumasu
汚損	おそん	osonn
走り抜ける	はしりぬける	hashirinukeru
突き出る	つきでる	tsukideru
恵方	えほう	ehou
律儀	りちぎ	richigi
被弾	ひだん	hidann
理髪	りはつ	rihatsu
惨劇	さんげき	sanngeki
詰め替える	つめかえる	tsumekaeru
朱色	しゅいろ	shuiro
縁組	えんぐみ	enngumi
家柄	いえがら	iegara
付き添う	つきそう	tsukisou
微熱	びねつ	binetsu
追憶	ついおく	tsuioku
較べる	くらべる	kuraberu
踏みつける	ふみつける	fumitsukeru
床の間	とこのま	tokonoma
陰影	いんえい	innei
激闘	げきとう	gekitou
瞬き	まばたき|しばたき|しばたたき|またたき	mabataki|shibataki|shibatataki|matataki
取り込める	とりこめる	torikomeru
尽す	つくす|づくす	tsukusu|dukusu
縁起物	えんぎもの	enngimono
優柔不断	ゆうじゅうふだん	yuujuufudann
体罰	たいばつ	taibatsu
抗う	あらがう|あらごう	aragau|aragou
脈絡	みゃくらく	myakuraku
軒先	のきさき	nokisaki
振り子	ふりこ	furiko
参与	さんよ	sannyo
傾斜地	けいしゃち	keishachi
歓談	かんだん	kanndann
品薄	しなうす	shinausu
介在	かいざい	kaizai
鋭意	えいい	eii
汚濁	おだく|おじょく	odaku|ojoku
舞い降りる	まいおりる	maioriru
行き詰まる	いきづまる|ゆきづまる|いきつまる	ikidumaru|yukidumaru|ikitsumaru
文豪	ぶんごう	bunngou
押しつぶす	おしつぶす	oshitsubusu
馬刺し	ばさし	basashi
添い寝	そいね	soine
切迫	せっぱく	seppaku
突っ張る	つっぱる	tsupparu
会釈	えしゃく	eshaku
失脚	しっきゃく	shikkyaku
猛者	もさ	mosa
主砲	しゅほう	shuhou
煮える	にえる	nieru
諸般	しょはん	shohann
決め込む	きめこむ	kimekomu
振りまく	ふりまく	furimaku
暗躍	あんやく	annyaku
振り替え	ふりかえ	furikae
枯葉	かれは	kareha
雷神	らいじん	raijinn
御存知	ごぞんじ	gozonnji
油彩	ゆさい	yusai
突き詰める	つきつめる	tsukitsumeru
すり替え	すりかえ	surikae
駆け付ける	かけつける	kaketsukeru
言い渡し	いいわたし	iiwatashi
寝転がる	ねころがる	nekorogaru
引き渡す	ひきわたす	hikiwatasu
奥の院	おくのいん	okunoinn
最北端	さいほくたん	saihokutann
一般的	いっぱんてき	ippannteki
高齢者	こうれいしゃ	koureisha
被害者	ひがいしゃ	higaisha
投稿者	とうこうしゃ	toukousha
一杯	いっぱい	ippai
朝鮮人	ちょうせんじん	tyousennjinn
販売店	はんばいてん	hannbaitenn
連絡先	れんらくさき	rennrakusaki
首都圏	しゅとけん	shutokenn
医療費	いりょうひ	iryouhi
皮膚科	ひふか	hifuka
敷地内	しきちない	shikichinai
漫画家	まんがか	manngaka
信頼性	しんらいせい	shinnraisei
高齢化	こうれいか	koureika
無添加	むてんか	mutennka
耐久性	たいきゅうせい	taikyuusei
継続的	けいぞくてき	keizokuteki
好奇心	こうきしん	koukishinn
同項	どうこう	doukou
活躍中	かつやくちゅう	katsuyakutyuu
戦闘機	せんとうき	senntouki
攻撃力	こうげきりょく	kougekiryoku
影響力	えいきょうりょく	eikyouryoku
被保険者	ひほけんしゃ	hihokennsha
特徴的	とくちょうてき	tokutyouteki
申込書	もうしこみしょ	moushikomisho
後継者	こうけいしゃ	koukeisha
魚介類	ぎょかいるい	gyokairui
途上国	とじょうこく	tojoukoku
応援団	おうえんだん	ouenndann
販売中	はんばいちゅう	hannbaityuu
添加物	てんかぶつ	tennkabutsu
加齢	かれい	karei
必需品	ひつじゅひん	hitsujuhinn
婚活	こんかつ	konnkatsu
接着剤	せっちゃくざい	settyakuzai
乾燥機	かんそうき	kannsouki
量販店	りょうはんてん	ryouhanntenn
被告人	ひこくにん	hikokuninn
透明感	とうめいかん	toumeikann
致命的	ちめいてき	chimeiteki
交響曲	こうきょうきょく	koukyoukyoku
後援会	こうえんかい	kouennkai
記入欄	きにゅうらん	kinyuurann
避難所	ひなんじょ	hinannjo
岩盤浴	がんばんよく	gannbannyoku
販売機	はんばいき	hannbaiki
涙目	なみだめ	namidame
日露	にちろ	nichiro
要介護	ようかいご	youkaigo
療法士	りょうほうし	ryouhoushi
年齢層	ねんれいそう	nennreisou
紹介状	しょうかいじょう	shoukaijou
体脂肪	たいしぼう	taishibou
証拠金	しょうこきん	shoukokinn
項中	こうちゅう	koutyuu
老朽化	ろうきゅうか	roukyuuka
治療薬	ちりょうやく	chiryouyaku
透明度	とうめいど	toumeido
被災者	ひさいしゃ	hisaisha
冒険者	ぼうけんしゃ	boukennsha
飛躍的	ひやくてき	hiyakuteki
何歳	なんさい	nannsai
一粒	ひとつぶ	hitotsubu
執行部	しっこうぶ	shikkoubu
監査役	かんさやく	kannsayaku
二十歳	はたち	hatachi
連載中	れんさいちゅう	rennsaityuu
爆発的	ばくはつてき	bakuhatsuteki
抜本的	ばっぽんてき	bapponnteki
両腕	りょううで	ryouude
攻撃的	こうげきてき	kougekiteki
状況下	じょうきょうか	joukyouka
実店舗	じつてんぽ	jitsutennpo
添乗員	てんじょういん	tennjouinn
驚異的	きょういてき	kyouiteki
備考欄	びこうらん	bikourann
刺激的	しげきてき	shigekiteki
記憶力	きおくりょく	kiokuryoku
脚本家	きゃくほんか	kyakuhonnka
晩御飯	ばんごはん	banngohann
含有量	がんゆうりょう	gannyuuryou
抗酸化	こうさんか	kousannka
被災地	ひさいち	hisaichi
入浴剤	にゅうよくざい	nyuuyokuzai
奇跡的	きせきてき	kisekiteki
連絡会	れんらくかい	rennrakukai
治療費	ちりょうひ	chiryouhi
支援者	しえんしゃ	shiennsha
大冒険	だいぼうけん	daiboukenn
歌謡曲	かようきょく	kayoukyoku
花柄	はながら	hanagara
優秀賞	ゆうしゅうしょう	yuushuushou
被爆者	ひばくしゃ	hibakusha
変更点	へんこうてん	hennkoutenn
振興会	しんこうかい	shinnkoukai
連泊	れんぱく	rennpaku
執筆者	しっぴつしゃ	shippitsusha
床面積	ゆかめんせき	yukamennseki
婚約者	こんやくしゃ	konnyakusha
全般的	ぜんぱんてき	zennpannteki
殺虫剤	さっちゅうざい	sattyuuzai
破壊力	はかいりょく	hakairyoku
象徴的	しょうちょうてき	shoutyouteki
介護者	かいごしゃ	kaigosha
医療用	いりょうよう	iryouyou
美脚	びきゃく	bikyaku
透明性	とうめいせい	toumeisei
信頼度	しんらいど	shinnraido
支援法	しえんほう	shiennhou
更新日	こうしんび	koushinnbi
環状線	かんじょうせん	kannjousenn
距離感	きょりかん	kyorikann
幾何学	きかがく	kikagaku
皮膚病	ひふびょう	hifubyou
維持費	いじひ	ijihi
販売者	はんばいしゃ	hannbaisha
活性剤	かっせいざい	kasseizai
入稿	にゅうこう	nyuukou
和太鼓	わだいこ	wadaiko
派遣先	はけんさき	hakennsaki
取扱店	とりあつかいてん	toriatsukaitenn
玄関先	げんかんさき	gennkannsaki
一般道	いっぱんどう	ippanndou
普通科	ふつうか	futsuuka
慢性的	まんせいてき	mannseiteki
握手会	あくしゅかい	akushukai
熱狂的	ねっきょうてき	nekkyouteki
人為的	じんいてき	jinniteki
隣町	となりまち	tonarimachi
攻略本	こうりゃくぼん	kouryakubonn
抵抗力	ていこうりょく	teikouryoku
水溶性	すいようせい	suiyousei
育毛剤	いくもうざい	ikumouzai
被疑者	ひぎしゃ	higisha
申込者	もうしこみしゃ	moushikomisha
角煮	かくに	kakuni
抵当権	ていとうけん	teitoukenn
信頼感	しんらいかん	shinnraikann
到着日	とうちゃくび	toutyakubi
不起訴	ふきそ	fukiso
普通車	ふつうしゃ	futsuusha
応援歌	おうえんか	ouennka
戦闘中	せんとうちゅう	senntoutyuu
格闘家	かくとうか	kakutouka
即戦力	そくせんりょく	sokusennryoku
歓迎会	かんげいかい	kanngeikai
年齢的	ねんれいてき	nennreiteki
先駆者	せんくしゃ	sennkusha
販売業	はんばいぎょう	hannbaigyou
贈答用	ぞうとうよう	zoutouyou
販売所	はんばいしょ	hannbaisho
持込	もちこめ	mochikome
最後尾	さいこうび	saikoubi
贈答品	ぞうとうひん	zoutouhinn
大先輩	だいせんぱい	daisennpai
宿泊先	しゅくはくさき	shukuhakusaki
依存性	いぞんせい	izonnsei
脱衣所	だついじょ	datsuijo
恐怖心	きょうふしん	kyoufushinn
名盤	めいばん	meibann
抵抗性	ていこうせい	teikousei
半透明	はんとうめい	hanntoumei
優越感	ゆうえつかん	yuuetsukann
目撃者	もくげきしゃ	mokugekisha
本剤	ほんざい	honnzai
和柄	わがら	wagara
除草剤	じょそうざい	josouzai
警戒心	けいかいしん	keikaishinn
水彩画	すいさいが	suisaiga
更衣室	こういしつ	kouishitsu
介護職	かいごしょく	kaigoshoku
都市圏	としけん	toshikenn
薄味	うすあじ	usuaji
販売員	はんばいいん	hannbaiinn
劣等感	れっとうかん	rettoukann
爆撃機	ばくげきき	bakugekiki
鑑定士	かんていし	kannteishi
戦闘力	せんとうりょく	senntouryoku
結婚後	けっこんご	kekkonngo
宿泊客	しゅくはくきゃく	shukuhakukyaku
端部	たんぶ	tannbu
民俗学	みんぞくがく	minnzokugaku
更新料	こうしんりょう	koushinnryou
療養費	りょうようひ	ryouyouhi
大富豪	だいふごう	daifugou
疲労感	ひろうかん	hiroukann
高脂	こうし	koushi
奥深	おくふか|おくぶか	okufuka|okubuka
占用	せんよう	sennyou
違法性	いほうせい	ihousei
耐震性	たいしんせい	taishinnsei
装飾品	そうしょくひん	soushokuhinn
関西圏	かんさいけん	kannsaikenn
横幅	よこはば	yokohaba
宿泊日	しゅくはくび	shukuhakubi
床材	ゆかざい	yukazai
目一杯	めいっぱい	meippai
巨人戦	きょじんせん	kyojinnsenn
箇月	かげつ	kagetsu