掲載	けいさい	keisai
開催	かいさい	kaisai
選択	せんたく	senntaku
携帯	けいたい	keitai
実施	じっし	jisshi
削除	さくじょ	sakujo
終了	しゅうりょう	shuuryou
該当	がいとう	gaitou
施設	しせつ	shisetsu
募集	ぼしゅう	boshuu
企業	きぎょう	kigyou
撮影	さつえい	satsuei
閲覧	えつらん	etsurann
交換	こうかん	koukann
逮捕	たいほ	taiho
了承	りょうしょう	ryoushou
邪魔	じゃま	jama
応募	おうぼ	oubo
魅力	みりょく	miryoku
施行	しこう|せぎょう|せこう|しぎょう	shikou|segyou|sekou|shigyou
請求	せいきゅう	seikyuu
書籍	しょせき|しょじゃく	shoseki|shojaku
企画	きかく	kikaku
承諾	しょうだく	shoudaku
申請	しんせい	shinnsei
完了	かんりょう	kannryou
訂正	ていせい	teisei
満喫	まんきつ	mannkitsu
如何	いか|いかが|いかん|どう	ika|ikaga|ikann|dou
契約	けいやく	keiyaku
促進	そくしん	sokushinn
連携	れんけい	rennkei
福祉	ふくし	fukushi
措置	そち	sochi
犠牲	ぎせい	gisei
魅了	みりょう	miryou
委託	いたく	itaku
覚悟	かくご	kakugo
要請	ようせい	yousei
風邪	かぜ|ふうじゃ|かざ	kaze|fuuja|kaza
上昇	じょうしょう	joushou
匿名	とくめい	tokumei
基礎	きそ	kiso
勘弁	かんべん	kannbenn
概要	がいよう	gaiyou
後悔	こうかい	koukai
緊張	きんちょう	kinntyou
焦点	しょうてん	shoutenn
霊園	れいえん	reienn
変換	へんかん	hennkann
締結	ていけつ	teiketsu
遭遇	そうぐう	souguu
分譲	ぶんじょう	bunnjou
抽選	ちゅうせん	tyuusenn
了解	りょうかい	ryoukai
掃除	そうじ	souji
葬儀	そうぎ	sougi
遂行	すいこう	suikou
魔法	まほう	mahou
紛失	ふんしつ	funnshitsu
譲渡	じょうと|ゆずりわたし	jouto|yuzuriwatashi
衝撃	しょうげき	shougeki
崩壊	ほうかい	houkai
採択	さいたく	saitaku
削減	さくげん	sakugenn
抑制	よくせい	yokusei
審査	しんさ	shinnsa
寿司	すし|ずし	sushi|zushi
円滑	えんかつ	ennkatsu
消滅	しょうめつ	shoumetsu
提携	ていけい	teikei
怪我	けが	kega
抽出	ちゅうしゅつ	tyuushutsu
遵守	じゅんしゅ	junnshu
排除	はいじょ	haijo
凝縮	ぎょうしゅく	gyoushuku
掲示	けいじ	keiji
滞在	たいざい	taizai
収穫	しゅうかく	shuukaku
放棄	ほうき	houki
阻止	そし	soshi
視聴	しちょう	shityou
愛顧	あいこ	aiko
冗談	じょうだん	joudann
宴会	えんかい	ennkai
克服	こくふく	kokufuku
拘束	こうそく	kousoku
在籍	ざいせき	zaiseki
免許	めんきょ	mennkyo
横軸	よこじく	yokojiku
既婚	きこん	kikonn
主催	しゅさい	shusai
魔女	まじょ	majo
募金	ぼきん	bokinn
控除	こうじょ	koujo
喫茶	きっさ	kissa
当該	とうがい	tougai
緩和	かんわ	kannwa
封印	ふういん	fuuinn
誘導	ゆうどう	yuudou
排出	はいしゅつ	haishutsu
偶然	ぐうぜん	guuzenn
奉納	ほうのう	hounou
翻訳	ほんやく	honnyaku
凍結	とうけつ	touketsu
休憩	きゅうけい	kyuukei
魔術	まじゅつ	majutsu
摂取	せっしゅ	sesshu
衰弱	すいじゃく	suijaku
転換	てんかん	tennkann
炎上	えんじょう	ennjou
試聴	しちょう	shityou
鎮座	ちんざ	chinnza
施工	しこう|せこう	shikou|sekou
同封	どうふう	doufuu
阻害	そがい	sogai
解雇	かいこ	kaiko
滅多	めった	metta
液晶	えきしょう	ekishou
錯覚	さっかく	sakkaku
団塊	だんかい	dannkai
工房	こうぼう	koubou
肝心	かんじん	kannjinn
殺伐	さつばつ	satsubatsu
豪華	ごうか	gouka
妨害	ぼうがい	bougai
免除	めんじょ	mennjo
北斗	ほくと	hokuto
処刑	しょけい	shokei
突如	とつじょ	totsujo
膨大	ぼうだい	boudai
分泌	ぶんぴ|ぶんぴつ	bunnpi|bunnpitsu
勧誘	かんゆう	kannyuu
地獄	じごく	jigoku
勘案	かんあん	kannann
華麗	かれい	karei
哲学	てつがく|てつがっ	tetsugaku|tetsugaxtu
雇用	こよう	koyou
没頭	ぼっとう	bottou
容赦	ようしゃ	yousha
審議	しんぎ	shinngi
付随	ふずい	fuzui
許諾	きょだく	kyodaku
悪魔	あくま	akuma
常駐	じょうちゅう	joutyuu
衝動	しょうどう	shoudou
抜粋	ばっすい	bassui
仏壇	ぶつだん	butsudann
既存	きそん|きぞん	kisonn|kizonn
駐車	ちゅうしゃ	tyuusha
擁護	ようご	yougo
邦楽	ほうがく	hougaku
優遇	ゆうぐう	yuuguu
絶滅	ぜつめつ	zetsumetsu
修了	しゅうりょう	shuuryou
換算	かんさん	kannsann
昇順	しょうじゅん	shoujunn
販促	はんそく	hannsoku
葬式	そうしき	soushiki
賢者	けんじゃ	kennja
隔離	かくり	kakuri
衝突	しょうとつ	shoutotsu
発酵	はっこう	hakkou
滅失	めっしつ	messhitsu
出没	しゅつぼつ	shutsubotsu
緊急	きんきゅう	kinnkyuu
鎮痛	ちんつう	chinntsuu
脅迫	きょうはく	kyouhaku
切符	きっぷ|ぎっぷ	kippu|gippu
紛争	ふんそう	funnsou
概念	がいねん	gainenn
概算	がいさん	gaisann
欧米	おうべい	oubei
棄却	ききゃく	kikyaku
邦画	ほうが	houga
契機	けいき	keiki
移籍	いせき	iseki
追随	ついずい	tsuizui
欠如	けつじょ	ketsujo
赴任	ふにん	funinn
免責	めんせき	mennseki
塗装	とそう	tosou
停滞	ていたい	teitai
既出	きしゅつ	kishutsu
埋葬	まいそう	maisou
平穏	へいおん	heionn
誘引	ゆういん	yuuinn
不審	ふしん	fushinn
随所	ずいしょ	zuisho
昇格	しょうかく	shoukaku
衰退	すいたい	suitai
召喚	しょうかん	shoukann
凝視	ぎょうし	gyoushi
施策	しさく	shisaku
清掃	せいそう	seisou
誘発	ゆうはつ	yuuhatsu
虐待	ぎゃくたい	gyakutai
度肝	どぎも	dogimo
食卓	しょくたく	shokutaku
誘惑	ゆうわく	yuuwaku
顧客	こきゃく|こかく	kokyaku|kokaku
乙女	おとめ	otome
滝汗	たきあせ	takiase
塗布	とふ	tofu
特撮	とくさつ	tokusatsu
待遇	たいぐう	taiguu
激励	げきれい	gekirei
遅滞	ちたい	chitai
脅威	きょうい	kyoui
如実	にょじつ	nyojitsu
虐殺	ぎゃくさつ	gyakusatsu
動揺	どうよう	douyou
超越	ちょうえつ	tyouetsu
酵素	こうそ	kouso
壊滅	かいめつ	kaimetsu
伐採	ばっさい	bassai
死刑	しけい	shikei
孤立	こりつ	koritsu
全滅	ぜんめつ	zennmetsu
抑圧	よくあつ	yokuatsu
陳列	ちんれつ	chinnretsu
軌道	きどう	kidou
破棄	はき	haki
警鐘	けいしょう	keishou
敢行	かんこう	kannkou
将棋	しょうぎ	shougi
奉仕	ほうし	houshi
卸売	おろしうり	oroshiuri
娯楽	ごらく	goraku
疾風	しっぷう|はやて	shippuu|hayate
施術	しじゅつ	shijutsu
中華	ちゅうか	tyuuka
高揚	こうよう	kouyou
幽閉	ゆうへい	yuuhei
花嫁	はなよめ	hanayome
改訂	かいてい	kaitei
肝要	かんよう	kannyou
自炊	じすい	jisui
夢幻	むげん|ゆめまぼろし	mugenn|yumemaboroshi
催行	さいこう	saikou
没収	ぼっしゅう	bosshuu
滞納	たいのう	tainou
要綱	ようこう	youkou
双書	そうしょ	sousho
双子	ふたご|ふたこ	futago|futako
封入	ふうにゅう	fuunyuu
刑事	けいじ|でか	keiji|deka
賢明	けんめい	kennmei
付託	ふたく	futaku
常軌	じょうき	jouki
石碑	せきひ	sekihi
撃墜	げきつい	gekitsui
廊下	ろうか	rouka
細胞	さいぼう	saibou
公募	こうぼ	koubo
随時	ずいじ	zuiji
彫刻	ちょうこく	tyoukoku
負債	ふさい	fusai
換金	かんきん	kannkinn
交錯	こうさく	kousaku
緊密	きんみつ	kinnmitsu
減免	げんめん	gennmenn
貫通	かんつう	kanntsuu
置換	ちかん	chikann
粗末	そまつ	somatsu
架空	かくう	kakuu
所掌	しょしょう	shoshou
同伴	どうはん	douhann
昇華	しょうか	shouka
駐留	ちゅうりゅう	tyuuryuu
口癖	くちぐせ	kuchiguse
豚骨	とんこつ	tonnkotsu
霊場	れいじょう	reijou
胎児	たいじ	taiji
潜伏	せんぷく	sennpuku
社債	しゃさい	shasai
粘着	ねんちゃく	nenntyaku
特殊	とくしゅ	tokushu
大胆	だいたん	daitann
潜入	せんにゅう	sennnyuu
換言	かんげん	kanngenn
喚起	かんき	kannki
豚肉	ぶたにく|とんにく	butaniku|tonnniku
名簿	めいぼ	meibo
封鎖	ふうさ	fuusa
湿気	しっけ|しけ|しっき	shikke|shike|shikki
点滅	てんめつ	tennmetsu
寿命	じゅみょう	jumyou
滅亡	めつぼう	metsubou
掌握	しょうあく	shouaku
辛酸	しんさん	shinnsann
冷凍	れいとう	reitou
間隔	かんかく	kannkaku
投獄	とうごく	tougoku
近郊	きんこう	kinnkou
佳境	かきょう	kakyou
駐在	ちゅうざい	tyuuzai
昇進	しょうしん	shoushinn
分裂	ぶんれつ	bunnretsu
疾走	しっそう	shissou
苗字	みょうじ	myouji
硬直	こうちょく	koutyoku
誤審	ごしん	goshinn
水没	すいぼつ	suibotsu
締切	しめきり|しめき	shimekiri|shimeki
恋姫	こいひめ	koihime
軸足	じくあし	jikuashi
要衝	ようしょう	youshou
互換	ごかん	gokann
埋没	まいぼつ	maibotsu
喫緊	きっきん	kikkinn
覆面	ふくめん	fukumenn
隔絶	かくぜつ	kakuzetsu
栄冠	えいかん	eikann
聴取	ちょうしゅ	tyoushu
排水	はいすい	haisui
控訴	こうそ	kouso
傍聴	ぼうちょう	boutyou
畜産	ちくさん	chikusann
疾病	しっぺい	shippei
大概	たいがい	taigai
全裸	ぜんら	zennra
受託	じゅたく	jutaku
符号	ふごう	fugou
債権	さいけん	saikenn
顧問	こもん	komonn
軌跡	きせき	kiseki
卓越	たくえつ	takuetsu
乗換	のりかえ	norikae
火葬	かそう	kasou
満了	まんりょう	mannryou
精霊	しょうりょう|せいれい	shouryou|seirei
諮問	しもん	shimonn
縦軸	たてじく	tatejiku
果敢	かかん	kakann
幻想	げんそう	gennsou
国籍	こくせき	kokuseki
基軸	きじく	kijiku
求刑	きゅうけい	kyuukei
束縛	そくばく	sokubaku
輪郭	りんかく	rinnkaku
胎教	たいきょう	taikyou
失墜	しっつい	shittsui
放浪	ほうろう	hourou
登壇	とうだん	toudann
主軸	しゅじく	shujiku
魅惑	みわく	miwaku
伏線	ふくせん	fukusenn
克明	こくめい	kokumei
委嘱	いしょく	ishoku
隔世	かくせい	kakusei
生憎	あいにく|あやにく	ainiku|ayaniku
粘膜	ねんまく	nennmaku
解凍	かいとう	kaitou
埋設	まいせつ	maisetsu
超過	ちょうか	tyouka
勧請	かんじょう	kannjou
強奪	ごうだつ	goudatsu
起伏	きふく|おきふし	kifuku|okifushi
嘱望	しょくぼう	shokubou
孤高	ここう	kokou
魔王	まおう	maou
肝臓	かんぞう	kannzou
魔弾	まだん	madann
手袋	てぶくろ	tebukuro
降伏	こうふく|ごうぶく	koufuku|goubuku
孤独	こどく	kodoku
浪費	ろうひ	rouhi
満悦	まんえつ	mannetsu
墜落	ついらく	tsuiraku
暫定	ざんてい	zanntei
陰謀	いんぼう	innbou
抑留	よくりゅう	yokuryuu
郊外	こうがい	kougai
安穏	あんのん	annnonn
焼豚	やきぶた|ちゃーしゅー	yakibuta|tya-shu-
戸籍	こせき	koseki
魔笛	まてき	mateki
重篤	じゅうとく	juutoku
昇給	しょうきゅう	shoukyuu
誘致	ゆうち	yuuchi
真髄	しんずい	shinnzui
師匠	ししょう	shishou
摂食	せっしょく	sesshoku
冷房	れいぼう	reibou
移封	いほう	ihou
緊迫	きんぱく	kinnpaku
残虐	ざんぎゃく	zanngyaku
陳謝	ちんしゃ	chinnsha
欠乏	けつぼう	ketsubou
破裂	はれつ	haretsu
翻案	ほんあん	honnann
花婿	はなむこ	hanamuko
喫煙	きつえん	kitsuenn
奇怪	きかい|きっかい	kikai|kikkai
超訳	ちょうやく	tyouyaku
勘定	かんじょう	kannjou
聴衆	ちょうしゅう	tyoushuu
拝聴	はいちょう	haityou
擁立	ようりつ	youritsu
結託	けったく	kettaku
苗木	なえぎ	naegi
論壇	ろんだん	ronndann
変哲	へんてつ	henntetsu
信奉	しんぽう	shinnpou
家畜	かちく	kachiku
搾取	さくしゅ|しぼりと	sakushu|shiborito
死霊	しりょう	shiryou
結晶	けっしょう	kesshou
共催	きょうさい	kyousai
落胆	らくたん	rakutann
湿度	しつど	shitsudo
心酔	しんすい	shinnsui
粗大	そだい	sodai
掲記	けいき	keiki
漂着	ひょうちゃく	hyoutyaku
摂理	せつり	setsuri
修繕	しゅうぜん	shuuzenn
帝王	ていおう	teiou
不穏	ふおん	fuonn
潤沢	じゅんたく	junntaku
横綱	よこづな	yokoduna
破滅	はめつ	hametsu
雪崩	なだれ	nadare
慈愛	じあい	jiai
債券	さいけん	saikenn
開封	かいふう	kaifuu
帝国	ていこく	teikoku
屈託	くったく	kuttaku
魔力	まりょく	maryoku
読了	どくりょう	dokuryou
純粋	じゅんすい	junnsui
埋蔵	まいぞう	maizou
憂慮	ゆうりょ	yuuryo
鶏肉	けいにく|とりにく	keiniku|toriniku
天寿	てんじゅ	tennju
必携	ひっけい	hikkei
湾岸	わんがん	wanngann
急募	きゅうぼ	kyuubo
硬化	こうか	kouka
本籍	ほんせき	honnseki
孤島	ことう	kotou
小房	こふさ	kofusa
清聴	せいちょう	seityou
浪人	ろうにん	rouninn
虚無	きょむ|こむ	kyomu|komu
句碑	くひ	kuhi
企図	きと	kito
木霊	こだま	kodama
		
又は	または	mataha
撮る	とる|どる	toru|doru
聴く	きく	kiku
既に	すでに	sudeni
伴う	ともなう|とものう	tomonau|tomonou
掛け	かけ|がけ	kake|gake
辛い	からい|つらい|がらい|づらい	karai|tsurai|garai|durai
掲げる	かかげる	kakageru
漏れ	もれ	more
伸び	のび	nobi
奪う	うばう|うぼう	ubau|ubou
超える	こえる	koeru
伸ばす	のばす	nobasu
揚げる	あげる	ageru
掛かる	かかる|がかる	kakaru|gakaru
誘う	いざなう|さそう|いざのう	izanau|sasou|izanou
絞る	しぼる	shiboru
勘違い	かんちがい	kannchigai
抑え	おさえ	osae
埋める	うずめる|うめる	uzumeru|umeru
削る	けずる|はつる	kezuru|hatsuru
飽き	あき	aki
控え	ひかえ|びかえ	hikae|bikae
仕掛け	しかけ|じかけ	shikake|jikake
殴る	なぐる	naguru
塗る	ぬる	nuru
漂う	ただよう	tadayou
塗り	ぬり	nuri
慌てる	あわてる	awateru
施す	ほどこす	hodokosu
悔しい	くやしい	kuyashii
穏やか	おだやか	odayaka
怪しい	あやしい|けしい	ayashii|keshii
乗り換え	のりかえ	norikae
崩れ	くずれ|くずれれ|かむあがれ	kuzure|kuzurere|kamuagare
絞り込む	しぼりこむ	shiborikomu
覆う	おおう	oou
酔う	よう|えう	you|eu
崩す	くずす	kuzusu
促す	うながす	unagasu
揺れ	ゆれ	yure
硬い	かたい	katai
鍛える	きたえる	kitaeru
携わる	たずさわる	tazusawaru
励ます	はげます	hagemasu
締め	しめ|じめ	shime|jime
如く	ごとく|しく	gotoku|shiku
滑る	すべる|ぬめる	suberu|numeru
膨らむ	ふくらむ	fukuramu
譲る	ゆずる	yuzuru
炊く	たく|だく	taku|daku
焦る	あせる|こげる	aseru|kogeru
縛る	しばる|じばる	shibaru|jibaru
遭う	あう|おう	au|ou
賢い	かしこい	kashikoi
華やか	はなやか	hanayaka
滑り	すべり|ぬめり	suberi|numeri
暫く	しばらく	shibaraku
抑える	おさえる	osaeru
伸びる	のびる	nobiru
出掛ける	でかける	dekakeru
遂に	ついに	tsuini
絞り込み	しぼりこみ	shiborikomi
潜る	くぐる|もぐる	kuguru|moguru
雇う	やとう	yatou
締め切り	しめきり	shimekiri
埋まる	うずまる|うまる	uzumaru|umaru
貫く	つらぬく|ぬく	tsuranuku|nuku
誘い	さそい|いざない|おびい	sasoi|izanai|obii
粘る	ねばる	nebaru
惜しい	おしい	oshii
擦る	こする|する|なする|ずる	kosuru|suru|nasuru|zuru
換え	かえ|がえ	kae|gae
脅す	おどす	odosu
聴ける	きける	kikeru
催し	もよおし	moyooshi
魅せる	みせる	miseru
遂げる	とげる	togeru
励み	はげみ	hagemi
凍る	こおる	kooru
揺れる	ゆれる	yureru
置き換える	おきかえる	okikaeru
お誘い	おさそい	osasoi
励む	はげむ	hagemu
嫁さん	よめさん	yomesann
控えめ	ひかえめ	hikaeme
漏らす	もらす	morasu
乏しい	とぼしい|まずしい	toboshii|mazushii
募る	つのる	tsunoru
恨み	うらみ	urami
掛ける	かける|がける	kakeru|gakeru
摂る	とる|どる	toru|doru
お嬢様	おじょうさま	ojousama
拘る	かかわる|こだわる	kakawaru|kodawaru
詠む	よむ	yomu
敢えて	あえて	aete
凝る	こごる|こる|しこる	kogoru|koru|shikoru
託す	たくす	takusu
愚か	おろか	oroka
緩やか	ゆるやか	yuruyaka
哀れ	あわれ	aware
魔法使い	まほうつかい	mahoutsukai
概ね	おおむね	oomune
手掛ける	てがける	tegakeru
伏せ	ふせ|ぶせ|ふくせ|ぷせ	fuse|buse|fukuse|puse
昇る	のぼる	noboru
埋め込む	うめこむ	umekomu
巧み	たくみ|だくみ	takumi|dakumi
悟る	さとる	satoru
酔っ払う	よっぱらう|よっぱろう	yopparau|yopparou
覆い	おおい	ooi
衰え	おとろえ	otoroe
埋もれる	うずもれる|うもれる	uzumoreru|umoreru
滅ぼす	ほろぼす	horobosu
妨げ	さまたげ	samatage
滑らか	なめらか|すべらか	nameraka|suberaka
怠る	おこたる	okotaru
潤い	うるおい	uruoi
哀しい	かなしい	kanashii
赴く	おもむく	omomuku
悟り	さとり	satori
縫う	ぬう	nuu
免れる	まぬかれる|まぬがれる	manukareru|manugareru
滅びる	ほろびる	horobiru
慰め	なぐさめ	nagusame
引き締め	ひきしめ	hikishime
彫り	ほり|えり|ぼり	hori|eri|bori
焦り	あせり	aseri
お嬢さん	おじょうさん	ojousann
譲り	ゆずり	yuzuri
如き	しき|ごとき	shiki|gotoki
憩い	いこい	ikoi
書き換え	かきかえ	kakikae
脅かす	おどかす|おびやかす	odokasu|obiyakasu
慕う	したう|しとう	shitau|shitou
誤魔化す	ごまかす	gomakasu
紛れ	まぎれ|まぐれ|まがえれ	magire|magure|magaere
心掛け	こころがけ	kokorogake
搾る	しぼる	shiboru
崩れる	くずれる	kuzureru
成し遂げる	なしとげる	nashitogeru
憎む	にくむ	nikumu
縫い	ぬい	nui
催す	もよおす	moyoosu
買い換える	かいかえる	kaikaeru
凝らす	こらす	korasu
取り敢えず	とりあえず	toriaezu
滞る	とどこおる	todokooru
彫る	える|ほる|ぼる	eru|horu|boru
覆す	くつがえす	kutsugaesu
湿る	しめる|しとる	shimeru|shitoru
葬る	ほうむる	houmuru
封じ	ふうじ|ほうじ	fuuji|houji
緩い	ゆるい|なるい|ぬるい|ゆりい|ぬりい	yurui|narui|nurui|yurii|nurii
引き換え	ひきかえ	hikikae
悔い	くい	kui
恨む	うらむ	uramu
揺らす	ゆらす	yurasu
呼び掛ける	よびかける	yobikakeru
憎い	にくい|にきい	nikui|nikii
水揚げ	みずあげ	mizuage
聴こえる	きこえる	kikoeru
憎しみ	にくしみ	nikushimi
二日酔い	ふつかよい	futsukayoi
飽きる	あきる	akiru
埋め立て	うめたて	umetate
阻む	はばむ	habamu
緩む	ゆるむ	yurumu
お姫様	おひめさま	ohimesama
虚しい	むなしい	munashii
寿し	すし|ずし	sushi|zushi
絞める	しめる	shimeru
引き締まる	ひきしまる	hikishimaru
控える	ひかえる	hikaeru
掛け軸	かけじく	kakejiku
嫁ぐ	とつぐ	totsugu
企む	たくらむ	takuramu
憂い	うい|うれい	ui|urei
下請け	したうけ	shitauke
浮き彫り	うきぼり	ukibori
潜り	もぐり|くぐり	moguri|kuguri
悔やむ	くやむ	kuyamu
潜む	ひそむ	hisomu
隔て	へだて	hedate
取り締まり	とりしまり	torishimari
惜しむ	おしむ	oshimu
締まる	しまる|じまる	shimaru|jimaru
締め付ける	しめつける	shimetsukeru
揚げ物	あげもの	agemono
腰掛け	こしかけ	koshikake
奉る	たてまつる|まつる	tatematsuru|matsuru
撮れる	とれる	toreru
掛け声	かけごえ	kakegoe
切り裂く	きりさく	kirisaku
怪しげ	あやしげ	ayashige
惜しみ	おしみ	oshimi
焦げ	こげ	koge
膨れる	ふくれる|ぶくれる	fukureru|bukureru
緩め	ゆるめ	yurume
揺る	ゆる	yuru
架かる	かかる	kakaru
裂ける	さける	sakeru
揺さぶる	ゆさぶる	yusaburu
握り締める	にぎりしめる	nigirishimeru
裂く	さく|ざく	saku|zaku
塗り替える	ぬりかえる	nurikaeru
架ける	かける|がける	kakeru|gakeru
如し	ごとし	gotoshi
仕掛ける	しかける	shikakeru
赦す	ゆるす	yurusu
締め切る	しめきる	shimekiru
話し掛ける	はなしかける	hanashikakeru
引っ掛ける	ひっかける	hikkakeru
組み換え	くみかえ	kumikae
惜しくも	おしくも	oshikumo
漏れる	もれる	moreru
炊き込む	たきこむ	takikomu
携える	たずさえる	tazusaeru
粘り強い	ねばりづよい	nebariduyoi
揺らぐ	ゆらぐ	yuragu
漏えい	ろうえい	rouei
引き裂く	ひきさく	hikisaku
超す	こす	kosu
取り締まる	とりしまる	torishimaru
虐める	いじめる	ijimeru
妨げる	さまたげる	samatageru
昇り	のぼり	nobori
引っ掛かる	ひっかかる	hikkakaru
紛らわしい	まぎらわしい	magirawashii
婆さん	ばあさん	baasann
油揚げ	あぶらあげ|あぶらげ	aburaage|aburage
雨漏り	あまもり	amamori
取り掛かる	とりかかる	torikakaru
催し物	もよおしもの	moyooshimono
請け負う	うけおう	ukeou
粗い	あらい	arai
掛け合い	かけあい	kakeai
滅ぶ	ほろぶ	horobu
締めくくる	しめくくる	shimekukuru
譲り受ける	ゆずりうける	yuzuriukeru
伸ばせる	のばせる	nobaseru
凝り	こり|こごり|しこり	kori|kogori|shikori
喚く	わめく|おめく	wameku|omeku
顧みる	かえりみる	kaerimiru
締める	しめる|じめる	shimeru|jimeru
取締り	とりしまり	torishimari
伸び悩む	のびなやむ	nobinayamu
潤う	うるおう	uruou
哀しみ	かなしみ	kanashimi
乗り換える	のりかえる	norikaeru
卸す	おろす	orosu
零れる	こぼれる	koboreru
如何なる	いかなる	ikanaru
焦がす	こがす	kogasu
締めくくり	しめくくり	shimekukuri
背伸び	せのび	senobi
一概に	いちがいに	ichigaini
抱き締める	だきしめる|いだきしめる	dakishimeru|idakishimeru
潤す	うるおす	uruosu
婆ちゃん	ばあちゃん	baatyann
感慨深い	かんがいぶかい	kanngaibukai
辛うじて	かろうじて	karoujite
慌ただしい	あわただしい	awatadashii
潜める	ひそめる	hisomeru
引き揚げる	ひきあげる	hikiageru
鎮める	しずめる	shizumeru
乗換える	のりかえる	norikaeru
華やかさ	はなやかさ	hanayakasa
緩み	ゆるみ	yurumi
控え室	ひかえしつ	hikaeshitsu
喫す	きっす	kissu
差し伸べる	さしのべる	sashinoberu
削ぐ	そぐ	sogu
芳しい	かぐわしい|かんばしい	kaguwashii|kannbashii
壁掛け	かべかけ	kabekake
冠す	かんす	kannsu
棄てる	すてる	suteru
奪い取る	うばいとる	ubaitoru
翻す	ひるがえす	hirugaesu
凍りつく	こおりつく	kooritsuku
穴埋め	あなうめ	anaume
日雇い	ひやとい	hiyatoi
差し掛かる	さしかかる	sashikakaru
企て	くわだて	kuwadate
架け橋	かけはし	kakehashi
慌しい	あわただしい	awatadashii
やり遂げる	やりとげる	yaritogeru
倣う	ならう|なろう	narau|narou
滑り台	すべりだい	suberidai
かき揚げ	かきあげ	kakiage
潤む	うるむ	urumu
揺るがす	ゆるがす	yurugasu
酔いしれる	よいしれる	yoishireru
欺く	あざむく	azamuku
見掛け	みかけ	mikake
揚げ足	あげあし	ageashi
封じ込め	ふうじこめ	fuujikome
お袋	おふくろ	ofukuro
卑しい	いやしい	iyashii
振り絞る	ふりしぼる	furishiboru
言い換え	いいかえ	iikae
凍える	こごえる	kogoeru
伏せる	ふせる|ぶせる	fuseru|buseru
紛れ込む	まぎれこむ	magirekomu
土砂崩れ	どしゃくずれ	doshakuzure
酔っぱらう	よっぱらう	yopparau
慈しむ	いつくしむ	itsukushimu
諮る	はかる	hakaru
擁する	ようする	yousuru
一騎打ち	いっきうち	ikkiuchi
怠ける	なまける	namakeru
手の甲	てのこう	tenokou
揚がる	あがる	agaru
木漏れ日	こもれび	komorebi
旗揚げ	はたあげ	hataage
掃く	はく|ぱく	haku|paku
揺れ動く	ゆれうごく	yureugoku
待ち伏せ	まちぶせ	machibuse
暫し	しばし	shibashi
ほろ酔い	ほろよい	horoyoi
揺らぎ	ゆらぎ	yuragi
お悔やみ	おくやみ	okuyami
お墨付き	おすみつき	osumitsuki
塗りつぶす	ぬりつぶす	nuritsubusu
お布施	おふせ	ofuse
お婆さん	おばあさん	obaasann
華やぐ	はなやぐ	hanayagu
冷やし中華	ひやしちゅうか	hiyashityuuka
擁す	ようす	yousu
請う	こう	kou
没す	ぼっす	bossu
木彫り	きぼり	kibori
怪い	あやい	ayai
甲高い	かんだかい	kanndakai
侍る	はべる	haberu
慰める	なぐさめる	nagusameru
掛け持ち	かけもち	kakemochi
粗大ごみ	そだいごみ	sodaigomi
掛け合う	かけあう|かけおう	kakeau|kakeou
手掛かり	てがかり	tegakari
憎める	にくめる	nikumeru
綱引き	つなひき	tsunahiki
愚か者	おろかもの	orokamono
殊に	ことに	kotoni
大掛かり	おおがかり	oogakari
恨めしい	うらめしい	urameshii
硬め	かため	katame
揚げたて	あげたて	agetate
惜しげ	おしげ	oshige
通り魔	とおりま	toorima
撮す	うつす	utsusu
名残惜しい	なごりおしい	nagorioshii
酔っぱらい	よっぱらい	yopparai
滑り込む	すべりこむ	suberikomu
怠け者	なまけもの	namakemono
年の瀬	としのせ	toshinose
拘わる	かかわる	kakawaru
掛け布団	かけぶとん	kakebutonn
嫁入り	よめいり	yomeiri
逆恨み	さかうらみ	sakaurami
追い掛ける	おいかける	oikakeru
金縛り	かなしばり	kanashibari
問い掛ける	といかける	toikakeru
帯締め	おびじめ	obijime
揺する	ゆする	yusuru
虚ろ	うつろ	utsuro
し尿	しにょう	shinyou
手縫い	てぬい	tenui
負け惜しみ	まけおしみ	makeoshimi
控え目	ひかえめ	hikaeme
零す	こぼす	kobosu
縫い目	ぬいめ	nuime
如何に	いかに	ikani
卸売り	おろしうり	oroshiuri
緩める	ゆるめる	yurumeru
請け合い	うけあい	ukeai
言い換える	いいかえる	iikaeru
水炊き	みずたき	mizutaki
塗り絵	ぬりえ	nurie
隔たり	へだたり	hedatari
換える	かえる	kaeru
悔い改める	くいあらためる	kuiaratameru
潜り込む	もぐりこむ|くぐりこむ	mogurikomu|kugurikomu
伏す	ふす|ぷす	fusu|pusu
滅入る	めいる	meiru
滅多に	めったに	mettani
上塗り	うわぬり	uwanuri
詠う	うたう|うとう	utau|utou
排す	はいす	haisu
掛る	かかる|かける|がける|がかる	kakaru|kakeru|gakeru|gakaru
書き換える	かきかえる	kakikaeru
借り換え	かりかえ	karikae
飽く	あく	aku
お粗末	おそまつ	osomatsu
帯揚げ	おびあげ	obiage
引き締める	ひきしめる	hikishimeru
渡り廊下	わたりろうか	watarirouka
概して	がいして	gaishite
虐げる	しいたげる	shiitageru
酔いどれ	よいどれ	yoidore
締切り	しめきり	shimekiri
悦び	よろこび	yorokobi
取り繕う	とりつくろう	toritsukurou
殴り合い	なぐりあい	naguriai
勘ぐる	かんぐる	kannguru
甘辛い	あまからい|あまがらい	amakarai|amagarai
忌まわしい	いまわしい	imawashii
ぶん殴る	ぶんなぐる	bunnnaguru
伸びやか	のびやか	nobiyaka
奪い合い	うばいあい	ubaiai
縛り付ける	しばりつける	shibaritsukeru
衰える	おとろえる	otoroeru
如何にも	いかにも	ikanimo
除夜の鐘	じょやのかね	joyanokane
怠り	おこたり	okotari
篤い	あつい|あちい	atsui|achii
口惜しい	くちおしい|くやしい	kuchioshii|kuyashii
くも膜	くもまく|くもまっ	kumomaku|kumomaxtu
炊き出し	たきだし	takidashi
封じる	ふうじる|ほうじる	fuujiru|houjiru
請け	うけ	uke
忌む	いむ	imu
契り	ちぎり	chigiri
塩辛い	しおからい	shiokarai
辛抱強い	しんぼうづよい	shinnbouduyoi
衝く	つく|づく	tsuku|duku
伸び伸び	のびのび	nobinobi
削り取る	けずりとる	kezuritoru
滑り出し	すべりだし	suberidashi
掛り	かかり|がかり	kakari|gakari
繕う	つくろう|づくろう	tsukurou|dukurou
揺らめく	ゆらめく	yurameku
塗り薬	ぬりぐすり	nurigusuri
膨らます	ふくらます	fukuramasu
揺さぶり	ゆさぶり	yusaburi
さつま揚げ	さつまあげ	satsumaage
伐る	きる|ぎる	kiru|giru
揺るぎない	ゆるぎない	yuruginai
目掛ける	めがける	megakeru
辛み	からみ	karami
粗しょう	そしょう	soshou
惜しむらくは	おしむらくは	oshimurakuha
差し控える	さしひかえる	sashihikaeru
掛け金	かけきん|かけがね	kakekinn|kakegane
切り換え	きりかえ	kirikae
焦らす	じらす	jirasu
謀る	はかる|たばかる	hakaru|tabakaru
辱める	はずかしめる	hazukashimeru
掛け時計	かけどけい	kakedokei
凍てつく	いてつく	itetsuku
貫き通す	つらぬきとおす	tsuranukitoosu
綱渡り	つなわたり	tsunawatari
墜ちる	おちる	ochiru
切っ掛け	きっかけ	kikkake
魅入る	みいる	miiru
取り崩す	とりくずす	torikuzusu
擦り傷	すりきず	surikizu
ひれ伏す	ひれふす	hirefusu
入れ墨	いれずみ	irezumi
佳い	よい	yoi
凍り付く	こおりつく	kooritsuku
如何せん	いかんせん	ikannsenn
泣き崩れる	なきくずれる	nakikuzureru
引き伸ばし	ひきのばし	hikinobashi
擦り寄る	すりよる	suriyoru
割り勘	わりかん	warikann
鍛え上げる	きたえあげる	kitaeageru
裂け目	さけめ	sakeme
引換える	ひきかえる	hikikaeru
擦り付ける	すりつける|なすりつける|こすりつける	suritsukeru|nasuritsukeru|kosuritsukeru
うつ伏せる	うつぶせる	utsubuseru
憎たらしい	にくたらしい	nikutarashii
素っ裸	すっぱだか	suppadaka
抑え込む	おさえこむ	osaekomu
焦げ目	こげめ	kogeme
突っ伏す	つっぷす	tsuppusu
お姫さま	おひめさま	ohimesama
ご免	ごめん	gomenn
憂う	うれう|うう	ureu|uu
遇う	あう|おう	au|ou
滑れる	すべれる	subereru
奪い合う	うばいあう|うばいおう	ubaiau|ubaiou
崩れ落ちる	くずれおちる	kuzureochiru
炊きたて	たきたて	takitate
見飽き	みあき	miaki
前掛け	まえかけ	maekake
憂き目	うきめ	ukime
可哀そう	かわいそう	kawaisou
換わる	かわる	kawaru
哀れみ	あわれみ	awaremi
翻る	ひるがえる	hirugaeru
豚まん	ぶたまん	butamann
殴りつける	なぐりつける	naguritsukeru
奉じる	ほうじる	houjiru
憎らしい	にくらしい	nikurashii
掛け算	かけざん	kakezann
譲り合う	ゆずりあう|ゆずりおう	yuzuriau|yuzuriou
脅える	おびえる	obieru
焼き豚	やきぶた|やきとん	yakibuta|yakitonn
苦し紛れ	くるしまぎれ	kurushimagire
引っ掛かり	ひっかかり	hikkakari
凝り固まる	こりかたまる	korikatamaru
愚かしい	おろかしい	orokashii
滑り降りる	すべりおりる	suberioriru
荒削り	あらけずり	arakezuri
悦に入る	えつにいる	etsuniiru
締めつけ	しめつけ	shimetsuke
腕立て伏せ	うでたてふせ	udetatefuse
滅する	めっする	messuru
ひな壇	ひなだん	hinadann
奪い返す	うばいかえす	ubaikaesu
塗りたくる	ぬりたくる	nuritakuru
なし崩し	なしくずし	nashikuzushi
押し掛ける	おしかける	oshikakeru
湿っぽい	しめっぽい	shimeppoi
搾り取る	しぼりとる	shiboritoru
縫い合わせる	ぬいあわせる	nuiawaseru
哀れむ	あわれむ	awaremu
匿う	かくまう|かくもう	kakumau|kakumou
腰掛ける	こしかける	koshikakeru
崩せる	くずせる	kuzuseru
置き換わる	おきかわる	okikawaru
聴き入る	ききいる	kikiiru
下塗り	したぬり	shitanuri
伏せ字	ふせじ	fuseji
湿り気	しめりけ	shimerike
生き埋め	いきうめ	ikiume
世知辛い	せちがらい	sechigarai
誘い込む	さそいこむ	sasoikomu
憂さ晴らし	うさばらし	usabarashi
ねじ伏せる	ねじふせる	nejifuseru
誘い出す	さそいだす	sasoidasu
横滑り	よこすべり	yokosuberi
入れ換える	いれかえる	irekaeru
心掛ける	こころがける	kokorogakeru
貫ける	つらぬける|ぬける	tsuranukeru|nukeru
封切り	ふうきり|ふうぎり	fuukiri|fuugiri
冠する	かんする	kannsuru
詰め掛ける	つめかける	tsumekakeru
焦げ付く	こげつく	kogetsuku
元締め	もとじめ	motojime
ひざ掛け	ひざかけ	hizakake
気紛れ	きまぐれ	kimagure
湿す	しめす	shimesu
克つ	かつ	katsu
辛くも	からくも	karakumo
横殴り	よこなぐり	yokonaguri
胆のう	たんのう	tannnou
削れる	けずれる	kezureru
企てる	くわだてる	kuwadateru
削り節	けずりぶし	kezuribushi
地滑り	じすべり	jisuberi
物の怪	もののけ	mononoke
肝っ玉	きもったま	kimottama
隔てる	へだてる	hedateru
悔やみ	くやみ	kuyami
紛らわす	まぎらわす	magirawasu
魔よけ	まよけ	mayoke
見掛ける	みかける	mikakeru
焦がれる	こがれる	kogareru
殴り込み	なぐりこみ	nagurikomi
飛び掛る	とびかかる	tobikakaru
願掛け	がんかけ	gannkake
中華まん	ちゅうかまん	tyuukamann
鎮まる	しずまる	shizumaru
免じる	めんじる	mennjiru
締め出す	しめだす	shimedasu
軸受け	じくうけ	jikuuke
雇い主	やといぬし	yatoinushi
悦ぶ	よろこぶ	yorokobu
悔し涙	くやしなみだ	kuyashinamida
憎まれる	にくまれる	nikumareru
封じ込める	ふうじこめる	fuujikomeru
怪しむ	あやしむ	ayashimu
かみ締める	かみしめる	kamishimeru
譲り渡す	ゆずりわたす	yuzuriwatasu
憩う	いこう	ikou
覆る	くつがえる	kutsugaeru
切り崩し	きりくずし	kirikuzushi
埋め合わせ	うめあわせ	umeawase
酔いつぶれる	よいつぶれる	yoitsubureru
措く	おく	oku
炊ける	たける	takeru
揺り動かす	ゆりうごかす	yuriugokasu
風邪ひき	かぜひき	kazehiki
畳み掛ける	たたみかける	tatamikakeru
辛め	からめ	karame
悪酔い	わるよい	waruyoi
揚げ油	あげあぶら	ageabura
取り換え	とりかえ	torikae
縛りつける	しばりつける	shibaritsukeru
穫る	かる	karu
待ち焦がれる	まちこがれる	machikogareru
締め出し	しめだし	shimedashi
お転婆	おてんば	otennba
縛り上げる	しばりあげる	shibariageru
粘り気	ねばりけ	nebarike
べっ甲	べっこう	bekkou
請け負い	うけおい	ukeoi
勘繰る	かんぐる	kannguru
餓え	うえ|かつえ	ue|katsue
罪滅ぼし	つみほろぼし	tsumihoroboshi
気掛かり	きがかり	kigakari
値崩れ	ねくずれ	nekuzure
滝つぼ	たきつぼ	takitsubo
焦げる	こげる	kogeru
擦り切る	すりきる	surikiru
心憎い	こころにくい|こころにきい	kokoronikui|kokoronikii
手提げ袋	てさげぶくろ	tesagebukuro
引き伸ばす	ひきのばす	hikinobasu
乏い	ともい|とぼしい	tomoi|toboshii
湿り	しめり|しとり	shimeri|shitori
肩掛け	かたかけ	katakake
漏る	もる	moru
張り裂ける	はりさける	harisakeru
塗りつける	ぬりつける	nuritsukeru
憂え	うれえ|うれい	uree|urei
総崩れ	そうくずれ	soukuzure
擦れる	こすれる|すれる|ずれる	kosureru|sureru|zureru
がけ崩れ	がけくずれ	gakekuzure
彫り物	ほりもの	horimono
没する	ぼっする	bossuru
縫いつける	ぬいつける	nuitsukeru
ふん尿	ふんにょう	funnnyou
小賢しい	こざかしい	kozakashii
紛らわせる	まぎらわせる	magirawaseru
買い控え	かいびかえ|かいひかえ	kaibikae|kaihikae
荷揚げ	にあげ	niage
強請る	ねだる|ゆする	nedaru|yusuru
手控え	てびかえ	tebikae
血塗る	ちぬる	chinuru
戸締り	とじまり	tojimari
憎まれ口	にくまれぐち	nikumareguchi
敢然と	かんぜんと	kannzennto
飽き飽きする	あきあきする	akiakisuru
陸揚げ	りくあげ	rikuage
脅し取る	おどしとる	odoshitoru
滑らす	すべらす	suberasu
絞り出す	しぼりだす	shiboridasu
働き掛け	はたらきかけ	hatarakikake
精霊流し	しょうりょうながし	shouryounagashi
書換え	かきかえ	kakikae
足掛け	あしかけ	ashikake
縫い代	ぬいしろ	nuishiro
はん濫	はんらん	hannrann
焦げ茶	こげちゃ	kogetya
のし袋	のしぶくろ	noshibukuro
請い	こい	koi
飽くまで	あくまで	akumade
擦れ違う	すれちがう|すれちごう	surechigau|surechigou
持ち掛ける	もちかける	mochikakeru
お茶請け	おちゃうけ	otyauke
詠める	よめる	yomeru
悪巧み	わるだくみ	warudakumi
邪魔くさい	じゃまくさい	jamakusai
風邪引き	かぜひき	kazehiki
詰め将棋	つめしょうぎ	tsumeshougi
凝り性	こりしょう	korishou
投げ掛ける	なげかける	nagekakeru
元請け	もとうけ	motouke
山崩れ	やまくずれ	yamakuzure
炊きあがる	たきあがる	takiagaru
冠たる	かんたる	kanntaru
切換え	きりかえ	kirikae
粘っこい	ねばっこい	nebakkoi
請負う	うけおう	ukeou
掛け替え	かけがえ|かけかえ	kakegae|kakekae
伸し	のし|のばし	noshi|nobashi
塗れる	ぬれる|まみれる	nureru|mamireru
憂さ	うさ	usa
芳ばしい	こうばしい	koubashii
血塗れ	ちまみれ|ちぬれ	chimamire|chinure
見せ掛け	みせかけ	misekake
煮炊き	にたき	nitaki
揺るぎ	ゆるぎ	yurugi
見繕う	みつくろう	mitsukurou
憂うつ	ゆううつ	yuuutsu
恋焦がれる	こいこがれる	koikogareru
奪える	うばえる	ubaeru
足掛かり	あしがかり	ashigakari
彫り込む	ほりこむ	horikomu
絞め殺す	しめころす	shimekorosu
滑り落ちる	すべりおちる	suberiochiru
見紛う	みまがう|みまごう	mimagau|mimagou
絞れる	しぼれる	shiboreru
紛れる	まぎれる	magireru
紛い	まがい|まごい	magai|magoi
抽せん	ちゅうせん	tyuusenn
黒焦げ	くろこげ	kurokoge
忌明け	いみあけ|きあけ	imiake|kiake
湯の華	ゆのはな	yunohana
凍み	しみ	shimi
縫いぐるみ	ぬいぐるみ	nuigurumi
水掛け論	みずかけろん	mizukakeronn
締付ける	しめつける	shimetsukeru
封切る	ふうきる|ふうぎる	fuukiru|fuugiru
縫い物	ぬいもの	nuimono
言い掛かり	いいがかり|いいかかり	iigakari|iikakari
説き伏せる	ときふせる	tokifuseru
引締める	ひきしめる	hikishimeru
隔たる	へだたる	hedataru
喫する	きっする	kissuru
平伏す	ひれふす	hirefusu
殴り飛ばす	なぐりとばす	naguritobasu
締り	しまり|じまり	shimari|jimari
掛け値	かけね	kakene
切り換える	きりかえる	kirikaeru
立て掛ける	たてかける	tatekakeru
身請け	みうけ	miuke
埋る	うまる|うめる	umaru|umeru
施せる	ほどこせる	hodokoseru
寄り掛かる	よりかかる	yorikakaru
八つ裂き	やつざき	yatsuzaki
語り掛ける	かたりかける	katarikakeru
喚ぶ	よぶ	yobu
通り掛かる	とおりかかる	toorikakaru
借換える	かりかえる	karikaeru
色仕掛け	いろじかけ	irojikake
掃き出す	はきだす	hakidasu
言い募る	いいつのる	iitsunoru
誘ふ	さそふ	sasofu
寿ぐ	ことほぐ	kotohogu
お伴	おとも	otomo
徐に	おもむろに	omomuroni
仮縫い	かりぬい	karinui
恨み言	うらみごと	uramigoto
辛みそ	からみそ	karamiso
引き絞る	ひきしぼる	hikishiboru
幽か	かすか	kasuka
揚げ句	あげく	ageku
天の邪鬼	あまのじゃく	amanojaku
伸び上がる	のびあがる	nobiagaru
雇える	やとえる	yatoeru
貧乏くじ	びんぼうくじ	binnboukuji
封ずる	ふうずる|ほうずる	fuuzuru|houzuru
と畜場	とちくじょう	tochikujou
揚げ玉	あげだま	agedama
排せつ	はいせつ	haisetsu
排せつ物	はいせつぶつ	haisetsubutsu
のう胞	のうほう	nouhou
憂える	うれえる	ureeru
聴き込む	ききこむ	kikikomu
添い遂げる	そいとげる	soitogeru
又聞き	またぎき	matagiki
覆せる	くつがえせる	kutsugaeseru
置換え	おきかえ	okikae
悔いる	くいる	kuiru
羽交い締め	はがいじめ	hagaijime
肝いり	きもいり	kimoiri
飽くまでも	あくまでも	akumademo
戸締まり	とじまり	tojimari
埋め立てる	うめたてる	umetateru
はく奪	はくだつ	hakudatsu
飯炊き	めしたき	meshitaki
凍てる	いてる	iteru
絞り染め	しぼりぞめ	shiborizome
着崩れ	きくずれ	kikuzure
鋳込む	いこむ	ikomu
慰み	なぐさみ	nagusami
又もや	またもや	matamoya
締め日	しめび	shimebi
切り崩す	きりくずす	kirikuzusu
絞まる	しまる	shimaru
織り姫	おりひめ	orihime
聞き漏らす	ききもらす	kikimorasu
罪滅し	つみほろぼし	tsumihoroboshi
擦り込む	すりこむ|なすりこむ	surikomu|nasurikomu
真っ裸	まっぱだか	mappadaka
辛らつ	しんらつ	shinnratsu
酔ひ	えい|よひ	ei|yohi
空揚げ	からあげ	karaage
漂わす	ただよわす	tadayowasu
振り掛け	ふりかけ	furikake
如何わしい	いかがわしい	ikagawashii
衣擦れ	きぬずれ	kinuzure
揺ぎ	ゆるぎ|ゆらぎ	yurugi|yuragi
将棋倒し	しょうぎだおし	shougidaoshi
小憎らしい	こにくらしい	konikurashii
伏し目	ふしめ	fushime
どんぶり勘定	どんぶりかんじょう	donnburikannjou
恨みつらみ	うらみつらみ	uramitsurami
酔える	よえる	yoeru
婿入り	むこいり	mukoiri
飽き性	あきしょう	akishou
末締め	まつじめ	matsujime
忌わしい	いまわしい	imawashii
憂ふ	うれふ	urefu
掛け橋	かけはし	kakehashi
哀しむ	かなしむ	kanashimu
紛らす	まぎらす	magirasu
免ずる	めんずる	mennzuru
立つ瀬	たつせ	tatsuse
浮き袋	うきぶくろ	ukibukuro
埋込み	うめこみ	umekomi
上滑り	うわすべり	uwasuberi
擦れ合う	すれあう|こすれあう|こすれおう|すれおう	sureau|kosureau|kosureou|sureou
詠じる	えいじる	eijiru
縫い糸	ぬいいと	nuiito
掛け離れる	かけはなれる	kakehanareru
塗り付ける	ぬりつける	nuritsukeru
縫い上げる	ぬいあげる	nuiageru
軌を一に	きをいつに	kiwoitsuni
縫える	ぬえる	nueru
殴れる	なぐれる	nagureru
悪賢い	わるがしこい	warugashikoi
擦り切れる	すりきれる	surikireru
物憂い	ものうい	monoui
慕わしい	したわしい	shitawashii
奉ずる	ほうずる	houzuru
滅ぼせる	ほろぼせる	horoboseru
彫り上げる	ほりあげる	horiageru
擦りむく	すりむく	surimuku
くり貫く	くりぬく	kurinuku
紛う	まがう|まごう	magau|magou
落ち穂	おちぼ	ochibo
伸びゆく	のびゆく	nobiyuku
着膨れ	きぶくれ	kibukure
安請け合い	やすうけあい	yasuukeai
埋め合わせる	うめあわせる	umeawaseru
勘どころ	かんどころ	kanndokoro
憎憎しい	にくにくしい	nikunikushii
焦れったい	じれったい	jirettai
塗り物	ぬりもの	nurimono
組み伏せる	くみふせる	kumifuseru
手掛り	てがかり	tegakari
斥ける	しりぞける	shirizokeru
見飽きる	みあきる	miakiru
締切る	しめきる	shimekiru
憎まれ役	にくまれやく	nikumareyaku
もたれ掛かる	もたれかかる	motarekakaru
肝吸い	きもすい	kimosui
打ち掛け	うちかけ	uchikake
掃き掃除	はきそうじ	hakisouji
稚い	いとけない	itokenai
縫い込む	ぬいこむ	nuikomu
引っ掛る	ひっかかる	hikkakaru
疾く	とく|やましく|はやく|ばやく	toku|yamashiku|hayaku|bayaku
揺りかご	ゆりかご	yurikago
取り換える	とりかえる	torikaeru
誘い合う	さそいあう|さそいおう	sasoiau|sasoiou
彫りこむ	ほりこむ	horikomu
誘える	さそえる	sasoeru
択ぶ	えらぶ	erabu
取崩す	とりくずす	torikuzusu
ひじ掛け	ひじかけ	hijikake
掃ける	はける	hakeru
締めつける	しめつける	shimetsukeru
伐つ	うつ	utsu
追っ掛ける	おっかける	okkakeru
聞き辛い	ききづらい	kikidurai
契る	ちぎる	chigiru
悦ばしい	よろこばしい	yorokobashii
疾しい	やましい	yamashii
お湿り	おしめり	oshimeri
袋だたき	ふくろだたき	fukurodataki
悔し紛れ	くやしまぎれ	kuyashimagire
紛い物	まがいもの	magaimono
揺り起こす	ゆりおこす	yuriokosu
詠み込む	よみこむ	yomikomu
恋い焦がれる	こいこがれる	koikogareru
伸べる	のべる	noberu
滑り出す	すべりだす	suberidasu
振り掛ける	ふりかける	furikakeru
墨染め	すみぞめ	sumizome
埋め込める	うめこめる	umekomeru
賢しい	さかしい	sakashii
愚図る	ぐずる	guzuru
焦げつく	こげつく	kogetsuku
踏み締める	ふみしめる	fumishimeru
排する	はいする	haisuru
悔み	くやみ	kuyami
もの憂い	ものうい	monoui
中華めん	ちゅうかめん	tyuukamenn
請ける	うける	ukeru
降り掛かる	ふりかかる	furikakaru
果敢ない	はかない	hakanai
封じ手	ふうじて	fuujite
恨み辛み	うらみつらみ	uramitsurami
吹っ掛ける	ふっかける	fukkakeru
封じ込む	ふうじこむ	fuujikomu
働き掛ける	はたらきかける	hatarakikakeru
上擦る	うわずる	uwazuru
手緩い	てぬるい|てぬりい	tenurui|tenurii
粘い	ねばい	nebai
架する	かする	kasuru
伸す	のす|のばす	nosu|nobasu
生揚げ	なまあげ	namaage
裸参り	はだかまいり	hadakamairi
吹き掛ける	ふきかける	fukikakeru
豆絞り	まめしぼり	mameshibori
歌詠み	うたよみ	utayomi
卑しめる	いやしめる	iyashimeru
心憂い	こころうい	kokoroui
殺伐と	さつばつと	satsubatsuto
焦げくさい	こげくさい	kogekusai
揺すぶる	ゆすぶる	yusuburu
削げる	そげる	sogeru
悔し泣き	くやしなき	kuyashinaki
揚る	あがる	agaru
三本締め	さんぼんじめ	sannbonnjime
敢無い	あえない	aenai
焼け焦げ	やけこげ	yakekoge
差し換える	さしかえる	sashikaeru
せち辛い	せちがらい	sechigarai
物忌み	ものいみ	monoimi
鶏ふん	けいふん	keifunn
凍り豆腐	こおりどうふ	kooridoufu
親譲り	おやゆずり	oyayuzuri
粘つく	ねばつく	nebatsuku
お絞り	おしぼり	oshibori
粗削り	あらけずり	arakezuri
誘き寄せる	おびきよせる	obikiyoseru
幽い	かそけい	kasokei
持ち崩す	もちくずす	mochikuzusu
漏れ聞く	もれきく	morekiku
盗み撮り	ぬすみどり	nusumidori
掛かれる	かかれる	kakareru
憎まれっ子	にくまれっこ	nikumarekko
小面憎い	こづらにくい	koduranikui
残り惜しい	のこりおしい	nokorioshii
又の名	またのな	matanona
見掛け倒し	みかけだおし	mikakedaoshi
どさくさ紛れ	どさくさまぎれ	dosakusamagire
打ち崩せる	うちくずせる	uchikuzuseru
切り伏せる	きりふせる	kirifuseru
こす辛い	こすからい	kosukarai
勘定高い	かんじょうだかい	kannjoudakai
華華しい	はなばなしい	hanabanashii
悟れる	さとれる	satoreru
如才無い	じょさいない	josainai
慰む	なぐさむ	nagusamu
引き換える	ひきかえる	hikikaeru
さく裂	さくれつ	sakuretsu
奇っ怪	きっかい	kikkai
封じこめる	ふうじこめる	fuujikomeru
粘強い	ねばりづよい	nebariduyoi
譲れる	ゆずれる	yuzureru
面憎い	つらにくい|つらにきい|おもにくい|おもにきい	tsuranikui|tsuranikii|omonikui|omonikii
売り掛け	うりかけ	urikake
忌忌しい	いまいましい|ゆゆしい	imaimashii|yuyushii
削りぶし	けずりぶし	kezuribushi
絞め技	しめわざ	shimewaza
残惜しい	のこりおしい	nokorioshii
忌いましい	いまいましい	imaimashii
誘いかける	さそいかける	sasoikakeru
恋い慕う	こいしたう|こいしとう	koishitau|koishitou
錬る	ねる	neru
聞辛い	ききづらい	kikidurai
下膨れ	しもぶくれ	shimobukure
炊さん	すいさん	suisann
見憎い	みにくい|みにきい	minikui|minikii
華ばなしい	はなばなしい	hanabanashii
双ない	そうない	sounai
潜り込める	もぐりこめる	mogurikomeru
敢ない	あえない	aenai
甲だかい	かんだかい	kanndakai
こすっ辛い	こすっからい	kosukkarai
手慰み	てなぐさみ	tenagusami
憎にくしい	にくにくしい	nikunikushii
又貸し	またがし	matagashi
縛め	いましめ	imashime
膨れっ面	ふくれっつら	fukurettsura
煮凝り	にこごり	nikogori
墨流し	すみながし	suminagashi
取り締る	とりしまる	torishimaru
せん滅	せんめつ	sennmetsu
返し縫い	かえしぬい	kaeshinui
やせ衰える	やせおとろえる	yaseotoroeru
三つ又	みつまた	mitsumata
誘き出す	おびきだす	obikidasu
お粗末さま	おそまつさま	osomatsusama
貫き通せる	つらぬきとおせる	tsuranukitooseru
羽繕い	はづくろい	hadukuroi
身繕い	みづくろい	midukuroi
縛り首	しばりくび	shibarikubi
搾り出し	しぼりだし	shiboridashi
木偶の坊	でくのぼう	dekunobou
紛れこむ	まぎれこむ	magirekomu
請する	しょうする	shousuru
嫁取り	よめとり	yometori
腹掛け	はらがけ	haragake
忌引き	きびき	kibiki
閲する	えっする|けみする	essuru|kemisuru
封かん	ふうかん	fuukann
卑わい	ひわい	hiwai
せん孔	せんこう	sennkou
墨書き	すみがき	sumigaki
魔法びん	まほうびん	mahoubinn
絞り上げる	しぼりあげる	shiboriageru
丸揚げ	まるあげ	maruage
菊の節句	きくのせっく	kikunosekku
粘りけ	ねばりけ	nebarike
泣き伏す	なきふす	nakifusu
託け	ことづけ|かこつけ	kotoduke|kakotsuke
誘い水	さそいみず	sasoimizu
雇い人	やといにん	yatoininn
待ち伏せる	まちぶせる	machibuseru
		