風呂	ふろ|ぶろ	furo|buro
挨拶	あいさつ	aisatsu
凄い	すごい	sugoi
焼酎	しょうちゅう|じょうちゅう	shouchuu|jouchuu
旦那	だんな	dannna
貼り	はり|ばり	hari|bari
必須	ひっす|ひっしゅ	hissu|hisshu
狙い	ねらい	nerai
匂い	におい	nioi
諦め	あきらめ	akirame
この頃	このごろ	konogoro
椅子	いす	isu
完璧	かんぺき	kannpeki
稽古	けいこ|げいこ	keiko|geiko
憧れ	あこがれ|あくがれ	akogare|akugare
日頃	ひごろ	higoro
爽やか	さわやか	sawayaka
一旦	いったん	ittann
拉致	らち|らっち	rachi|racchi
狙う	ねらう|ねろう	nerau|nerou
僅か	わずか|はつか	wazuka|hatsuka
親戚	しんせき	shinnseki
痩せ	やせ	yase
隙間	すきま	sukima
破綻	はたん	hatann
歌舞伎	かぶき	kabuki
年頃	としごろ	toshigoro
妖怪	ようかい	youkai
貼る	はる|ばる	haru|baru
腫瘍	しゅよう	shuyou
貼り付け	はりつけ	haritsuke
曖昧	あいまい	aimai
所詮	しょせん	shosenn
蹴り	けり|げり	keri|geri
潰し	つぶし|つやし	tsubushi|tsuyashi
今頃	いまごろ	imagoro
嫉妬	しっと	shitto
羨ましい	うらやましい	urayamashii
洞窟	どうくつ	doukutsu
頂戴	ちょうだい	choudai
妖精	ようせい	yousei
玩具	がんぐ|おもちゃ	ganngu|omocha
三昧	さんまい|ざんまい	sannmai|zannmai
憂鬱	ゆううつ	yuuutsu
弥生	やよい	yayoi
日韓	にっかん	nikkann
爽快	そうかい	soukai
潰れ	つぶれ	tsubure
賭け	かけ|がけ	kake|gake
斬り	きり|ぎり	kiri|giri
呪い	のろい|まじない	noroi|majinai
貼付	ちょうふ|てんぷ	choufu|tennpu
僧侶	そうりょ	souryo
呪文	じゅもん	jumonn
腫れ	はれ	hare
暗闇	くらやみ	kurayami
藤本	とうほん	touhonn
尻尾	しっぽ	shippo
挫折	ざせつ	zasetsu
手頃	てごろ	tegoro
覚醒	かくせい	kakusei
斬新	ざんしん	zannshinn
腎臓	じんぞう	jinnzou
月頃	つきごろ	tsukigoro
つけ麺	つけめん	tsukemenn
山麓	さんろく	sannroku
真摯	しんし	shinnshi
汎用	はんよう	hannyou
毀損	きそん	kisonn
勾配	こうばい	koubai
見頃	みごろ	migoro
拭い	ふい|ぬぐい	fui|nugui
捉える	とらえる|つらまえる	toraeru|tsuramaeru
葛藤	かっとう|つづらふじ	kattou|tsudurafuji
初詣	はつもうで	hatsumoude
股間	こかん	kokann
近頃	ちかごろ	chikagoro
冥福	めいふく	meifuku
進捗	しんちょく	shinnchoku
刹那	せつな	setsuna
元旦	がんたん	ganntann
韓流	かんりゅう	kannryuu
拳銃	けんじゅう	kennjuu
旺盛	おうせい	ousei
潰す	つぶす|つやす	tsubusu|tsuyasu
堆肥	たいひ	taihi
閉塞	へいそく	heisoku
凄まじい	すさまじい	susamajii
語彙	ごい	goi
変貌	へんぼう	hennbou
痩せる	やせる	yaseru
斬る	きる|ぎる	kiru|giru
賭博	とばく	tobaku
危惧	きぐ	kigu
堆積	たいせき	taiseki
要塞	ようさい	yousai
拭き	ふき	fuki
翻弄	ほんろう	honnrou
物凄い	ものすごい	monosugoi
宛て	あて	ate
蜂蜜	はちみつ	hachimitsu
脊髄	せきずい	sekizui
罵倒	ばとう	batou
傲慢	ごうまん	goumann
失踪	しっそう	shissou
隠蔽	いんぺい	innpei
振袖	ふりそで	furisode
勃起	ぼっき	bokki
諦める	あきらめる	akirameru
梗塞	こうそく	kousoku
唾液	だえき	daeki
瑠璃	るり	ruri
乞食	こじき|こつじき	kojiki|kotsujiki
勃発	ぼっぱつ	boppatsu
痕跡	こんせき	konnseki
緻密	ちみつ	chimitsu
親睦	しんぼく	shinnboku
半袖	はんそで	hannsode
風呂敷	ふろしき|ぶろしき	furoshiki|buroshiki
湧水	ゆうすい	yuusui
風呂場	ふろば	furoba
脇役	わきやく	wakiyaku
鍛冶	たんや|かじ	tannya|kaji
長袖	ながそで|ちょうしゅう	nagasode|choushuu
滑稽	こっけい	kokkei
串焼き	くしやき	kushiyaki
明瞭	めいりょう	meiryou
いつ頃	いつごろ	itsugoro
亀裂	きれつ	kiretsu
宛名	あてな	atena
氾濫	はんらん	hannrann
参詣	さんけい	sannkei
湧く	わく	waku
沙汰	さた|ざた	sata|zata
眉毛	まゆげ	mayuge
憧れる	あこがれる	akogareru
美貌	びぼう	bibou
訃報	ふほう	fuhou
麺類	めんるい	mennrui
鍵盤	けんばん	kennbann
潰れる	つぶれる	tsubureru
狙撃	そげき	sogeki
払拭	ふっしょく	fusshoku
臆病	おくびょう	okubyou
煎餅	せんべい	sennbei
潰瘍	かいよう	kaiyou
萎縮	いしゅく	ishuku
全貌	ぜんぼう	zennbou
裾野	すその	susono
串揚げ	くしあげ	kushiage
蹴る	ける	keru
眉間	みけん	mikenn
冷麺	れいめん	reimenn
両脇	りょうわき	ryouwaki
整頓	せいとん	seitonn
痩身	そうしん	soushinn
采配	さいはい	saihai
煎茶	せんちゃ	senncha
麻呂	まろ	maro
製麺	せいめん	seimenn
餅つき	もちつき	mochitsuki
軽蔑	けいべつ	keibetsu
狙える	ねらえる	neraeru
塩尻	しおじり	shiojiri
薬膳	やくぜん	yakuzenn
比喩	ひゆ	hiyu
風貌	ふうぼう	fuubou
宛先	あてさき	atesaki
錦糸	きんし	kinnshi
恣意	しい	shii
謎解き	なぞとき	nazotoki
叱り	しかり	shikari
乞う	こう	kou
拭く	ふく	fuku
抱き枕	だきまくら	dakimakura
灯籠	とうろう|どうろう	tourou|dourou
脊椎	せきつい	sekitsui
雑巾	ぞうきん	zoukinn
巾着	きんちゃく|ぎんちゃく	kinnchaku|ginnchaku
残骸	ざんがい	zanngai
捻挫	ねんざ	nennza
死骸	しがい	shigai
もの凄い	ものすごい	monosugoi
中韓	ちゅうかん	chuukann
貪欲	とんよく|どんよく	tonnyoku|donnyoku
呪縛	じゅばく	jubaku
賭ける	かける|がける	kakeru|gakeru
乳腺	にゅうせん	nyuusenn
喝采	かっさい	kassai
嘲笑	ちょうしょう	choushou
割り箸	わりばし	waribashi
風呂上り	ふろあがり	furoagari
断崖	だんがい	danngai
嗅覚	きゅうかく	kyuukaku
中頃	なかごろ	nakagoro
呪術	じゅじゅつ	jujutsu
萎える	なえる|しなえる	naeru|shinaeru
遡る	さかのぼる	sakanoboru
苛立ち	いらだち	iradachi
素麺	そうめん	soumenn
鬱陶しい	うっとうしい	uttoushii
戦慄	せんりつ	sennritsu
湧き水	わきみず	wakimizu
急須	きゅうす	kyuusu
哺乳	ほにゅう	honyuu
二股	ふたまた	futamata
鉄拳	てっけん	tekkenn
象牙	ぞうげ	zouge
枕元	まくらもと	makuramoto
捻出	ねんしゅつ	nennshutsu
餌食	えじき	ejiki
斑点	はんてん	hanntenn
叱る	しかる	shikaru
産駒	さんく	sannku
筋腫	きんしゅ	kinnshu
塩釜	しおがま	shiogama
唄う	うたう|うとう	utau|utou
鬱病	うつびょう	utsubyou
崖っぷち	がけっぷち	gakeppuchi
妖艶	ようえん	youenn
脱臼	だっきゅう	dakkyuu
怨念	おんねん	onnnenn
咽頭	いんとう	inntou
鍛冶屋	かじや	kajiya
巣窟	そうくつ	soukutsu
苛め	いじめ|さいなめ	ijime|sainame
罵声	ばせい	basei
腰椎	ようつい	youtsui
湧出	わきで|ゆうしゅつ	wakide|yuushutsu
沙羅	さら|しゃら	sara|shara
怨霊	おんりょう	onnryou
捕捉	ほそく	hosoku
釜飯	かまめし	kamameshi
賄賂	わいろ	wairo
狙い目	ねらいめ	neraime
頭巾	ずきん|ときん	zukinn|tokinn
浮腫	ふしゅ	fushu
留袖	とめそで	tomesode
韓日	かんにち	kannnichi
妖魔	ようま	youma
拳法	けんぽう	kennpou
石臼	いしうす	ishiusu
韓国人	かんこくじん	kannkokujinn
車椅子	くるまいす	kurumaisu
韓国語	かんこくご	kannkokugo
牛丼	ぎゅうどん	gyuudonn
前立腺	ぜんりつせん	zennritsusenn
甲状腺	こうじょうせん	koujousenn
股関節	こかんせつ	kokannsetsu
脳梗塞	のうこうそく	noukousoku
処方箋	しょほうせん	shohousenn
哺乳類	ほにゅうるい	honyuurui
顎関節	がくかんせつ	gakukannsetsu
土鍋	どなべ	donabe
虹色	にじいろ	nijiiro
爽快感	そうかいかん	soukaikann
椎間板	ついかんばん	tsuikannbann
子守唄	こもりうた	komoriuta
太極拳	たいきょくけん	taikyokukenn
稽古場	けいこじょう	keikojou
鍋料理	なべりょうり	naberyouri
天丼	てんどん	tenndonn
恣意的	しいてき	shiiteki
羞恥心	しゅうちしん	shuuchishinn
若旦那	わかだんな	wakadannna
頭蓋骨	ずがいこつ	zugaikotsu
不明瞭	ふめいりょう	fumeiryou
覚醒剤	かくせいざい	kakuseizai
昼頃	ひるごろ	hirugoro
腎不全	じんふぜん	jinnfuzenn
親子丼	おやこどん	oyakodonn