思う	おもう	omou
言う	いう|ゆう	iu|yuu
行く	いく|ゆく	iku|yuku
自分	じぶん	jibunn
場合	ばあい	baai
思い	おもい	omoi
時間	じかん	jikann
今日	きょう|こんにち	kyou|konnnichi
書く	かく|がく	kaku|gaku
知る	しる	shiru
考え	かんがえ	kanngae
読む	よむ	yomu
聞く	きく|ぎく	kiku|giku
会社	かいしゃ|がいしゃ	kaisha|gaisha
食べる	たべる	taberu
同じ	おなじ|どうじ|おんなじ	onaji|douji|onnnaji
買う	かう|こう	kau|kou
多い	おおい	ooi
作る	つくる|づくる	tsukuru|dukuru
今回	こんかい	konnkai
行う	おこなう|おこのう	okonau|okonou
高い	たかい|こうい|だかい	takai|koui|dakai
多く	おおく	ooku
生活	せいかつ	seikatsu
出来	しゅったい|しゅつらい|でき	shuttai|shutsurai|deki
少し	すこし|しょうし|すくなし	sukoshi|shoushi|sukunashi
分かる	わかる	wakaru
楽しい	たのしい	tanoshii
名前	なまえ	namae
帰る	かえる|がえる	kaeru|gaeru
今年	ことし|こんねん	kotoshi|konnnenn
本当に	ほんとうに	honntouni
強い	つよい|しい|こわい|じい|づよい	tsuyoi|shii|kowai|jii|duyoi
新しい	あたらしい	atarashii
教え	おしえ	oshie
地図	ちず	chizu
通り	とおり|どおり	toori|doori
中心	ちゅうしん	tyuushinn
言える	いえる|ゆえる	ieru|yueru
楽しみ	たのしみ	tanoshimi
近く	ちかく|じかく	chikaku|jikaku
少ない	すくない|ずくない	sukunai|zukunai
音楽	おんがく	onngaku
大会	たいかい|だいえ	taikai|daie
その後	そのご|そのあと	sonogo|sonoato
計画	けいかく	keikaku
今後	こんご	konngo
考える	かんがえる	kanngaeru
話す	はなす|ばなす	hanasu|banasu
お知らせ	おしらせ	oshirase
長い	ながい	nagai
出来る	できる	dekiru
来る	きたる|くる	kitaru|kuru
語る	かたる|がたる	kataru|gataru
高校	こうこう	koukou
お前	おまえ	omae
売る	うる	uru
歩く	あるく|ありく	aruku|ariku
合わせる	あわせる	awaseru
走る	はしる|ばしる|ぱしる	hashiru|bashiru|pashiru
作り	つくり|づくり	tsukuri|dukuri
年間	ねんかん	nennkann
会う	あう|おう	au|ou
週間	しゅうかん	shuukann
海外	かいがい	kaigai
近い	ちかい	chikai
行い	おこない|こうい|ゆい	okonai|koui|yui
土地	とち	tochi
出会い	であい	deai
交通	こうつう	koutsuu
回答	かいとう	kaitou
合う	あう|おう	au|ou
国内	こくない	kokunai
会場	かいじょう	kaijou
地元	じもと	jimoto
当社	とうしゃ	tousha
午後	ごご	gogo
答え	こたえ|いらえ|ごたえ	kotae|irae|gotae
用いる	もちいる	mochiiru
社長	しゃちょう	shatyou
先頭	せんとう	senntou
新た	あらた	arata
活用	かつよう	katsuyou
上記	じょうき	jouki
気分	きぶん	kibunn
外国	がいこく|とつくに	gaikoku|totsukuni
下記	かき	kaki
明らか	あきらか	akiraka
広い	ひろい	hiroi
楽しめる	たのしめる	tanoshimeru
思い出す	おもいだす	omoidasu
切る	きる|ぎる	kiru|giru
お話	おはなし	ohanashi
日本語	にほんご	nihonngo
同時に	どうじに	doujini
空間	あきま|くうかん	akima|kuukann
歌う	うたう|うとう	utau|utou
自体	じたい	jitai
食う	くう|ぐう	kuu|guu
電子	でんし	dennshi
計算	けいさん	keisann
工場	こうじょう|こうば	koujou|kouba
国家	こっか	kokka
電車	でんしゃ	dennsha
多数	たすう	tasuu
知れる	しれる	shireru
止め	とどめ|とめ|やめ|どめ	todome|tome|yame|dome
通る	とおる	tooru
午前	ごぜん	gozenn
市内	いちない|しない	ichinai|shinai
自ら	みずから|じら	mizukara|jira
電気	でんき	dennki
分野	ぶんや	bunnya
組合	くみあい	kumiai
会長	かいちょう	kaityou
本当	ほんとう|ほんと	honntou|honnto
明るい	あかるい	akarui
古い	ふるい|ふりい	furui|furii
当日	とうじつ	toujitsu
少女	しょうじょ|おとめ	shoujo|otome
時点	じてん	jitenn
今週	こんしゅう	konnshuu
聞こえる	きこえる	kikoeru
来年	らいねん	rainenn
当たる	あたる	ataru
毎年	まいとし|まいねん	maitoshi|mainenn
歩き	あるき|ありき	aruki|ariki
切れ	きれ|ぎれ	kire|gire
止まる	とまる|どまる|とどまる	tomaru|domaru|todomaru
後ろ	うしろ	ushiro
本来	ほんらい	honnrai
多分	たぶん	tabunn
楽しむ	たのしむ	tanoshimu
図る	はかる	hakaru
前回	ぜんかい	zennkai
半分	はんぶん	hannbunn
会話	かいわ	kaiwa
引く	ひく|びく|ぴく	hiku|biku|piku
作家	さっか	sakka
引き	ひき|びき|ぴき	hiki|biki|piki
弱い	よわい	yowai
用語	ようご	yougo
一体	いったい	ittai
考え方	かんがえかた	kanngaekata
広がる	ひろがる	hirogaru
後半	こうはん	kouhann
回る	まわる|めぐる	mawaru|meguru
分ける	わける	wakeru
今月	こんげつ	konngetsu
何とか	なんとか	nanntoka
記入	きにゅう	kinyuu
会計	かいけい	kaikei
お茶	おちゃ	otya
市長	しちょう	shityou
当たり	あたり	atari
出会う	であう|でおう	deau|deou
出場	しゅつじょう|でば	shutsujou|deba
売買	ばいばい	baibai
思い出	おもいで|おもいいづ	omoide|omoiidu
数字	すうじ	suuji
人数	にんずう|にんず|ひとかず	ninnzuu|ninnzu|hitokazu
行なう	おこなう	okonau
当店	とうてん	toutenn
夕方	ゆうがた	yuugata
母親	ははおや	hahaoya
多少	たしょう	tashou
手作り	てづくり	tedukuri
当たり前	あたりまえ	atarimae
切り	きり|ぎり	kiri|giri
学会	がっかい	gakkai
遠く	とおく|どおく	tooku|dooku
売れ	うれ	ure
を通して	をとおして	wotooshite
走り	はしり|ばしり|ぱしり	hashiri|bashiri|pashiri
近づく	ちかづく	chikaduku
原作	げんさく	gennsaku
細かい	こまかい	komakai
を通じて	をつうじて	wotsuujite
心理	しんり	shinnri
外科	げか	geka
夏休み	なつやすみ	natsuyasumi
高校生	こうこうせい	koukousei
文書	ぶんしょ|もんじょ	bunnsho|monnjo
お母さん	おかあさん	okaasann
言語	げんご|ごんご	genngo|gonngo
黒い	くろい|こくい|ぐろい	kuroi|kokui|guroi
国会	こっかい	kokkai
先週	せんしゅう	sennshuu
思わず	おもわず	omowazu
引用	いんよう	innyou
前日	ぜんじつ|まえび	zennjitsu|maebi
手紙	てがみ	tegami
組み合わせ	くみあわせ	kumiawase
合計	ごうけい	goukei
日曜日	にちようび	nichiyoubi
中止	ちゅうし	tyuushi
少なくとも	すくなくとも	sukunakutomo
作用	さよう	sayou
家電	かでん	kadenn
何で	なんで	nannde
見直し	みなおし	minaoshi
朝食	ちょうしょく|あさげ	tyoushoku|asage
晴れ	はれ|はれれ|ばれ	hare|harere|bare
父親	ちちおや	chichioya
教える	おしえる	oshieru
本体	ほんたい	honntai
店長	てんちょう	tenntyou
兄弟	きょうだい|けいてい	kyoudai|keitei
夕食	ゆうしょく|ゆうげ	yuushoku|yuuge
市町村	しちょうそん	shityousonn
外す	はずす|ぱずす	hazusu|pazusu
思考	しこう	shikou
来週	らいしゅう	raishuu
同じく	おなじく	onajiku
直後	ちょくご	tyokugo
店内	てんない	tennnai
土曜日	どようび	doyoubi
遠い	とおい|どおい	tooi|dooi
手当	てあて	teate
書ける	かける	kakeru
回数	かいすう	kaisuu
明け	あけ	ake
前半	ぜんはん|ぜんぱん	zennhann|zennpann
市立	いちりつ|しりつ	ichiritsu|shiritsu
広げる	ひろげる|ぴろげる	hirogeru|pirogeru
本当は	ほんとうは	honntouha
手前	てまえ|てめい	temae|temei
本社	ほんしゃ	honnsha
直前	ちょくぜん	tyokuzenn
体力	たいりょく	tairyoku
台風	たいふう	taifuu
回り	まわり|めぐり	mawari|meguri
毎回	まいかい	maikai
今朝	けさ|こんちょう	kesa|konntyou
組む	くむ|ぐむ	kumu|gumu
来店	らいてん	raitenn
科目	かもく	kamoku
毎月	まいつき|まいげつ	maitsuki|maigetsu
走行	そうこう	soukou
細い	こまかい|ほそい|ぼそい|こまい	komakai|hosoi|bosoi|komai
当て	あて	ate
毎週	まいしゅう	maishuu
直し	なおし	naoshi
半年	はんとし|はんねん	hanntoshi|hannnenn
音声	おんせい|おんじょう	onnsei|onnjou
お父さん	おとうさん	otousann
高め	たかめ	takame
地上	ちじょう	chijou
教科書	きょうかしょ	kyoukasho
日帰り	ひがえり	higaeri
今夜	こんや	konnya
活かす	いかす	ikasu
入門	にゅうもん	nyuumonn
昼食	ちゅうしょく|ちゅうじき|ひるげ	tyuushoku|tyuujiki|hiruge
知り合い	しりあい	shiriai
新人	しんじん	shinnjinn
思える	おもえる	omoeru
お昼	おひる	ohiru
近年	きんねん	kinnnenn
売上	うりあげ	uriage
人工	じんこう	jinnkou
大体	だいたい	daitai
同社	どうしゃ	dousha
地点	ちてん	chitenn
数学	すうがく|すうがっ	suugaku|suugaxtu
回し	まわし	mawashi
帰国	きこく	kikoku
電池	でんち	dennchi
日曜	にちよう	nichiyou
お答え	おこたえ	okotae
間に合う	まにあう|まにおう	maniau|maniou
本店	ほんてん	honntenn
やり方	やりかた	yarikata
記す	しるす|きす	shirusu|kisu
聞ける	きける	kikeru
姉妹	しまい	shimai
本書	ほんしょ	honnsho
通し	とおし|どおし	tooshi|dooshi
通じ	つうじ	tsuuji
内科	ないか	naika
光る	ひかる	hikaru
学科	がっか	gakka
同時	どうじ	douji
入会	にゅうかい|いりあい	nyuukai|iriai
強力	きょうりょく|ごうりき|きょうりき	kyouryoku|gouriki|kyouriki
行ける	いける|ゆける	ikeru|yukeru
電力	でんりょく	dennryoku
王国	おうこく	oukoku
半角	はんかく	hannkaku
外交	がいこう	gaikou
古く	ふるく	furuku
中国人	ちゅうごくじん	tyuugokujinn
引き出す	ひきだす	hikidasu
色んな	いろんな	ironnna
黄色	おうしょく|きいろ|こうしょく	oushoku|kiiro|koushoku
用紙	ようし	youshi
自立	じりつ	jiritsu
国土	こくど	kokudo
外れ	はずれ	hazure
新年	しんねん	shinnnenn
出来上がる	できあがる	dekiagaru
分かれ	わかれ	wakare
先行	せんこう	sennkou
出店	しゅってん|でみせ	shuttenn|demise
青春	せいしゅん	seishunn
早朝	そうちょう	soutyou
店頭	てんとう	tenntou
広がり	ひろがり	hirogari
姉さん	あねさん|ねえさん	anesann|neesann
作り方	つくりかた	tsukurikata
前記	ぜんき	zennki
歌手	かしゅ	kashu
親切	しんせつ	shinnsetsu
この間	このあいだ|このかん	konoaida|konokann
見通し	みとおし	mitooshi
自作	じさく	jisaku
店名	てんめい	tennmei
後で	あとで|うしろで	atode|ushirode
立地	りっち	ricchi
本番	ほんばん	honnbann
校長	こうちょう	koutyou
高める	たかめる	takameru
何より	なにより	naniyori
手間	てま|でま	tema|dema
答える	こたえる|ごたえる	kotaeru|gotaeru
点数	てんすう	tennsuu
何だか	なんだか	nanndaka
親父	おやじ|しんぷ|おやっ	oyaji|shinnpu|oyaxtu
天才	てんさい	tennsai
同人	どうじん|どうにん	doujinn|douninn
社内	しゃない	shanai
その間	そのかん	sonokann
高まる	たかまる	takamaru
上場	じょうじょう	joujou
金曜日	きんようび	kinnyoubi
外出	がいしゅつ	gaishutsu
絵画	かいが	kaiga
数える	かぞえる	kazoeru
大半	たいはん|たいぱん	taihann|taipann
心地	ここち|ごこち|しんじ	kokochi|gokochi|shinnji
あり方	ありかた	arikata
月曜日	げつようび	getsuyoubi
上回る	うわまわる	uwamawaru
肉体	にくたい	nikutai
合同	ごうどう	goudou
前年	ぜんねん	zennnenn
数多い	かずおおい	kazuooi
心から	こころから	kokorokara
手元	てもと	temoto
止める	とどめる|とめる|やめる|どめる	todomeru|tomeru|yameru|domeru
国語	こくご	kokugo
書き方	かきかた	kakikata
夜間	やかん	yakann
入社	にゅうしゃ	nyuusha
日時	にちじ	nichiji
来場	らいじょう	raijou
外来	がいらい	gairai
弟子	ていし|でし	teishi|deshi
通う	かよう|がよう	kayou|gayou
お寺	おてら	otera
何らかの	なんらかの	nannrakano
太る	ふとる|ぶとる	futoru|butoru
生理	せいり	seiri
後日	ごじつ|ごにち	gojitsu|gonichi
言い方	いいかた	iikata
思いつく	おもいつく	omoitsuku
土曜	どよう	doyou
合理	ごうり	gouri
分子	ぶんし	bunnshi
兄ちゃん	にいちゃん	niityann
半ば	なかば	nakaba
買える	かえる	kaeru
来月	らいげつ	raigetsu
兄さん	にいさん	niisann
正体	しょうたい|せいたい	shoutai|seitai
子会社	こがいしゃ	kogaisha
あっという間に	あっというまに	attoiumani
正当	せいとう	seitou
足元	あしもと	ashimoto
いつの間にか	いつのまにか	itsunomanika
通学	つうがく	tsuugaku
日数	にっすう|ひかず	nissuu|hikazu
立体	りったい	rittai
歩行	ほこう	hokou
工学	こうがく|こうがっ	kougaku|kougaxtu
小売	こうり	kouri
丸い	まるい|まりい	marui|marii
公立	こうりつ	kouritsu
心がけ	こころがけ	kokorogake
太い	ふとい|ぶとい	futoi|butoi
思いっきり	おもいっきり	omoikkiri
同一	どういつ	douitsu
回線	かいせん	kaisenn
何とも	なんとも	nanntomo
組み	くみ|ぐみ	kumi|gumi
心地よい	ここちよい	kokochiyoi
車内	しゃない	shanai
今や	いまや|こんや	imaya|konnya
直す	なおす	naosu
町内	ちょうない|まちうち	tyounai|machiuchi
力強い	ちからづよい	chikaraduyoi
読める	よめる	yomeru
直線	ちょくせん	tyokusenn
長時間	ちょうじかん	tyoujikann
黄色い	きいろい	kiiroi
鳴る	なる	naru
原子力	げんしりょく	gennshiryoku
体内	たいない	tainai
本線	ほんせん	honnsenn
地理	ちり	chiri
何と	なんと	nannto
少数	しょうすう	shousuu
同行	どうこう|どうぎょう	doukou|dougyou
地形	ちけい|じぎょう	chikei|jigyou
買い上げ	かいあげ	kaiage
目線	めせん	mesenn
話しかける	はなしかける	hanashikakeru
お話し	おはなし	ohanashi
売れる	うれる	ureru
歩道	ほどう	hodou
同日	どうじつ	doujitsu
気楽	きらく	kiraku
名作	めいさく	meisaku
野生	やせい	yasei
作れる	つくれる	tsukureru
直ぐ	すぐ	sugu
話し合い	はなしあい	hanashiai
売り上げ	うりあげ	uriage
友だち	ともだち	tomodachi
一同	いちどう	ichidou
お手数	おてかず|おてすう	otekazu|otesuu
やって来る	やってくる	yattekuru
間近	まぢか|まじか	madika|majika
出番	でばん	debann
時に	ときに	tokini
わが国	わがくに	wagakuni
画家	がか	gaka
引き上げ	ひきあげ	hikiage
会合	かいごう	kaigou
鳴らす	ならす	narasu
後方	こうほう|のちかた	kouhou|nochikata
原点	げんてん	genntenn
人前	にんまえ|ひとまえ	ninnmae|hitomae
通す	とおす|どおす	toosu|doosu
親友	しんゆう	shinnyuu
売り切れ	うりきれ	urikire
回す	まわす	mawasu
切ない	せつない	setsunai
青少年	せいしょうねん	seishounenn
出前	でまえ	demae
気合	きあい	kiai
作り出す	つくりだす	tsukuridasu
同年	どうねん	dounenn
新書	しんしょ	shinnsho
通い	かよい|がよい	kayoi|gayoi
姉ちゃん	ねえちゃん	neetyann
牛肉	ぎゅうにく	gyuuniku
算出	さんしゅつ	sannshutsu
女子高	じょしこう	joshikou
思ふ	おもふ	omofu
お家	おいえ|おうち	oie|ouchi
交わす	かわす	kawasu
当方	とうほう	touhou
前方	ぜんぽう|まえかた	zennpou|maekata
強引	ごういん	gouinn
目当て	めあて	meate
歩ける	あるける	arukeru
歩む	あゆむ	ayumu
水曜日	すいようび	suiyoubi
火曜日	かようび	kayoubi
年数	ねんすう	nennsuu
交える	まじえる	majieru
外見	がいけん|そとみ	gaikenn|sotomi
直ちに	ただちに	tadachini
万が一	まんがいち	manngaichi
新車	しんしゃ	shinnsha
話し合う	はなしあう|はなしおう	hanashiau|hanashiou
休止	きゅうし	kyuushi
前作	ぜんさく	zennsaku
合間	あいま	aima
歩み	あゆみ	ayumi
作り上げる	つくりあげる	tsukuriageru
語学	ごがく|ごがっ	gogaku|gogaxtu
切れる	きれる|ぎれる	kireru|gireru
来れる	これる	koreru
会える	あえる	aeru
組み立て	くみたて	kumitate
鳴く	なく	naku
計上	けいじょう	keijou
元年	がんねん	gannnenn
知らせ	しらせ	shirase
月曜	げつよう	getsuyou
方言	ほうげん	hougenn
色合い	いろあい	iroai
通じる	つうじる	tsuujiru
明かす	あかす	akasu
何かと	なにかと	nanikato
歌声	うたごえ	utagoe
外人	がいじん	gaijinn
見直す	みなおす	minaosu
百科	ひゃっか	hyakka
読み方	よみかた	yomikata
音色	おんしょく|ねいろ	onnshoku|neiro
食生活	しょくせいかつ	shokuseikatsu
立ち読み	たちよみ	tachiyomi
車線	しゃせん	shasenn
切手	きって|ぎって	kitte|gitte
長女	ちょうじょ|おさめ	tyoujo|osame
親しい	したしい	shitashii
教科	きょうか	kyouka
間もなく	まもなく	mamonaku
強める	つよめる	tsuyomeru
時には	ときには	tokiniha
大声	おおごえ|たいせい	oogoe|taisei
番地	ばんち	bannchi
生体	せいたい	seitai
分る	わかる|わける	wakaru|wakeru
引っかかる	ひっかかる	hikkakaru
売り場	うりば	uriba
木曜日	もくようび	mokuyoubi
曜日	ようび	youbi
野外	やがい	yagai
思い切る	おもいきる	omoikiru
下水道	げすいどう	gesuidou
金曜	きんよう	kinnyou
人体	じんたい|じんてい|にんてい	jinntai|jinntei|ninntei
通話	つうわ	tsuuwa
社名	しゃめい	shamei
海水	かいすい	kaisui
家計	かけい	kakei
名言	めいげん	meigenn
茶色	ちゃいろ	tyairo
言い出す	いいだす	iidasu
自力	じりき	jiriki
教わる	おそわる	osowaru
長文	ちょうぶん	tyoubunn
同市	どうし	doushi
国内外	こくないがい	kokunaigai
声明	せいめい|しょうみょう	seimei|shoumyou
北東	ほくとう	hokutou
食らう	くらう	kurau
番手	ばんて	bannte
知り合う	しりあう|しりおう	shiriau|shiriou
引け	ひけ|びけ|ぴけ	hike|bike|pike
車体	しゃたい	shatai
用地	ようち	youchi
明細	めいさい	meisai
外食	がいしょく	gaishoku
内外	ないがい|うちそと	naigai|uchisoto
近づける	ちかづける	chikadukeru
直る	なおる	naoru
何やら	なにやら	naniyara
毎朝	まいあさ	maiasa
南西	なんせい	nannsei
入国	にゅうこく	nyuukoku
自国	じこく	jikoku
親方	おやかた	oyakata
台数	だいすう	daisuu
夜明け	よあけ	yoake
道中	どうちゅう	doutyuu
何気ない	なにげない	nanigenai
何ら	なんら	nannra
高まり	たかまり	takamari
活力	かつりょく	katsuryoku
明後日	あさって|みょうごにち	asatte|myougonichi
帰り道	かえりみち	kaerimichi
売店	ばいてん	baitenn
黒人	こくじん	kokujinn
公社	こうしゃ	kousha
強風	きょうふう	kyoufuu
引きずる	ひきずる	hikizuru
国交	こっこう	kokkou
書道	しょどう	shodou
作文	さくぶん	sakubunn
多め	おおめ	oome
前線	ぜんせん	zennsenn
風水	ふうすい	fuusui
フランス語	ふらんすご	furannsugo
当てはまる	あてはまる	atehamaru
弱点	じゃくてん	jakutenn
入園	にゅうえん	nyuuenn
手首	てくび	tekubi
当分	とうぶん	toubunn
数少ない	かずすくない	kazusukunai
手書き	てがき|てかき	tegaki|tekaki
当てる	あてる	ateru
気合い	きあい	kiai
光学	こうがく|こうがっ	kougaku|kougaxtu
土台	どだい	dodai
活気	かっき	kakki
父母	ちちはは|ふぼ	chichihaha|fubo
思いやり	おもいやり	omoiyari
本数	ほんすう	honnsuu
万一	まんいち	mannichi
合体	がったい	gattai
月間	げっかん	gekkann
古書	こしょ	kosho
見合い	みあい	miai
強まる	つよまる	tsuyomaru
広まる	ひろまる	hiromaru
細か	こまか|さいか	komaka|saika
当り	あたり	atari
母さん	かあさん	kaasann
通算	つうさん	tsuusann
風土	ふうど|ふど	fuudo|fudo
白色	しろいろ|はくしょく	shiroiro|hakushoku
王朝	おうちょう	outyou
年内	ねんない	nennnai
半日	はんにち|はんじつ	hannnichi|hannjitsu
多大	ただい	tadai
何だ	なんだ	nannda
学長	がくちょう	gakutyou
半数	はんすう	hannsuu
広め	ひろめ	hirome
晴天	せいてん	seitenn
文字通り	もじどおり	mojidoori
出会える	であえる	deaeru
道のり	みちのり	michinori
親しみ	したしみ	shitashimi
黒字	くろじ	kuroji
明かり	あかり	akari
細工	さいく|ざいく	saiku|zaiku
合金	ごうきん	goukinn
計る	はかる	hakaru
行える	おこなえる	okonaeru
自家	じか	jika
強み	つよみ	tsuyomi
算数	さんすう	sannsuu
昼休み	ひるやすみ	hiruyasumi
国王	こくおう	kokuou
書記	しょき	shoki
強行	きょうこう	kyoukou
見当たる	みあたる	miataru
知らせる	しらせる	shiraseru
赤色	あかいろ|せきしょく	akairo|sekishoku
言うまでもない	いうまでもない	iumademonai
夏場	なつば	natsuba
番外	ばんがい	banngai
目前	もくぜん	mokuzenn
走り回る	はしりまわる	hashirimawaru
手当て	てあて	teate
友の会	とものかい	tomonokai
立ち止まる	たちどまる	tachidomaru
時空	じくう	jikuu
下回る	したまわる	shitamawaru
内心	ないしん	naishinn
南東	なんとう	nanntou
食後	しょくご	shokugo
王道	おうどう	oudou
直売	ちょくばい	tyokubai
国体	こくたい	kokutai
食用	しょくよう	shokuyou
出回る	でまわる	demawaru
何もかも	なにもかも	nanimokamo
今さら	いまさら	imasara
語り合う	かたりあう|かたりおう	katariau|katariou
分科	ぶんか	bunnka
聞かす	きかす	kikasu
父さん	とうさん	tousann
合える	あえる	aeru
弱る	よわる	yowaru
鳴き声	なきごえ	nakigoe
用水	ようすい	yousui
足場	あしば	ashiba
名門	めいもん	meimonn
食する	しょくする	shokusuru
口元	くちもと	kuchimoto
水曜	すいよう	suiyou
天体	てんたい	tenntai
木工	もっこう|もく	mokkou|moku
母校	ぼこう	bokou
合コン	ごうこん	goukonn
作画	さくが	sakuga
多用	たよう	tayou
見分け	みわけ	miwake
国外	こくがい	kokugai
赤外線	せきがいせん	sekigaisenn
思い切り	おもいきり	omoikiri
思いつき	おもいつき	omoitsuki
山行	さんこう	sannkou
鳴り	なり	nari
手話	しゅわ	shuwa
組立	くみたて	kumitate
生後	せいご	seigo
今時	いまどき	imadoki
ピンク色	ぴんくいろ	pinnkuiro
長生き	ながいき	nagaiki
遠足	えんそく	ennsoku
空母	くうぼ	kuubo
色気	いろけ	iroke
古今	こきん|ここん	kokinn|kokonn
やり直し	やりなおし	yarinaoshi
理学	りがく|りがっ	rigaku|rigaxtu
合図	あいず	aizu
話せる	はなせる	hanaseru
お方	おかた	okata
丸ごと	まるごと	marugoto
日の丸	ひのまる	hinomaru
新春	しんしゅん	shinnshunn
太もも	ふともも	futomomo
分かれる	わかれる	wakareru
明白	めいはく	meihaku
丸出し	まるだし	marudashi
まとめ買い	まとめがい	matomegai
絵かき	えかき	ekaki
引き下げ	ひきさげ	hikisage
原画	げんが	gennga
同点	どうてん	doutenn
直近	ちょっきん	tyokkinn
円形	えんけい	ennkei
思い入れ	おもいいれ	omoiire
里親	さとおや	satooya
売春	ばいしゅん	baishunn
新米	しんまい	shinnmai
帰す	かえす|きす	kaesu|kisu
見合う	みあう|みおう	miau|miou
通れる	とおれる	tooreru
原文	げんぶん	gennbunn
同名	どうめい	doumei
馬車	ばしゃ	basha
木曜	もくよう	mokuyou
電線	でんせん	dennsenn
活字	かつじ	katsuji
引き分け	ひきわけ	hikiwake
何しろ	なにしろ	nanishiro
当る	あたる|あてる	ataru|ateru
走り出す	はしりだす	hashiridasu
少なめ	すくなめ	sukuname
足首	あしくび	ashikubi
強気	つよき	tsuyoki
止む	やむ	yamu
岩場	いわば	iwaba
読み上げる	よみあげる	yomiageru
思春	ししゅん	shishunn
引手	ひきて	hikite
顔色	かおいろ|がんしょく	kaoiro|gannshoku
頭上	ずじょう	zujou
中高年	ちゅうこうねん	tyuukounenn
何時も	いつも	itsumo
山歩き	やまあるき	yamaaruki
台本	だいほん	daihonn
生前	せいぜん	seizenn
一読	いちどく	ichidoku
風力	ふうりょく	fuuryoku
校内	こうない	kounai
行き先	いきさき|ゆきさき	ikisaki|yukisaki
人間ドック	にんげんどっく	ninngenndokku
心強い	こころづよい	kokoroduyoi
わが家	わがや	wagaya
細長い	ほそながい	hosonagai
見当	けんとう|みあた	kenntou|miata
鳴き	なき	naki
活きる	いきる	ikiru
白書	はくしょ	hakusho
光線	こうせん	kousenn
日当たり	ひあたり	hiatari
自生	じせい	jisei
組合せ	くみあわせ	kumiawase
冬場	ふゆば	fuyuba
口頭	こうとう	koutou
あっという間	あっというま	attoiuma
社交	しゃこう	shakou
通行止め	つうこうどめ	tsuukoudome
考古学	こうこがく	koukogaku
新入生	しんにゅうせい	shinnnyuusei
心中	しんじゅう|しんちゅう	shinnjuu|shinntyuu
手引き	てびき	tebiki
思い立つ	おもいたつ	omoitatsu
交番	こうばん	koubann
色づく	いろづく	iroduku
文体	ぶんたい	bunntai
切り口	きりくち	kirikuchi
知らす	しらす	shirasu
茶道	さどう|ちゃどう	sadou|tyadou
ただ今	ただいま	tadaima
言い聞かせる	いいきかせる	iikikaseru
首長	しゅちょう	shutyou
前夜	ぜんや	zennya
話し方	はなしかた	hanashikata
通気	つうき	tsuuki
社外	しゃがい	shagai
近日	きんじつ	kinnjitsu
本国	ほんごく	honngoku
何時	いつ|なんどき	itsu|nanndoki
きめ細かい	きめこまかい	kimekomakai
回帰	かいき	kaiki
見回す	みまわす	mimawasu
汽車	きしゃ|ぎしゃ	kisha|gisha
見知らぬ	みしらぬ	mishiranu
図形	ずけい	zukei
年明け	としあけ|ねんあけ	toshiake|nennake
合せ	あわせ|がっせ	awase|gasse
口内	こうない	kounai
羽目	はめ|ばめ	hame|bame
止る	とまる|やめる|とめる|どまる|とどまる	tomaru|yameru|tomeru|domaru|todomaru
明太子	めんたいこ	menntaiko
名店	めいてん	meitenn
火曜	かよう	kayou
言い分	いいぶん	iibunn
分かつ	わかつ	wakatsu
高分子	こうぶんし	koubunnshi
男前	おとこまえ	otokomae
長引く	ながびく	nagabiku
黒色	こくしょく|くろいろ	kokushoku|kuroiro
羽毛	うもう	umou
細やか	こまやか|ささやか|ほそやか	komayaka|sasayaka|hosoyaka
遠ざかる	とおざかる	toozakaru
同月	どうげつ	dougetsu
地中	ちちゅう	chityuu
音頭	おんど	onndo
年長	ねんちょう	nenntyou
風合い	ふうあい	fuuai
用心	ようじん	youjinn
日食	にっしょく	nisshoku
語りかける	かたりかける	katarikakeru
風車	かざぐるま|ふうしゃ	kazaguruma|fuusha
計り	はかり|ばかり	hakari|bakari
方角	ほうがく	hougaku
細め	ほそめ	hosome
室長	しつちょう	shitsutyou
行き来	いきき|ゆきき	ikiki|yukiki
今にも	いまにも	imanimo
親王	しんのう	shinnnou
一直線	いっちょくせん	ittyokusenn
丸める	まるめる	marumeru
長め	ながめ	nagame
海中	かいちゅう	kaityuu
音楽家	おんがくか	onngakuka
外せる	はずせる	hazuseru
外れる	はずれる	hazureru
少子	しょうし	shoushi
組み合わせる	くみあわせる	kumiawaseru
食道	しょくどう	shokudou
三角形	さんかっけい	sannkakkei
春休み	はるやすみ	haruyasumi
太刀	たち|だち	tachi|dachi
通りすがり	とおりすがり	toorisugari
書き下ろす	かきおろす	kakiorosu
当番	とうばん	toubann
色紙	いろがみ|しきし	irogami|shikishi
朝市	あさいち	asaichi
当の	とうの	touno
本会	ほんかい	honnkai
点字	てんじ	tennji
白紙	はくし|しらかみ	hakushi|shirakami
学内	がくない	gakunai
走れる	はしれる	hashireru
目の当たり	まのあたり|めのあたり	manoatari|menoatari
体外	たいがい	taigai
元来	がんらい	gannrai
歩き回る	あるきまわる	arukimawaru
親しむ	したしむ	shitashimu
国歌	こっか	kokka
出社	しゅっしゃ	shussha
明言	めいげん	meigenn
一新	いっしん	isshinn
当人	とうにん	touninn
売場	うりば	uriba
直下	ちょっか|じきげ	tyokka|jikige
後ほど	のちほど	nochihodo
家出	いえで	iede
一線	いっせん	issenn
親会社	おやがいしゃ	oyagaisha
何れ	いずれ|どれ	izure|dore
引き上げる	ひきあげる	hikiageru
作風	さくふう	sakufuu
色とりどり	いろとりどり	irotoridori
中高生	ちゅうこうせい	tyuukousei
夏バテ	なつばて	natsubate
直に	じかに|じきに	jikani|jikini
食パン	しょくぱん	shokupann
台地	だいち	daichi
昼前	ひるまえ	hirumae
場内	じょうない	jounai
作中	さくちゅう	sakutyuu
回生	かいせい	kaisei
本心	ほんしん	honnshinn
母ちゃん	かあちゃん	kaatyann
切り上げ	きりあげ	kiriage
売り出し	うりだし	uridashi
万引き	まんびき	mannbiki
肉食	にくしょく|にくじき	nikushoku|nikujiki
大当たり	おおあたり	ooatari
矢先	やさき	yasaki
冬休み	ふゆやすみ	fuyuyasumi
見合わせ	みあわせ	miawase
園長	えんちょう	enntyou
歌人	かじん|うたびと	kajinn|utabito
朝顔	あさがお	asagao
絵文字	えもじ	emoji
いつの間に	いつのまに	itsunomani
自前	じまえ	jimae
名高い	なだかい	nadakai
新聞紙	しんぶんし	shinnbunnshi
組長	くみちょう	kumityou
晴れる	はれる	hareru
細心	さいしん	saishinn
文言	もんごん|ぶんげん	monngonn|bunngenn
今ひとつ	いまひとつ	imahitotsu
書体	しょたい	shotai
朝夕	あさゆう|ちょうせき	asayuu|tyouseki
明け方	あけがた	akegata
色っぽい	いろっぽい	iroppoi
行楽	こうらく	kouraku
立ち直る	たちなおる	tachinaoru
昼夜	ちゅうや|ひるよる	tyuuya|hiruyoru
書き出し	かきだし	kakidashi
食肉	しょくにく	shokuniku
点く	つく|づく	tsuku|duku
先行き	さきゆき	sakiyuki
何せ	なにせ|なんせ	nanise|nannse
顔立ち	かおだち	kaodachi
耳元	みみもと	mimimoto
みじん切り	みじんぎり	mijinngiri
晴らす	はらす|ばらす	harasu|barasu
四角い	しかくい|しかきい	shikakui|shikakii
市電	しでん	shidenn
番線	ばんせん	bannsenn
春先	はるさき	harusaki
外道	げどう	gedou
絵日記	えにっき	enikki
気長	きなが	kinaga
何一つ	なにひとつ	nanihitotsu
人道	じんどう	jinndou
高学年	こうがくねん	kougakunenn
生計	せいけい	seikei
長らく	ながらく	nagaraku
思いこむ	おもいこむ	omoikomu
空き地	あきち	akichi
出家	しゅっけ	shukke
晴れ間	はれま	harema
前もって	まえもって	maemotte
同国	どうこく	doukoku
名声	めいせい	meisei
切り出し	きりだし	kiridashi
言い回し	いいまわし	iimawashi
口当たり	くちあたり	kuchiatari
前月	ぜんげつ	zenngetsu
見聞	けんぶん|けんもん	kennbunn|kennmonn
弱体	じゃくたい	jakutai
聞き入る	ききいる	kikiiru
多角	たかく|たかっ	takaku|takaxtu
分り	わかり	wakari
同い年	おないどし	onaidoshi
年会	ねんかい	nennkai
台車	だいしゃ	daisha
原生	げんせい	gennsei
交じる	まじる	majiru
遠出	とおで	toode
売上げ	うりあげ	uriage
公用	こうよう	kouyou
母国	ぼこく	bokoku
茶色い	ちゃいろい	tyairoi
親知らず	おやしらず	oyashirazu
書名	しょめい	shomei
作り直す	つくりなおす	tsukurinaosu
会食	かいしょく	kaishoku
合わす	あわす	awasu
同校	どうこう	doukou
帰れる	かえれる	kaereru
人魚	にんぎょ	ninngyo
天文台	てんもんだい	tennmonndai
見切り	みきり	mikiri
校歌	こうか	kouka
今春	こんしゅん	konnshunn
直せる	なおせる	naoseru
手記	しゅき	shuki
年来	ねんらい	nennrai
まつ毛	まつげ	matsuge
里帰り	さとがえり	satogaeri
元本	がんぽん	gannponn
馬力	ばりき	bariki
本紙	ほんし	honnshi
気体	きたい	kitai
思い通り	おもいどおり	omoidoori
見晴らし	みはらし	miharashi
売国	ばいこく	baikoku
今夏	こんか	konnka
親近	しんきん	shinnkinn
強大	きょうだい	kyoudai
顔つき	かおつき	kaotsuki
白米	はくまい	hakumai
手羽	てば	teba
先方	せんぽう|さきがた	sennpou|sakigata
教頭	きょうとう	kyoutou
教え子	おしえご	oshiego
公文書	こうぶんしょ	koubunnsho
小切手	こぎって	kogitte
通夜	つや	tsuya
交わる	まじわる	majiwaru
市外	しがい	shigai
後回し	あとまわし	atomawashi
半生	はんせい|はんしょう|はんなま	hannsei|hannshou|hannnama
黒毛	くろげ	kuroge
後見	こうけん|うしろみ	koukenn|ushiromi
思い当たる	おもいあたる	omoiataru
雪国	ゆきぐに	yukiguni
食える	くえる	kueru
風通し	かざとおし|かぜとおし	kazatooshi|kazetooshi
読本	とくほん|よみほん|どくほん	tokuhonn|yomihonn|dokuhonn
間合い	まあい	maai
心当たり	こころあたり	kokoroatari
近海	きんかい	kinnkai
引き金	ひきがね	hikigane
一室	いっしつ	isshitsu
遠回り	とおまわり	toomawari
弱気	よわき	yowaki
茶室	ちゃしつ	tyashitsu
後手	ごて|うしろで	gote|ushirode
ひと言	ひとこと	hitokoto
理工	りこう	rikou
考え直す	かんがえなおす	kanngaenaosu
引数	ひきすう	hikisuu
組める	くめる	kumeru
週休	しゅうきゅう	shuukyuu
思いやる	おもいやる	omoiyaru
文字数	もじすう	mojisuu
出来高	できだか	dekidaka
記名	きめい	kimei
顔ぶれ	かおぶれ	kaobure
場外	じょうがい	jougai
行きつけ	いきつけ|ゆきつけ	ikitsuke|yukitsuke
社寺	しゃじ	shaji
町家	まちや|ちょうか	machiya|tyouka
前売り	まえうり	maeuri
小高い	こだかい	kodakai
後場	ごば	goba
入室	にゅうしつ	nyuushitsu
つき合う	つきあう|つきおう	tsukiau|tsukiou
父ちゃん	とうちゃん	toutyann
雪だるま	ゆきだるま	yukidaruma
食いつく	くいつく	kuitsuku
近親	きんしん	kinnshinn
目元	めもと	memoto
読み直す	よみなおす	yominaosu
船内	せんない	sennnai
人見知り	ひとみしり	hitomishiri
国公立	こくこうりつ|こっこうりつ	kokukouritsu|kokkouritsu
小声	こごえ	kogoe
引き立て	ひきたて	hikitate
番台	ばんだい	banndai
自室	じしつ	jishitsu
当てはめる	あてはめる	atehameru
線引き	せんひき|せんびき	sennhiki|sennbiki
毛糸	けいと	keito
出国	しゅっこく	shukkoku
今秋	こんしゅう	konnshuu
出頭	しゅっとう	shuttou
内地	ないち	naichi
当直	とうちょく	toutyoku
見せ場	みせば	miseba
大理石	だいりせき	dairiseki
丸見え	まるみえ	marumie
たった今	たったいま	tattaima
絵図	えず	ezu
売れ行き	うれゆき	ureyuki
語らう	かたらう	katarau
原本	げんぽん	gennponn
出船	しゅっせん|でふね|でぶね	shussenn|defune|debune
千切り	せんぎり|ちぎり	senngiri|chigiri
思い知らす	おもいしらす	omoishirasu
考古	こうこ	kouko
自公	じこう	jikou
お作り	おつくり	otsukuri
切に	せつに	setsuni
船体	せんたい	senntai
土間	どま	doma
引き合い	ひきあい	hikiai
弱火	よわび	yowabi
算入	さんにゅう	sannnyuu
四角	しかく|よつかど|しかっ	shikaku|yotsukado|shikaxtu
切らす	きらす	kirasu
千秋楽	せんしゅうらく	sennshuuraku
古文書	こもんじょ	komonnjo
羽ばたく	はばたく	habataku
弓道	きゅうどう	kyuudou
弱まる	よわまる	yowamaru
立ち会う	たちあう|たちおう	tachiau|tachiou
上書き	うわがき	uwagaki
数理	すうり	suuri
ついて行く	ついていく|ついてゆく	tsuiteiku|tsuiteyuku
体長	たいちょう	taityou
読み書き	よみかき	yomikaki
立て直し	たてなおし	tatenaoshi
野心	やしん	yashinn
生理学	せいりがく	seirigaku
自白	じはく	jihaku
耳鳴り	みみなり	miminari
書き上げる	かきあげる	kakiageru
同店	どうてん	doutenn
直角	ちょっかく	tyokkaku
音読	おんどく	onndoku
歌える	うたえる	utaeru
頭文字	かしらもじ	kashiramoji
広める	ひろめる	hiromeru
引当	ひきあて	hikiate
言い合う	いいあう|いいおう	iiau|iiou
車台	しゃだい	shadai
風土記	ふどき	fudoki
読み手	よみて	yomite
線形	せんけい	sennkei
思いがけない	おもいがけない	omoigakenai
市バス	しばす	shibasu
遠のく	とおのく	toonoku
肉まん	にくまん	nikumann
行き交う	いきかう|ゆきかう|いきこう|ゆきこう	ikikau|yukikau|ikikou|yukikou
長ける	たける	takeru
茶の間	ちゃのま	tyanoma
戸数	こすう	kosuu
親交	しんこう	shinnkou
細道	ほそみち	hosomichi
人間らしい	にんげんらしい	ninngennrashii
当会	とうかい	toukai
通行人	つうこうにん	tsuukouninn
公売	こうばい	koubai
買い方	かいかた	kaikata
買い手	かいて	kaite
左記	さき	saki
工学科	こうがっか|こうがくか	kougakka|kougakuka
交ぜる	まぜる	mazeru
何だかんだ	なんだかんだ	nanndakannda
切れ目	きれめ	kireme
思い思い	おもいおもい	omoiomoi
名画	めいが	meiga
草食	そうしょく	soushoku
丸み	まるみ	marumi
王家	おうけ	ouke
引き立つ	ひきたつ	hikitatsu
生長	せいちょう	seityou
小心	しょうしん|しあおしん	shoushinn|shiaoshinn
弱める	よわめる	yowameru
書き手	かきて	kakite
秋刀魚	さんま	sannma
出し合う	だしあう|だしおう	dashiau|dashiou
合気道	あいきどう	aikidou
母音	ぼいん|ぼおん	boinn|boonn
立会う	たちあう|たちおう	tachiau|tachiou
父上	ちちうえ	chichiue
長方形	ちょうほうけい	tyouhoukei
分校	ぶんこう	bunnkou
合算	がっさん	gassann
小道	こみち	komichi
ラテン語	らてんご	ratenngo
書き直し	かきなおし	kakinaoshi
回せる	まわせる	mawaseru
色あせる	いろあせる	iroaseru
公家	くげ	kuge
出直し	でなおし	denaoshi
王室	おうしつ	oushitsu
合わさる	あわさる	awasaru
昼下がり	ひるさがり	hirusagari
自家用車	じかようしゃ	jikayousha
通ずる	つうずる	tsuuzuru
聞える	きこえる	kikoeru
家人	かじん|けにん	kajinn|keninn
手直し	てなおし	tenaoshi
人通り	ひとどおり	hitodoori
見分ける	みわける	miwakeru
年少	ねんしょう	nennshou
弱み	よわみ	yowami
分光	ぶんこう	bunnkou
買上げ	かいあげ	kaiage
見計らう	みはからう	mihakarau
国内線	こくないせん	kokunaisenn
字体	じたい	jitai
細分	さいぶん	saibunn
自画	じが	jiga
土用	どよう	doyou
一石二鳥	いっせきにちょう	issekinityou
空売り	からうり	karauri
そよ風	そよかぜ	soyokaze
父兄	ふけい	fukei
食い止める	くいとめる	kuitomeru
つかの間	つかのま	tsukanoma
町会	ちょうかい	tyoukai
知力	ちりょく	chiryoku
今どき	いまどき	imadoki
顔出し	かおだし	kaodashi
聞き手	ききて	kikite
黒っぽい	くろっぽい	kuroppoi
時分	じぶん	jibunn
立ち回り	たちまわり	tachimawari
外気	がいき	gaiki
思しい	おぼしい	oboshii
交わり	まじわり	majiwari
絵手紙	えてがみ	etegami
太め	ふとめ	futome
目新しい	めあたらしい	meatarashii
秋晴れ	あきばれ	akibare
声楽	せいがく	seigaku
組み立てる	くみたてる	kumitateru
強弱	きょうじゃく	kyoujaku
日夜	にちや	nichiya
国力	こくりょく	kokuryoku
茶会	ちゃかい	tyakai
夜食	やしょく	yashoku
肉じゃが	にくじゃが	nikujaga
売り出す	うりだす	uridasu
番頭	ばんがしら|ばんとう	banngashira|banntou
国名	こくめい	kokumei
天地人	てんちじん	tennchijinn
古文	こぶん	kobunn
画す	かくす	kakusu
心電図	しんでんず	shinndennzu
顔合わせ	かおあわせ	kaoawase
時間切れ	じかんぎれ	jikanngire
時として	ときとして	tokitoshite
前科	ぜんか	zennka
会す	かいす|くわす	kaisu|kuwasu
下書き	したがき	shitagaki
後見人	こうけんにん	koukennninn
買出し	かいだし	kaidashi
正方形	せいほうけい	seihoukei
店先	みせさき	misesaki
親日	しんにち	shinnnichi
買春	ばいしゅん|かいしゅん	baishunn|kaishunn
同町	どうちょう	doutyou
語り口	かたりくち	katarikuchi
と同時に	とどうじに	todoujini
八百長	やおちょう	yaotyou
古び	ふるび	furubi
遠心	えんしん	ennshinn
直立	ちょくりつ	tyokuritsu
弱小	じゃくしょう	jakushou
多年草	たねんそう	tanennsou
外車	がいしゃ	gaisha
心がける	こころがける	kokorogakeru
数え切れる	かぞえきれる	kazoekireru
思い知る	おもいしる	omoishiru
買いもの	かいもの	kaimono
後年	こうねん	kounenn
ひき肉	ひきにく	hikiniku
子分	こぶん	kobunn
家来	けらい|げらい	kerai|gerai
買い出し	かいだし	kaidashi
強がる	つよがる	tsuyogaru
来す	きたす	kitasu
こぼれ話	こぼればなし	koborebanashi
岩魚	いわな	iwana
合作	がっさく	gassaku
心細い	こころぼそい	kokorobosoi
出自	しゅつじ	shutsuji
交友	こうゆう	kouyuu
前足	まえあし	maeashi
広角	こうかく	koukaku
やり直す	やりなおす	yarinaosu
遠目	とおめ	toome
遠ざける	とおざける	toozakeru
新風	しんぷう	shinnpuu
語れる	かたれる	katareru
風光	ふうこう	fuukou
引ける	ひける|びける	hikeru|bikeru
母方	ははかた	hahakata
聞き出す	ききだす	kikidasu
秋風	あきかぜ|しゅうふう	akikaze|shuufuu
出方	でかた	dekata
地すべり	じすべり	jisuberi
日当り	ひあたり	hiatari
黄ばむ	きばむ	kibamu
言い切る	いいきる	iikiru
空回り	からまわり	karamawari
見本市	みほんいち	mihonnichi
頭数	あたまかず|とうすう	atamakazu|tousuu
顔見知り	かおみしり	kaomishiri
高らか	たからか	takaraka
上体	じょうたい	joutai
古紙	こし	koshi
家元	いえもと	iemoto
通風	つうふう	tsuufuu
台紙	だいし	daishi
公金	こうきん	koukinn
空き家	あきや	akiya
心ゆく	こころゆく	kokoroyuku
かみ合う	かみあう|かみおう	kamiau|kamiou
考え出す	かんがえだす	kanngaedasu
立会	たちあい|たちあえ	tachiai|tachiae
小数点	しょうすうてん	shousuutenn
気道	きどう	kidou
出合う	であう|でおう	deau|deou
点心	てんしん	tennshinn
足止め	あしどめ	ashidome
組立て	くみたて	kumitate
あっと言う間に	あっというまに	attoiumani
水切り	みずきり	mizukiri
ほど遠い	ほどとおい	hodotooi
元通り	もとどおり	motodoori
形作る	かたちづくる	katachidukuru
風雨	ふうう	fuuu
黒ずみ	くろずみ	kurozumi
母上	ははうえ	hahaue
原石	げんせき	gennseki
出し切る	だしきる	dashikiru
かみ合わせ	かみあわせ	kamiawase
思いがける	おもいがける	omoigakeru
後記	こうき	kouki
通り道	とおりみち	toorimichi
何分	なにぶん	nanibunn
太字	ふとじ	futoji
すき間	すきま	sukima
言わす	いわす	iwasu
立国	りっこく	rikkoku
食前	しょくぜん	shokuzenn
切り分け	きりわけ	kiriwake
新茶	しんちゃ	shinntya
道しるべ	みちしるべ	michishirube
竹刀	しない	shinai
立春	りっしゅん	risshunn
分家	ぶんけ	bunnke
木馬	もくば	mokuba
活魚	いけうお|かつぎょ	ikeuo|katsugyo
星雲	せいうん	seiunn
自ずと	おのずと	onozuto
明ける	あける	akeru
校門	こうもん	koumonn
電光	でんこう	dennkou
室内楽	しつないがく	shitsunaigaku
言わば	いわば|ゆわば	iwaba|yuwaba
黒船	くろふね	kurofune
下図	かず|したず	kazu|shitazu
分数	ぶんすう	bunnsuu
目頭	めがしら	megashira
科す	かす	kasu
下線	かせん	kasenn
言いなり	いいなり	iinari
高み	たかみ	takami
月明かり	つきあかり	tsukiakari
食べもの	たべもの	tabemono
雪かき	ゆきかき	yukikaki
小分け	こわけ	kowake
手引	てびき	tebiki
右記	うき	uki
声高	こわだか	kowadaka
同室	どうしつ	doushitsu
小回り	こまわり	komawari
今一つ	いまひとつ	imahitotsu
強火	つよび	tsuyobi
工大	こうだい	koudai
売り手	うりて	urite
来社	らいしゃ	raisha
聞き分け	ききわけ	kikiwake
何でもかんでも	なんでもかんでも	nanndemokanndemo
見切る	みきる	mikiru
古風	こふう	kofuu
組み入れる	くみいれる	kumiireru
思いきり	おもいきり	omoikiri
売り子	うりこ	uriko
当行	とうこう	toukou
何もの	なにもの	nanimono
上下水道	じょうげすいどう	jougesuidou
西北	せいほく|しーぺい|にしきた	seihoku|shi-pei|nishikita
後ろめたい	うしろめたい	ushirometai
室外	しつがい	shitsugai
万人	ばんにん|ばんじん|まんにん	bannninn|bannjinn|mannninn
一回	いっかい|いちかい	ikkai|ichikai
外国人	がいこくじん	gaikokujinn
何回	なんかい	nannkai
午前中	ごぜんちゅう	gozenntyuu
何人	なにびと|なんぴと|なんびと|なにじん|なんにん	nanibito|nannpito|nannbito|nanijinn|nannninn
社会人	しゃかいじん	shakaijinn
中古車	ちゅうこしゃ	tyuukosha
日米	にちべい	nichibei
数十	すうじゅう|すうじっ|すうじゅっ	suujuu|suujixtu|suujuxtu
分間	ふんかん|ぶんけん|ぷんかん	funnkann|bunnkenn|punnkann
千万	せんまん|ちよろず|せんばん	sennmann|chiyorozu|sennbann
空室	くうしつ	kuushitsu
心理学	しんりがく	shinnrigaku
数百	すーひゃく|すーひゃっ	su-hyaku|su-hyaxtu
本作	ほんさく	honnsaku
女子高生	じょしこうせい	joshikousei
何十	なんじゅう|なんじっ|なんじゅっ	nannjuu|nannjixtu|nannjuxtu
円高	えんだか	enndaka
一点	いってん	ittenn
中国語	ちゅうごくご	tyuugokugo
売上高	うりあげだか	uriagedaka
外国語	がいこくご	gaikokugo
何日	なんにち	nannnichi
少人数	しょうにんずう	shouninnzuu
数千	すうせん	suusenn
何気	なにげ	nanige
数時間	すうじかん	suujikann
時間外	じかんがい	jikanngai
点目	てんめ	tennme
作目	さくもく	sakumoku
通知書	つうちしょ	tsuuchisho
会社名	かいしゃめい	kaishamei
何百	なんびゃく|なんびゃっ	nannbyaku|nannbyaxtu
外出先	がいしゅつさき	gaishutsusaki
分科会	ぶんかかい	bunnkakai
近場	ちかば	chikaba
地下水	ちかすい	chikasui
日朝	にっちょう	nittyou
新年会	しんねんかい	shinnnennkai
社会学	しゃかいがく	shakaigaku
大多数	だいたすう	daitasuu
入店	にゅうてん	nyuutenn
顔文字	かおもじ	kaomoji
何時間	なんじかん	nannjikann
水道水	すいどうすい	suidousui
中心地	ちゅうしんち	tyuushinnchi
一時金	いちじきん	ichijikinn
新生活	しんせいかつ	shinnseikatsu
計算書	けいさんしょ	keisannsho
帰国後	きこくご	kikokugo
明細書	めいさいしょ	meisaisho
町内会	ちょうないかい	tyounaikai
何千	なんぜん	nannzenn
小売店	こうりてん	kouritenn
今作	こんさく	konnsaku
一人前	いちにんまえ|ひとりまえ	ichininnmae|hitorimae
計画書	けいかくしょ	keikakusho
社会科	しゃかいか	shakaika
走行中	そうこうちゅう	soukoutyuu
入門書	にゅうもんしょ	nyuumonnsho
小顔	こがお	kogao
図書室	としょしつ	toshoshitsu
前走	ぜんそう	zennsou
数年間	すうねんかん	suunennkann
日本刀	にっぽんとう|にほんとう	nipponntou|nihonntou
大人数	おおにんずう	ooninnzuu
数週間	すうしゅうかん	suushuukann
地内	じない	jinai
三線	さんしん	sannshinn
会場内	かいじょうない	kaijounai
南北朝	なんぼくちょう	nannbokutyou
数日間	すうじつかん	suujitsukann
力強	ちからづよ	chikaraduyo
南高	なんこう	nannkou
山野草	さんやそう	sannyasou
何万	なんまん	nannmann
語学力	ごがくりょく	gogakuryoku
大百科	だいひゃっか	daihyakka
原生林	げんせいりん	gennseirinn
地形図	ちけいず	chikeizu
思考力	しこうりょく	shikouryoku
遠赤外線	えんせきがいせん	ennsekigaisenn
黄金色	こがねいろ	koganeiro
百人一首	ひゃくにんいっしゅ	hyakuninnisshu
十二分	じゅうにぶん	juunibunn
線上	せんじょう	sennjou
新日	しんにち	shinnnichi
引当金	ひきあてきん	hikiatekinn
今日中	きょうじゅう	kyoujuu
言語学	げんごがく	genngogaku
小魚	こざかな	kozakana
音楽会	おんがくかい	onngakukai
米国人	べいこくじん	beikokujinn
地下室	ちかしつ	chikashitsu
外野手	がいやしゅ	gaiyashu
何色	なにいろ	naniiro
姉弟	してい	shitei
自走	じそう	jisou
水場	みずば	mizuba
三色	さんしょく	sannshoku
日本茶	にほんちゃ	nihonntya
地魚	じざかな	jizakana
毛先	けさき	kesaki
今年中	ことしじゅう	kotoshijuu
古書店	こしょてん	koshotenn
手羽先	てばさき	tebasaki
三時	さんじ	sannji
雪道	せつどう|ゆきみち	setsudou|yukimichi
今月中	こんげつちゅう	konngetsutyuu
番組内	ばんぐみない	bannguminai
車高	しゃこう	shakou
同会	どうかい	doukai
十八番	おはこ|じゅうはちばん	ohako|juuhachibann
社中	しゃちゅう	shatyuu
市町村長	しちょうそんちょう	shityousonntyou
中山間	ちゅうさんかん	tyuusannkann
花色	はないろ|かしょく	hanairo|kashoku
工場長	こうじょうちょう	koujoutyou