使う	つかう|つこう	tsukau|tsukou
感じ	かんじ	kannji
商品	しょうひん	shouhinn
持つ	もつ	motsu
写真	しゃしん|じゃしん	shashinn|jashinn
記事	きじ	kiji
問い合わせ	といあわせ	toiawase
仕事	しごと	shigoto
使用	しよう	shiyou
その他	そのた	sonota
受ける	うける	ukeru
研究	けんきゅう	kennkyuu
事業	じぎょう	jigyou
活動	かつどう	katsudou
意味	いみ	imi
作品	さくひん	sakuhinn
悪い	わるい|わりい|わろい	warui|warii|waroi
場所	ばしょ	basho
取る	とる|どる	toru|doru
終わる	おわる	owaru
教育	きょういく	kyouiku
全国	ぜんこく	zennkoku
お客様	おきゃくさま	okyakusama
向け	むけ	muke
予定	よてい	yotei
部分	ぶぶん	bubunn
会員	かいいん	kaiinn
相談	そうだん	soudann
飲む	のむ	nomu
相手	あいて	aite
始め	はじめ	hajime
委員	いいん	iinn
全て	すべて	subete
意見	いけん	ikenn
旅行	りょこう	ryokou
気持ち	きもち	kimochi
注文	ちゅうもん|ちゅうぶん	tyuumonn|tyuubunn
に対する	にたいする	nitaisuru
家族	かぞく	kazoku
注意	ちゅうい	tyuui
に対して	にたいして	nitaishite
理由	りゆう	riyuu
指定	してい	shitei
送る	おくる	okuru
期待	きたい	kitai
発表	はっぴょう	happyou
代表	だいひょう	daihyou
公開	こうかい	koukai
面白い	おもしろい	omoshiroi
流れ	ながれ|ながれれ	nagare|nagarere
登場	とうじょう	toujou
使い	つかい|づかい|つかわい	tsukai|dukai|tsukawai
安全	あんぜん	annzenn
待つ	まつ	matsu
年度	ねんど	nenndo
作業	さぎょう	sagyou
向かう	むかう	mukau
自身	じしん	jishinn
乗る	のる	noru
進む	すすむ	susumu
取引	とりひき	torihiki
開始	かいし	kaishi
全体	ぜんたい	zenntai
美しい	うつくしい	utsukushii
死ぬ	しぬ|じぬ	shinu|jinu
勉強	べんきょう	bennkyou
決定	けってい	kettei
話題	わだい	wadai
時期	じき	jiki
期間	きかん	kikann
発生	はっせい	hassei
放送	ほうそう	housou
美味しい	おいしい	oishii
全く	まったく	mattaku
発売	はつばい	hatsubai
目指す	めざす	mezasu
実は	じつは	jitsuha
行動	こうどう	koudou
開く	あく|ひらく|びらく|ぴらく	aku|hiraku|biraku|piraku
動画	どうが	douga
番号	ばんごう	banngou
練習	れんしゅう	rennshuu
食事	しょくじ	shokuji
全部	ぜんぶ	zennbu
始まる	はじまる	hajimaru
運動	うんどう	unndou
歯科	しか	shika
安い	やすい|やしい	yasui|yashii
様子	ようす	yousu
道路	どうろ	douro
注目	ちゅうもく	tyuumoku
発見	はっけん	hakkenn
今度	こんど	konndo
感想	かんそう	kannsou
家庭	かてい	katei
住む	すむ	sumu
心配	しんぱい	shinnpai
有名	ゆうめい	yuumei
都市	とし|まち	toshi|machi
学習	がくしゅう	gakushuu
動物	どうぶつ	doubutsu
住所	じゅうしょ	juusho
自動車	じどうしゃ	jidousha
事実	じじつ	jijitsu
起きる	おきる	okiru
有る	ある|はべる	aru|haberu
方向	ほうこう	houkou
神社	じんじゃ|かむやしろ	jinnja|kamuyashiro
打つ	うつ|ぶつ	utsu|butsu
予想	よそう	yosou
決め	きめ|ぎめ	kime|gime
決まる	きまる	kimaru
守る	まもる|もる	mamoru|moru
深い	ふかい|ぶかい|しんい	fukai|bukai|shinni
画面	がめん	gamenn
動き	うごき	ugoki
落ち	おち	ochi
用意	ようい	youi
身体	からだ|しんたい	karada|shinntai
運転	うんてん	unntenn
幸せ	しあわせ	shiawase
野球	やきゅう	yakyuu
調べ	しらべ	shirabe
負け	まけ	make
銀行	ぎんこう	ginnkou
地球	ちきゅう	chikyuu
食品	しょくひん	shokuhinn
進める	すすめる	susumeru
発送	はっそう	hassou
遊び	あそび|すさび	asobi|susabi
仕方	しかた	shikata
物語	ものがたり|ものがた	monogatari|monogata
祭り	まつり	matsuri
動く	うごく	ugoku
業者	ぎょうしゃ	gyousha
感じる	かんじる	kannjiru
鉄道	てつどう	tetsudou
発言	はつげん	hatsugenn
気軽	きがる	kigaru
病気	びょうき	byouki
全員	ぜんいん	zenninn
発行	はっこう	hakkou
交流	こうりゅう	kouryuu
問合せ	といあわせ	toiawase
勝つ	かつ|がつ|まさつ	katsu|gatsu|masatsu
業界	ぎょうかい	gyoukai
起こる	おこる	okoru
買い物	かいもの	kaimono
人物	じんぶつ	jinnbutsu
同様	どうよう	douyou
消える	きえる|ぎえる	kieru|gieru
調整	ちょうせい	tyousei
軽い	かるい|けいい|かりい	karui|keii|karii
感動	かんどう	kanndou
用品	ようひん	youhinn
遊ぶ	あそぶ|すさぶ	asobu|susabu
反対	はんたい	hanntai
具体	ぐたい	gutai
役立つ	やくだつ	yakudatsu
医院	いいん	iinn
社員	しゃいん	shainn
自転車	じてんしゃ	jitennsha
流す	ながす	nagasu
住まい	すまい|ずまい	sumai|zumai
集め	あつめ	atsume
息子	むすこ	musuko
向上	こうじょう	koujou
植物	しょくぶつ	shokubutsu
落とす	おとす	otosu
お待ち	おまち	omachi
申し上げる	もうしあげる	moushiageru
寒い	さむい|さぶい|さみい|さびい	samui|sabui|samii|sabii
予算	よさん	yosann
開ける	あける|ひらける|はだける	akeru|hirakeru|hadakeru
相当	そうとう	soutou
集まる	あつまる	atsumaru
起こす	おこす	okosu
次回	じかい	jikai
に対し	にたいし	nitaishi
読者	どくしゃ	dokusha
公式	こうしき	koushiki
お客	おきゃく	okyaku
路線	ろせん	rosenn
次に	つぎに	tsugini
自動	じどう	jidou
農業	のうぎょう	nougyou
事前	じぜん	jizenn
出発	しゅっぱつ	shuppatsu
使える	つかえる	tsukaeru
始まり	はじまり	hajimari
新着	しんちゃく	shinntyaku
育てる	そだてる	sodateru
出身	しゅっしん	shusshinn
整理	せいり	seiri
首相	しゅしょう	shushou
旅館	りょかん	ryokann
近所	きんじょ	kinnjo
強化	きょうか	kyouka
暑い	あつい|あちい	atsui|achii
使い方	つかいかた	tsukaikata
主人公	しゅじんこう	shujinnkou
子育て	こそだて	kosodate
集中	しゅうちゅう	shuutyuu
短い	みじかい	mijikai
定期	ていき	teiki
生命	いのち|せいめい	inochi|seimei
配送	はいそう	haisou
返す	かえす|がえす	kaesu|gaesu
去年	きょねん|こぞ	kyonenn|kozo
登山	とざん	tozann
始める	はじめる	hajimeru
決して	けっして|けして	kesshite|keshite
重い	おもい	omoi
都合	つごう	tsugou
図書館	としょかん	toshokann
次第	しだい	shidai
県内	けんない	kennnai
表記	ひょうき	hyouki
仕様	しよう	shiyou
勝ち	かち|がち	kachi|gachi
記者	きしゃ	kisha
定める	さだめる	sadameru
高級	こうきゅう	koukyuu
係る	かかる|かかわる	kakaru|kakawaru
運用	うんよう	unnyou
登る	のぼる	noboru
取り組み	とりくみ	torikumi
車両	しゃりょう	sharyou
見事	みごと	migoto
回転	かいてん	kaitenn
問う	とう	tou
取り組む	とりくむ	torikumu
返品	へんぴん	hennpinn
落ち着く	おちつく	ochitsuku
研究所	けんきゅうしょ|けんきゅうじょ	kennkyuusho|kennkyuujo
文庫	ぶんこ	bunnko
投げる	なげる	nageru
終える	おえる	oeru
列車	れっしゃ	ressha
代わり	かわり|がわり	kawari|gawari
お世話	おせわ	osewa
追う	おう	ou
化学	かがく|かがっ|ばけがく	kagaku|kagaxtu|bakegaku
乗り	のり	nori
表面	ひょうめん	hyoumenn
理事	りじ	riji
生物	せいぶつ|なまもの|いきもの	seibutsu|namamono|ikimono
助け	たすけ|すけ|だすけ	tasuke|suke|dasuke
部門	ぶもん	bumonn
長期	ちょうき	tyouki
形式	けいしき	keishiki
待ち	まち	machi
工業	こうぎょう	kougyou
出来事	できごと	dekigoto
返事	へんじ	hennji
場面	ばめん	bamenn
悲しい	かなしい|がなしい	kanashii|ganashii
飲食	いんしょく|おんじき	innshoku|onnjiki
世の中	よのなか	yononaka
代金	だいきん	daikinn
早速	さっそく	sassoku
死ねる	しねる	shineru
苦手	にがて	nigate
主人	しゅじん	shujinn
動かす	うごかす	ugokasu
方式	ほうしき	houshiki
勝負	かちまけ|しょうぶ	kachimake|shoubu
温度	おんど	onndo
運ぶ	はこぶ	hakobu
所有	しょゆう	shoyuu
思想	しそう	shisou
中身	なかみ	nakami
同意	どうい	doui
医学	いがく|いがっ	igaku|igaxtu
進行	しんこう	shinnkou
幸い	さいわい|ざいわい	saiwai|zaiwai
放題	ほうだい	houdai
役に立つ	やくにたつ	yakunitatsu
もう一度	もういちど	mouichido
入荷	にゅうか	nyuuka
負う	おう|おぶう	ou|obuu
美味い	うまい	umai
意外	いがい	igai
発電	はつでん	hatsudenn
動作	どうさ	dousa
調べる	しらべる	shiraberu
速度	そくど	sokudo
定め	さだめ	sadame
家具	かぐ	kagu
一定	いってい|いちじょう	ittei|ichijou
実感	じっかん	jikkann
集合	しゅうごう	shuugou
表す	あらわす|ひょうす	arawasu|hyousu
開き	ひらき|びらき|あき|ぴらき	hiraki|biraki|aki|piraki
出品	しゅっぴん	shuppinn
入院	にゅういん	nyuuinn
部品	ぶひん	buhinn
向こう	むこう	mukou
医者	いしゃ	isha
作者	さくしゃ	sakusha
知事	ちじ	chiji
両方	りょうほう	ryouhou
暗い	くらい|ぐらい	kurai|gurai
仕上げ	しあげ	shiage
お送り	おおくり	ookuri
育つ	そだつ	sodatsu
重ね	かさね|がさね	kasane|gasane
荷物	にもつ	nimotsu
去る	さる|ざる	saru|zaru
想い	おもい	omoi
出荷	しゅっか	shukka
部長	ぶちょう	butyou
神様	かみさま	kamisama
地下鉄	ちかてつ	chikatetsu
近代	きんだい	kinndai
本物	ほんもの	honnmono
外部	がいぶ	gaibu
多様	たよう	tayou
着物	きもの	kimono
向き	むき	muki
放つ	はなつ	hanatsu
両親	りょうしん	ryoushinn
受け取る	うけとる	uketoru
味わう	あじわう	ajiwau
食べ物	たべもの	tabemono
実に	じつに|まことに|げに	jitsuni|makotoni|geni
気温	きおん	kionn
受け入れ	うけいれ	ukeire
乗せる	のせる	noseru
高等	こうとう	koutou
買取	かいとり|かいと	kaitori|kaito
有する	ゆうする	yuusuru
具合	ぐあい|ぐわい	guai|guwai
進化	しんか	shinnka
人事	じんじ|ひとごと	jinnji|hitogoto
実力	じつりょく	jitsuryoku
決勝	けっしょう	kesshou
世間	せけん	sekenn
植える	うえる	ueru
役員	やくいん	yakuinn
取り上げ	とりあげ	toriage
仕組み	しくみ	shikumi
高度	こうど	koudo
向い	むかい|むい	mukai|mui
首都	しゅと	shuto
調理	ちょうり	tyouri
気味	きみ|ぎみ	kimi|gimi
味わい	あじわい	ajiwai
意思	いし	ishi
流れる	ながれる	nagareru
由来	ゆらい	yurai
物理	ぶつり	butsuri
第三者	だいさんしゃ	daisannsha
投手	とうしゅ	toushu
身近	みぢか|みじか	midika|mijika
運命	うんめい	unnmei
発明	はつめい	hatsumei
着い	ちゃくい|つい	tyakui|tsui
速い	はやい|ばやい	hayai|bayai
正式	せいしき	seishiki
拾う	ひろう|びろう	hirou|birou
店員	てんいん	tenninn
着く	つく	tsuku
整う	ととのう	totonou
公表	こうひょう	kouhyou
代理	だいり	dairi
決める	きめる|ぎめる	kimeru|gimeru
表紙	ひょうし|びょうし	hyoushi|byoushi
体重	たいじゅう	taijuu
申す	もうす	mousu
農家	のうか	nouka
意外と	いがいと	igaito
登り	のぼり	nobori
全身	ぜんしん	zennshinn
会館	かいかん	kaikann
教員	きょういん	kyouinn
予め	あらかじめ	arakajime
整形	せいけい	seikei
県立	けんりつ	kennritsu
発想	はっそう	hassou
急ぐ	いそぐ	isogu
開業	かいぎょう	kaigyou
開放	かいほう	kaihou
進出	しんしゅつ	shinnshutsu
決算	けっさん	kessann
落ちる	おちる	ochiru
守り	もり|まもり	mori|mamori
消し	けし	keshi
想定	そうてい	soutei
世界中	せかいじゅう	sekaijuu
動向	どうこう	doukou
意図	いと	ito
商業	しょうぎょう	shougyou
作曲	さっきょく	sakkyoku
歯医者	はいしゃ	haisha
定番	ていばん	teibann
進学	しんがく	shinngaku
温かい	あたたかい	atatakai
風味	ふうみ	fuumi
真ん中	まんなか	mannnaka
お子様	おこさま	okosama
学者	がくしゃ	gakusha
悪化	あっか	akka
真面目	まじめ	majime
助かる	たすかる	tasukaru
起動	きどう	kidou
主体	しゅたい	shutai
生き物	いきもの	ikimono
苦しい	くるしい|ぐるしい	kurushii|gurushii
お礼	おれい	orei
集会	しゅうかい	shuukai
短期	たんき	tannki
集まり	あつまり	atsumari
消化	しょうか	shouka
手軽	てがる	tegaru
交代	こうたい	koutai
表明	ひょうめい	hyoumei
全面	ぜんめん	zennmenn
様式	ようしき	youshiki
早期	そうき	souki
電波	でんぱ	dennpa
休業	きゅうぎょう	kyuugyou
運行	うんこう	unnkou
問い合せる	といあわせる	toiawaseru
乗車	じょうしゃ	jousha
見守る	みまもる	mimamoru
代行	だいこう	daikou
学問	がくもん	gakumonn
小物	こもの	komono
お湯	おゆ	oyu
強調	きょうちょう	kyoutyou
学部	がくぶ	gakubu
合意	ごうい	goui
都内	とない	tonai
投入	とうにゅう	tounyuu
名物	めいぶつ	meibutsu
自主	じしゅ	jishu
大学院	だいがくいん	daigakuinn
石油	せきゆ	sekiyu
間取り	まどり	madori
区間	くかん	kukann
決意	けつい	ketsui
区分	くぶん|くわけ	kubunn|kuwake
気配	けはい|きはい	kehai|kihai
市役所	しやくしょ	shiyakusho
平気	へいき	heiki
農薬	のうやく	nouyaku
客室	きゃくしつ	kyakushitsu
取り入れ	とりいれ	toriire
持てる	もてる	moteru
回路	かいろ	kairo
配合	はいごう	haigou
予感	よかん	yokann
実用	じつよう	jitsuyou
重なる	かさなる	kasanaru
深める	ふかめる	fukameru
後期	こうき	kouki
商売	しょうばい	shoubai
実習	じっしゅう	jisshuu
この世	このよ	konoyo
主役	しゅやく	shuyaku
庭園	ていえん	teienn
両手	もろて|りょうて	morote|ryoute
地面	じめん	jimenn
仕入れ	しいれ|しいれれ	shiire|shiirere
全力	ぜんりょく	zennryoku
西洋	せいよう	seiyou
曲がる	まがる	magaru
住人	じゅうにん	juuninn
読み取る	よみとる	yomitoru
目次	もくじ	mokuji
行列	ぎょうれつ	gyouretsu
局長	きょくちょう	kyokutyou
角度	かくど	kakudo
都会	とかい	tokai
集落	しゅうらく	shuuraku
返る	かえる|がえる	kaeru|gaeru
手配	てはい	tehai
指名	しめい	shimei
市区	しく	shiku
合宿	がっしゅく	gasshuku
配る	くばる	kubaru
名所	めいしょ|などころ	meisho|nadokoro
寺院	じいん	jiinn
強度	きょうど	kyoudo
感心	かんしん	kannshinn
手帳	てちょう	tetyou
正社員	せいしゃいん	seishainn
受注	じゅちゅう	jutyuu
発注	はっちゅう	hattyuu
反する	はんする	hannsuru
本屋	ほんや	honnya
暗号	あんごう	anngou
新品	しんぴん	shinnpinn
起業	きぎょう	kigyou
注ぐ	そそぐ|つぐ	sosogu|tsugu
落語	らくご	rakugo
取れる	とれる	toreru
対立	たいりつ	tairitsu
対決	たいけつ	taiketsu
消す	けす	kesu
流行る	はやる	hayaru
定食	ていしょく	teishoku
医薬品	いやくひん	iyakuhinn
神話	しんわ	shinnwa
工具	こうぐ	kougu
活発	かっぱつ	kappatsu
反発	はんぱつ	hannpatsu
整体	せいたい	seitai
丁度	ちょうど	tyoudo
問い	とい|どい	toi|doi
重大	じゅうだい	juudai
取り出し	とりだし	toridashi
習う	ならう|なろう	narau|narou
定員	ていいん	teiinn
半島	はんとう	hanntou
地味	じみ|ちみ	jimi|chimi
身長	しんちょう	shinntyou
役者	やくしゃ	yakusha
追いかける	おいかける	oikakeru
先進	せんしん	sennshinn
写る	うつる	utsuru
全文	ぜんぶん	zennbunn
育ち	そだち	sodachi
苦しむ	くるしむ	kurushimu
負ける	まける	makeru
泳ぐ	およぐ	oyogu
部下	ぶか	buka
着用	ちゃくよう	tyakuyou
定着	ていちゃく	teityaku
次第に	しだいに	shidaini
当局	とうきょく	toukyoku
有名人	ゆうめいじん	yuumeijinn
返答	へんとう	henntou
打ち合わせ	うちあわせ	uchiawase
有す	ゆうす	yuusu
何事	なにごと	nanigoto
負荷	ふか	fuka
洋服	ようふく	youfuku
水着	みずぎ	mizugi
受け止める	うけとめる	uketomeru
仕立て	したて|じたて	shitate|jitate
開店	かいてん	kaitenn
部員	ぶいん	buinn
気持ちよい	きもちよい	kimochiyoi
転送	てんそう	tennsou
海洋	かいよう	kaiyou
前向き	まえむき	maemuki
同期	どうき	douki
発音	はつおん	hatsuonn
真っ赤	まっか	makka
発動	はつどう	hatsudou
今年度	こんねんど	konnnenndo
仕上がり	しあがり	shiagari
世話	せわ|ぜわ	sewa|zewa
院長	いんちょう	inntyou
下着	したぎ	shitagi
子宮	しきゅう	shikyuu
代わる	かわる|がわる	kawaru|gawaru
都心	としん	toshinn
物流	ぶつりゅう	butsuryuu
飲み物	のみもの	nomimono
生息	せいそく	seisoku
一族	いちぞく	ichizoku
死体	したい	shitai
一流	いちりゅう	ichiryuu
名乗る	なのる	nanoru
金持ち	かねもち|がねもち	kanemochi|ganemochi
体育館	たいいくかん	taiikukann
相次ぐ	あいつぐ	aitsugu
駅名	えきめい	ekimei
階級	かいきゅう	kaikyuu
学院	がくいん	gakuinn
悲しみ	かなしみ	kanashimi
集計	しゅうけい	shuukei
内定	ないてい	naitei
対話	たいわ	taiwa
流出	りゅうしゅつ|ながれで	ryuushutsu|nagarede
筆者	ひっしゃ	hissha
二度と	にどと	nidoto
上流	じょうりゅう	jouryuu
部会	ぶかい	bukai
行使	こうし	koushi
楽曲	がっきょく	gakkyoku
体感	たいかん	taikann
進路	しんろ	shinnro
当事者	とうじしゃ	toujisha
太陽光	たいようこう	taiyoukou
遊べる	あそべる	asoberu
苦しみ	くるしみ	kurushimi
打ち上げる	うちあげる	uchiageru
他社	たしゃ	tasha
農園	のうえん	nouenn
店主	てんしゅ	tennshu
全日本	ぜんにほん|ぜんにっぽん	zennnihonn|zennnipponn
運び	はこび	hakobi
身分	みぶん	mibunn
次世代	じせだい	jisedai
両者	りょうしゃ	ryousha
急速	きゅうそく	kyuusoku
受け取り	うけとり	uketori
出血	しゅっけつ|でち	shukketsu|dechi
下落	げらく	geraku
調和	ちょうわ	tyouwa
有力	ゆうりょく	yuuryoku
指し	さし|ざし	sashi|zashi
電化	でんか	dennka
緑色	みどりいろ|りょくしょく	midoriiro|ryokushoku
同級生	どうきゅうせい	doukyuusei
調味	ちょうみ	tyoumi
学級	がっきゅう	gakkyuu
勝てる	かてる	kateru
死者	ししゃ	shisha
心身	しんしん	shinnshinn
指数	しすう	shisuu
商工	しょうこう	shoukou
線路	せんろ	sennro
会談	かいだん	kaidann
前期	ぜんき	zennki
物事	ものごと	monogoto
上級	じょうきゅう	joukyuu
先発	せんぱつ	sennpatsu
配当	はいとう	haitou
気持ちいい	きもちいい	kimochiii
指す	さす|ざす	sasu|zasu
直送	ちょくそう	tyokusou
和室	わしつ	washitsu
家事	かじ	kaji
県道	けんどう	kenndou
定休	ていきゅう	teikyuu
部活	ぶかつ	bukatsu
図面	ずめん	zumenn
後者	こうしゃ	kousha
引き起こす	ひきおこす	hikiokosu
開通	かいつう	kaitsuu
万全	ばんぜん	bannzenn
集める	あつめる	atsumeru
水面	すいめん|みなも|みのも	suimenn|minamo|minomo
動ける	うごける	ugokeru
食物	くいもの|しょくもつ|たべもの	kuimono|shokumotsu|tabemono
打てる	うてる	uteru
球場	きゅうじょう	kyuujou
農村	のうそん	nousonn
口調	くちょう	kutyou
着る	きる	kiru
真相	しんそう	shinnsou
美味	びみ|うま	bimi|uma
意向	いこう	ikou
台所	だいどころ	daidokoro
礼金	れいきん	reikinn
高温	こうおん	kouonn
写し	うつし	utsushi
漢方	かんぽう	kannpou
相対	あいたい|そうたい	aitai|soutai
屋外	おくがい	okugai
屋台	やたい	yatai
実物	じつぶつ|みもの	jitsubutsu|mimono
命じる	めいじる	meijiru
館内	かんない	kannnai
区画	くかく	kukaku
転用	てんよう	tennyou
所持	しょじ	shoji
電動	でんどう	denndou
服用	ふくよう	fukuyou
急行	きゅうこう	kyuukou
用事	ようじ	youji
同等	どうとう	doutou
登校	とうこう	toukou
運動会	うんどうかい	unndoukai
面す	めんす	mennsu
追記	ついき	tsuiki
宿題	しゅくだい	shukudai
水平	すいへい	suihei
鉄板	てっぱん	teppann
持ち主	もちぬし	mochinushi
対談	たいだん	taidann
王様	おうさま	ousama
着ける	つける|づける	tsukeru|dukeru
曲げる	まげる	mageru
使命	しめい	shimei
前進	ぜんしん	zennshinn
発す	はっす	hassu
持ち帰り	もちかえり	mochikaeri
追いつく	おいつく	oitsuku
重点	じゅうてん	juutenn
所定	しょてい	shotei
原油	げんゆ	gennyu
助手	じょしゅ	joshu
転がる	ころがる	korogaru
飲酒	いんしゅ|おんじゅ	innshu|onnju
申し出	もうしで	moushide
詩人	しじん	shijinn
薬物	やくぶつ	yakubutsu
路面	ろめん	romenn
真っ白	まっしろ	masshiro
題名	だいめい	daimei
農地	のうち	nouchi
電流	でんりゅう	dennryuu
短時間	たんじかん	tannjikann
路上	ろじょう	rojou
温める	あたためる|ぬくめる	atatameru|nukumeru
たどり着く	たどりつく	tadoritsuku
安打	あんだ	annda
悲鳴	ひめい	himei
他者	たしゃ	tasha
先物	さきもの	sakimono
算定	さんてい	sanntei
向き合う	むきあう|むきおう	mukiau|mukiou
幸運	こううん	kouunn
中期	ちゅうき	tyuuki
等しい	ひとしい	hitoshii
家屋	かおく	kaoku
育む	はぐくむ	hagukumu
葉っぱ	はっぱ	happa
うつ病	うつびょう	utsubyou
主流	しゅりゅう	shuryuu
苦い	にがい	nigai
美少女	びしょうじょ	bishoujo
化合	かごう	kagou
落ち着き	おちつき	ochitsuki
主力	しゅりょく	shuryoku
悪口	あっこう|わるくち|わるぐち	akkou|warukuchi|waruguchi
配線	はいせん	haisenn
毎度	まいど	maido
書面	しょめん	shomenn
大使	たいし	taishi
急ぎ	いそぎ	isogi
持ち上げる	もちあげる	mochiageru
やり取り	やりとり	yaritori
役場	やくば	yakuba
医学部	いがくぶ	igakubu
問い合わせる	といあわせる	toiawaseru
水族館	すいぞくかん	suizokukann
有用	ゆうよう	yuuyou
乗客	じょうきゃく	joukyaku
買物	かいもの	kaimono
配列	はいれつ	hairetsu
返金	へんきん	hennkinn
役立てる	やくだてる	yakudateru
学期	がっき	gakki
人員	じんいん	jinninn
速やか	すみやか	sumiyaka
親族	しんぞく	shinnzoku
習い事	ならいごと	naraigoto
命名	めいめい	meimei
路地	ろじ	roji
配分	はいぶん	haibunn
前面	ぜんめん	zennmenn
助ける	すける|たすける|だすける	sukeru|tasukeru|dasukeru
名曲	めいきょく	meikyoku
陽気	ようき	youki
化す	かす	kasu
電鉄	でんてつ	denntetsu
落下	らっか	rakka
受かる	うかる	ukaru
向ける	むける	mukeru
発する	はっする	hassuru
反日	はんにち	hannnichi
役目	やくめ	yakume
言動	げんどう	genndou
水泳	すいえい	suiei
列島	れっとう	rettou
新曲	しんきょく	shinnkyoku
原発	げんぱつ	gennpatsu
見送る	みおくる	miokuru
受け入れる	うけいれる	ukeireru
取り消し	とりけし	torikeshi
体温	たいおん	taionn
部落	ぶらく	buraku
味わえる	あじわえる	ajiwaeru
出題	しゅつだい	shutsudai
投下	とうか	touka
全集	ぜんしゅう	zennshuu
引き取る	ひきとる	hikitoru
指先	ゆびさき	yubisaki
ため息	ためいき	tameiki
洋食	ようしょく	youshoku
主題歌	しゅだいか	shudaika
題す	だいす	daisu
待ち合わせ	まちあわせ	machiawase
両面	りょうめん	ryoumenn
向う	むかう|むこう	mukau|mukou
着手	ちゃくしゅ	tyakushu
想う	おもう	omou
助言	じょげん|じょごん	jogenn|jogonn
当面	とうめん	toumenn
多発	たはつ	tahatsu
集い	つどい|すだい	tsudoi|sudai
全開	ぜんかい	zennkai
両立	りょうりつ	ryouritsu
前者	ぜんしゃ	zennsha
炭火	すみび	sumibi
生育	せいいく	seiiku
気持	きもち	kimochi
何者	なにもの	nanimono
頭部	とうぶ	toubu
身内	みうち|しんない	miuchi|shinnnai
物体	ぶったい	buttai
地酒	じざけ	jizake
早起き	はやおき	hayaoki
取組む	とりくむ	torikumu
注入	ちゅうにゅう	tyuunyuu
反面	はんめん	hannmenn
決着	けっちゃく	kettyaku
対面	たいめん|だいめん	taimenn|daimenn
物足りない	ものたりない	monotarinai
昔ながら	むかしながら	mukashinagara
入所	にゅうしょ	nyuusho
物品	ぶっぴん	buppinn
下半身	かはんしん	kahannshinn
起用	きよう	kiyou
感度	かんど	kanndo
終る	おわる	owaru
次期	じき	jiki
乗り物	のりもの	norimono
区切る	くぎる	kugiru
仕上がる	しあがる	shiagaru
死去	しきょ	shikyo
役人	やくにん	yakuninn
遊園	ゆうえん	yuuenn
期日	きじつ	kijitsu
代理人	だいりにん	dairininn
手持ち	てもち	temochi
事由	じゆう	jiyuu
終点	しゅうてん	shuutenn
王者	おうじゃ|おうしゃ	ouja|ousha
一員	いちいん	ichiinn
開会	かいかい	kaikai
作物	さくぶつ|さくもつ	sakubutsu|sakumotsu
先着	せんちゃく	senntyaku
集客	しゅうきゃく	shuukyaku
着せる	きせる	kiseru
お守り	おもり|おまもり	omori|omamori
通院	つういん	tsuuinn
短期間	たんきかん	tannkikann
用具	ようぐ	yougu
動き出す	うごきだす	ugokidasu
流動	りゅうどう	ryuudou
全角	ぜんかく	zennkaku
追って	おって	otte
顔面	がんめん	gannmenn
調教	ちょうきょう	tyoukyou
重ねる	かさねる	kasaneru
平面	へいめん	heimenn
平行	へいこう	heikou
新緑	しんりょく	shinnryoku
打者	だしゃ	dasha
転落	てんらく|ころげおち	tennraku|korogeochi
作動	さどう	sadou
火事	かじ	kaji
化け	ばけ	bake
図表	ずひょう	zuhyou
終始	しゅうし	shuushi
命中	めいちゅう	meityuu
仕分け	しわけ	shiwake
早急	さっきゅう|そうきゅう	sakkyuu|soukyuu
虫歯	むしば	mushiba
薬品	やくひん	yakuhinn
入れ歯	いれば	ireba
使い勝手	つかいがって	tsukaigatte
転ぶ	ころぶ|まろぶ	korobu|marobu
品目	ひんもく	hinnmoku
県知事	けんちじ	kennchiji
筆頭	ひっとう|ふでがしら	hittou|fudegashira
商社	しょうしゃ	shousha
和む	なごむ	nagomu
飲める	のめる	nomeru
見送り	みおくり	miokuri
品切れ	しなぎれ	shinagire
短大	たんだい	tanndai
来年度	らいねんど	rainenndo
皮肉	ひにく	hiniku
着実	ちゃくじつ	tyakujitsu
今期	こんき	konnki
仕える	つかえる|づかえる	tsukaeru|dukaeru
知名度	ちめいど	chimeido
死後	しご	shigo
和紙	わし	washi
和牛	わぎゅう	wagyuu
他国	たこく	takoku
お返し	おかえし	okaeshi
直面	ちょくめん	tyokumenn
意地	いじ	iji
手打ち	てうち	teuchi
一息	ひといき	hitoiki
定数	じょうすう|ていすう	jousuu|teisuu
内面	うちづら|ないめん	uchidura|naimenn
追い出す	おいだす	oidasu
童話	どうわ	douwa
実名	じつめい|じつみょう	jitsumei|jitsumyou
真に	しんに|まことに	shinnni|makotoni
分配	ぶんぱい	bunnpai
波動	はどう	hadou
期す	きす	kisu
水路	すいろ	suiro
真っ直ぐ	まっすぐ	massugu
暗黒	あんこく	annkoku
区内	くない	kunai
文具	ぶんぐ	bunngu
深まる	ふかまる	fukamaru
親指	おやゆび	oyayubi
一時期	いちじき	ichijiki
重力	じゅうりょく	juuryoku
練り	ねり	neri
引き受け	ひきうけ	hikiuke
落書き	らくがき	rakugaki
本命	ほんめい	honnmei
動員	どういん	douinn
遊歩道	ゆうほどう	yuuhodou
聞き取る	ききとる	kikitoru
直感	ちょっかん	tyokkann
追放	ついほう	tsuihou
見受ける	みうける	miukeru
曲線	きょくせん	kyokusenn
出世	しゅっせ	shusse
神道	しんとう	shinntou
漢方薬	かんぽうやく	kannpouyaku
四半期	しはんき	shihannki
テレビ局	てれびきょく	terebikyoku
乗り切る	のりきる	norikiru
打線	だせん	dasenn
主題	しゅだい	shudai
消せる	けせる	keseru
時事	じじ	jiji
水温	すいおん	suionn
転じる	てんじる	tennjiru
次ぐ	つぐ	tsugu
当館	とうかん	toukann
実体	じったい|じってい	jittai|jittei
頭皮	とうひ	touhi
長期間	ちょうきかん	tyoukikann
大使館	たいしかん	taishikann
問いかける	といかける	toikakeru
品物	しなもの|しなもん	shinamono|shinamonn
見所	みどころ	midokoro
予言	よげん	yogenn
乗用車	じょうようしゃ	jouyousha
屋内	おくない	okunai
短歌	たんか	tannka
読み返す	よみかえす	yomikaesu
着色	ちゃくしょく	tyakushoku
向く	むく	muku
都度	つど	tsudo
温室	おんしつ|うんしつ	onnshitsu|unnshitsu
持ち帰る	もちかえる	mochikaeru
談話	だんわ	dannwa
整える	ととのえる	totonoeru
出動	しゅつどう	shutsudou
表れ	あらわれ	araware
放流	ほうりゅう	houryuu
根元	こんげん|ねもと	konngenn|nemoto
書物	かきもの|しょもつ	kakimono|shomotsu
酒場	さかば	sakaba
有数	ゆうすう	yuusuu
始動	しどう	shidou
重み	おもみ	omomi
物語る	ものがたる	monogataru
発着	はっちゃく	hattyaku
持ち出し	もちだし	mochidashi
次いで	ついで	tsuide
乗り出す	のりだす	noridasu
公安	こうあん	kouann
第一歩	だいいっぽ	daiippo
福音	ふくいん	fukuinn
局面	きょくめん	kyokumenn
持ち歩く	もちあるく	mochiaruku
悪意	あくい	akui
真っ暗	まっくら	makkura
多重	たじゅう	tajuu
田植え	たうえ	taue
石炭	せきたん	sekitann
練る	ねる	neru
消去	しょうきょ|きえさ	shoukyo|kiesa
緑化	りょくか|りょっか	ryokuka|ryokka
決心	けっしん	kesshinn
金具	かなぐ	kanagu
読み取り	よみとり	yomitori
返せる	かえせる	kaeseru
洋書	ようしょ	yousho
立ち向かう	たちむかう	tachimukau
近世	きんせい	kinnsei
反転	はんてん	hanntenn
取り出す	とりだす	toridasu
回想	かいそう	kaisou
発車	はっしゃ	hassha
生放送	なまほうそう	namahousou
実写	じっしゃ	jissha
教委	きょうい	kyoui
書式	しょしき	shoshiki
着工	ちゃっこう	tyakkou
出向く	でむく	demuku
送り出す	おくりだす	okuridasu
商談	しょうだん	shoudann
来院	らいいん	raiinn
古本屋	ふるほんや	furuhonnya
年配	ねんぱい	nennpai
林業	りんぎょう	rinngyou
後世	こうせい|ごせ	kousei|gose
発光	はっこう	hakkou
面談	めんだん	menndann
楽章	がくしょう	gakushou
中級	ちゅうきゅう	tyuukyuu
直進	ちょくしん	tyokushinn
いた事	いたこと	itakoto
深み	ふかみ	fukami
主として	しゅとして	shutoshite
上半身	じょうはんしん	jouhannshinn
紙面	しめん	shimenn
帰路	きろ	kiro
真っ黒	まっくろ	makkuro
泳ぎ	およぎ	oyogi
大都市	だいとし	daitoshi
消火	しょうか	shouka
取り外し	とりはずし	torihazushi
少子化	しょうしか	shoushika
和書	わしょ	washo
使い分け	つかいわけ	tsukaiwake
係数	けいすう	keisuu
想い出	おもいで	omoide
取消	とりけし	torikeshi
育毛	いくもう	ikumou
三味線	しゃみせん	shamisenn
対岸	たいがん	taigann
昔話	むかしばなし	mukashibanashi
集う	つどう	tsudou
進入	しんにゅう	shinnnyuu
反動	はんどう	hanndou
対人	たいじん	taijinn
空調	くうちょう	kuutyou
全長	ぜんちょう	zenntyou
着目	ちゃくもく	tyakumoku
軽自動車	けいじどうしゃ	keijidousha
真っ先	まっさき	massaki
開館	かいかん	kaikann
緑茶	りょくちゃ	ryokutya
他方	たほう	tahou
外相	がいしょう|げそう	gaishou|gesou
前年度	ぜんねんど	zennnenndo
行進	こうしん	koushinn
受取	うけとり|うけと	uketori|uketo
流入	りゅうにゅう	ryuunyuu
短期大学	たんきだいがく	tannkidaigaku
等級	とうきゅう	toukyuu
全品	ぜんぴん	zennpinn
流用	りゅうよう	ryuuyou
意味合い	いみあい	imiai
待ち時間	まちじかん	machijikann
投球	とうきゅう	toukyuu
区切り	くぎり	kugiri
電球	でんきゅう	dennkyuu
取り消す	とりけす	torikesu
重たい	おもたい	omotai
乗船	じょうせん	jousenn
登用	とうよう	touyou
本業	ほんぎょう	honngyou
都立	とりつ	toritsu
一向に	いっこうに	ikkouni
真夜中	まよなか	mayonaka
夏期	かき	kaki
弱者	じゃくしゃ	jakusha
商事	しょうじ	shouji
金庫	きんこ	kinnko
待ち受ける	まちうける	machiukeru
送金	そうきん	soukinn
品書き	しながき	shinagaki
起点	きてん	kitenn
緑地	りょくち	ryokuchi
乗り場	のりば	noriba
身の回り	みのまわり	minomawari
教習所	きょうしゅうしょ|きょうしゅうじょ	kyoushuusho|kyoushuujo
返送	へんそう	hennsou
見習う	みならう|みなろう	minarau|minarou
打ち出し	うちだし	uchidashi
神事	しんじ	shinnji
手動	しゅどう	shudou
代え	かえ|がえ	kae|gae
受理	じゅり	juri
安らぎ	やすらぎ	yasuragi
感じ取る	かんじとる	kannjitoru
投じる	とうじる	toujiru
一式	いっしき	isshiki
買い取り	かいとり	kaitori
平米	へいべい	heibei
度合い	どあい	doai
上着	うわぎ	uwagi
様相	ようそう	yousou
お母様	おかあさま	okaasama
旅立つ	たびだつ	tabidatsu
酒屋	さかや|ざかや	sakaya|zakaya
荷重	かじゅう|におも	kajuu|niomo
主たる	しゅたる	shutaru
答申	とうしん	toushinn
国有	こくゆう	kokuyuu
学童	がくどう	gakudou
洋風	ようふう	youfuu
学区	がっく	gakku
病む	やむ	yamu
洋画	ようが	youga
旅客	りょかく|りょきゃく|りょかっ	ryokaku|ryokyaku|ryokaxtu
終り	おわり	owari
放す	はなす|ほかす|ばなす|ぱなす	hanasu|hokasu|banasu|panasu
宿る	やどる	yadoru
転生	てんせい|てんしょう	tennsei|tennshou
宿命	しゅくめい	shukumei
仕草	しぐさ	shigusa
助け合う	たすけあう|たすけおう	tasukeau|tasukeou
放火	ほうか	houka
医薬	いやく	iyaku
鼻水	はなみず	hanamizu
空想	くうそう	kuusou
乗れる	のれる	noreru
大祭	たいさい	taisai
買取る	かいとる	kaitoru
原始	げんし	gennshi
君たち	きみたち	kimitachi
後部	こうぶ	koubu
取り合う	とりあう|とりおう	toriau|toriou
動植物	どうしょくぶつ	doushokubutsu
和える	あえる	aeru
死神	しにがみ	shinigami
談合	だんごう	danngou
面会	めんかい	mennkai
ゴミ箱	ごみばこ	gomibako
苦しめる	くるしめる	kurushimeru
乗じる	じょうじる	joujiru
重度	じゅうど	juudo
商用	しょうよう	shouyou
切り取る	きりとる	kiritoru
夕陽	ゆうひ	yuuhi
事後	じご	jigo
詩集	ししゅう	shishuu
見習い	みならい	minarai
風習	ふうしゅう	fuushuu
手助け	てだすけ	tedasuke
使いこなす	つかいこなす	tsukaikonasu
持ち物	もちもの	mochimono
指向	しこう	shikou
暗記	あんき	annki
人身	じんしん|ひとみ	jinnshinn|hitomi
落ち着ける	おちつける	ochitsukeru
帰化	きか	kika
台帳	だいちょう	daityou
起き上がる	おきあがる	okiagaru
先代	せんだい	senndai
本題	ほんだい	honndai
対す	たいす	taisu
取り上げる	とりあげる	toriageru
待ち遠しい	まちどおしい	machidooshii
乗馬	じょうば	jouba
乗っ取る	のっとる	nottoru
整合	せいごう	seigou
前身	ぜんしん	zennshinn
代用	だいよう	daiyou
温まる	あたたまる|ぬくまる	atatamaru|nukumaru
旅立ち	たびだち	tabidachi
定か	さだか	sadaka
発進	はっしん	hasshinn
海面	かいめん|うなづら	kaimenn|unadura
神父	しんぷ	shinnpu
乗り入れ	のりいれ	noriire
打合せ	うちあわせ	uchiawase
曲名	きょくめい	kyokumei
飲み屋	のみや	nomiya
波長	はちょう	hatyou
人様	ひとさま	hitosama
相手方	あいてがた	aitegata
商会	しょうかい	shoukai
銀色	ぎんいろ|ぎんしょく	ginniro|ginnshoku
読み物	よみもの	yomimono
着地	ちゃくち	tyakuchi
見落とす	みおとす	miotosu
進め方	すすめかた	susumekata
来館	らいかん	raikann
長持ち	ながもち	nagamochi
打ち切り	うちきり	uchikiri
決め手	きめて	kimete
次女	じじょ	jijo
仕切り	しきり|じきり	shikiri|jikiri
悪人	あくにん	akuninn
自発	じはつ	jihatsu
筆記	ひっき	hikki
申し入れ	もうしいれ	moushiire
仕出し	しだし	shidashi
仕切る	しきる	shikiru
対等	たいとう	taitou
開き直る	ひらきなおる	hirakinaoru
所見	しょけん	shokenn
問答	もんどう	monndou
記帳	きちょう	kityou
横たわる	よこたわる	yokotawaru
水銀	すいぎん	suiginn
転売	てんばい	tennbai
委ねる	ゆだねる	yudaneru
ひっくり返す	ひっくりかえす	hikkurikaesu
対外	たいがい	taigai
遊具	ゆうぐ	yuugu
受取る	うけとる	uketoru
登板	とうばん	toubann
落ち葉	おちば	ochiba
黒豆	くろまめ	kuromame
地上波	ちじょうは	chijouha
横切る	よこぎる	yokogiru
分身	ぶんしん	bunnshinn
四球	しきゅう	shikyuu
持ち合わせ	もちあわせ	mochiawase
休館	きゅうかん	kyuukann
平ら	たいら|だいら	taira|daira
係員	かかりいん	kakariinn
始発	しはつ	shihatsu
立ち去る	たちさる	tachisaru
使者	ししゃ	shisha
楽屋	がくや	gakuya
名乗り	なのり	nanori
温もり	ぬくもり	nukumori
表題	ひょうだい	hyoudai
工学部	こうがくぶ	kougakubu
年表	ねんぴょう	nennpyou
使い道	つかいみち	tsukaimichi
植林	しょくりん	shokurinn
仕事場	しごとば	shigotoba
悪役	あくやく	akuyaku
薬草	やくそう	yakusou
足湯	あしゆ	ashiyu
前世	ぜんせ|ぜんせい	zennse|zennsei
子守	こもり	komori
落とせる	おとせる	otoseru
待合室	まちあいしつ	machiaishitsu
山登り	やまのぼり	yamanobori
生意気	なまいき	namaiki
両足	りょうあし	ryouashi
申し立て	もうしたて	moushitate
分化	ぶんか	bunnka
横目	よこめ	yokome
代物	しろもの|だいぶつ|だいもつ	shiromono|daibutsu|daimotsu
区長	くちょう	kutyou
開校	かいこう	kaikou
仕上げる	しあげる	shiageru
君主	くんしゅ	kunnshu
文集	ぶんしゅう	bunnshuu
自重	じじゅう|じちょう	jijuu|jityou
根強い	ねづよい	neduyoi
係わる	かかわる	kakawaru
血行	けっこう	kekkou
起算	きさん	kisann
時速	じそく	jisoku
終日	しゅうじつ|ひもすがら|ひねもす	shuujitsu|himosugara|hinemosu
重心	じゅうしん	juushinn
局所	きょくしょ	kyokusho
神さま	かみさま	kamisama
同感	どうかん	doukann
後味	あとあじ	atoaji
旅先	たびさき	tabisaki
対局	たいきょく	taikyoku
勝る	まさる	masaru
宿場	しゅくば	shukuba
歯ブラシ	はぶらし	haburashi
感知	かんち	kannchi
楽勝	らくしょう	rakushou
転がす	ころがす	korogasu
文面	ぶんめん	bunnmenn
世に	よに	yoni
勝者	しょうしゃ	shousha
父様	とうさま	tousama
様子見	ようすみ	yousumi
軽やか	かろやか|かるやか	karoyaka|karuyaka
取り入れる	とりいれる	toriireru
実る	みのる	minoru
追っかけ	おっかけ	okkake
病室	びょうしつ	byoushitsu
風物詩	ふうぶつし	fuubutsushi
毛皮	けがわ	kegawa
取り直す	とりなおす	torinaosu
流体	りゅうたい	ryuutai
薬用	やくよう	yakuyou
申立	もうしたて	moushitate
美化	びか	bika
一服	いっぷく	ippuku
発育	はついく	hatsuiku
定住	ていじゅう	teijuu
当主	とうしゅ	toushu
全線	ぜんせん	zennsenn
切り開く	きりひらく	kirihiraku
電柱	でんちゅう	denntyuu
実り	みのり	minori
当期	とうき	touki
第一人者	だいいちにんしゃ	daiichininnsha
界面	かいめん	kaimenn
国庫	こっこ	kokko
教習	きょうしゅう	kyoushuu
来客	らいきゃく	raikyaku
次長	じちょう	jityou
祭神	さいじん	saijinn
自負	じふ	jifu
投げ出す	なげだす	nagedasu
物色	ぶっしょく	busshoku
着こなし	きこなし	kikonashi
取消し	とりけし	torikeshi
調書	ちょうしょ	tyousho
取りあえず	とりあえず	toriaezu
歯ごたえ	はごたえ	hagotae
組曲	くみきょく	kumikyoku
寒天	かんてん	kanntenn
打球	だきゅう	dakyuu
真意	しんい	shinni
通帳	かよいちょう|つうちょう	kayoityou|tsuutyou
農作物	のうさくぶつ|のうさくもつ	nousakubutsu|nousakumotsu
予知	よち	yochi
対向	たいこう	taikou
一安心	ひとあんしん	hitoannshinn
着メロ	ちゃくめろ	tyakumero
仕業	しわざ|しぎょう	shiwaza|shigyou
放電	ほうでん	houdenn
手作業	てさぎょう	tesagyou
お化け	おばけ	obake
転写	てんしゃ	tennsha
意地悪	いじわる	ijiwaru
古事記	こじき	kojiki
同調	どうちょう	doutyou
金物	かなもの	kanamono
待たす	またす	matasu
切実	せつじつ	setsujitsu
決行	けっこう	kekkou
病人	びょうにん	byouninn
出向	しゅっこう|でむけ	shukkou|demuke
上等	じょうとう	joutou
開場	かいじょう	kaijou
悪用	あくよう	akuyou
部数	ぶすう	busuu
洋室	ようしつ	youshitsu
根気	こんき	konnki
究明	きゅうめい	kyuumei
勝ち取る	かちとる	kachitoru
横顔	よこがお	yokogao
有様	ありさま	arisama
文様	もんよう	monnyou
一人物	いちじんぶつ	ichijinnbutsu
転向	てんこう	tennkou
本県	ほんけん	honnkenn
祭る	まつる	matsuru
切開	せっかい|きりひらけ	sekkai|kirihirake
中等	ちゅうとう	tyuutou
通商	つうしょう	tsuushou
見苦しい	みぐるしい	migurushii
打開	だかい	dakai
買い取る	かいとる	kaitoru
五感	ごかん	gokann
発声	はっせい	hassei
生死	せいし|しょうし|しょうじ	seishi|shoushi|shouji
交配	こうはい	kouhai
持ち運び	もちはこび	mochihakobi
消しゴム	けしごむ	keshigomu
定まる	さだまる	sadamaru
引き返し	ひきかえし	hikikaeshi
火薬	かやく	kayaku
和服	わふく	wafuku
係長	かかりちょう	kakarityou
出所	しゅっしょ|でどこ|でどころ	shussho|dedoko|dedokoro
全校	ぜんこう	zennkou
実話	じつわ	jitsuwa
身元	みもと	mimoto
予習	よしゅう	yoshuu
投げかける	なげかける	nagekakeru
住める	すめる	sumeru
手放し	てばなし	tebanashi
農作業	のうさぎょう	nousagyou
上乗せ	うわのせ	uwanose
終身	しゅうしん	shuushinn
会期	かいき	kaiki
歯車	はぐるま	haguruma
入館	にゅうかん	nyuukann
発色	はっしょく	hasshoku
指南	しなん	shinann
取りまとめ	とりまとめ	torimatome
有線	ゆうせん	yuusenn
表わす	あらわす	arawasu
原動力	げんどうりょく	genndouryoku
駅員	えきいん	ekiinn
開港	かいこう	kaikou
前列	ぜんれつ	zennretsu
命ずる	めいずる	meizuru
他所	たしょ|よそ	tasho|yoso
葉書	はがき	hagaki
美学	びがく|びがっ	bigaku|bigaxtu
切れ味	きれあじ	kireaji
代打	だいだ	daida
化け物	ばけもの	bakemono
曲目	きょくもく	kyokumoku
持ち出す	もちだす	mochidasu
お決まり	おきまり	okimari
有形	ゆうけい	yuukei
足取り	あしとり|あしどり	ashitori|ashidori
持ち味	もちあじ	mochiaji
病名	びょうめい	byoumei
黒板	こくばん	kokubann
先取り	さきどり	sakidori
落し	おとし	otoshi
先送り	さきおくり	sakiokuri
半身	はんしん|はんみ	hannshinn|hannmi
急落	きゅうらく	kyuuraku
親身	しんみ	shinnmi
花言葉	はなことば	hanakotoba
文学部	ぶんがくぶ	bunngakubu
地表	ちひょう	chihyou
あの世	あのよ	anoyo
根っこ	ねっこ	nekko
病原	びょうげん	byougenn
都知事	とちじ	tochiji
配し	はいし	haishi
寒気	かんき|さむけ	kannki|samuke
主食	しゅしょく	shushoku
女流	じょりゅう	joryuu
生薬	きぐすり|しょうやく	kigusuri|shouyaku
動き回る	うごきまわる	ugokimawaru
美食	びしょく	bishoku
発病	はつびょう	hatsubyou
予期	よき	yoki
医大	いだい	idai
自分勝手	じぶんがって|じぶんかって	jibunngatte|jibunnkatte
使い切る	つかいきる	tsukaikiru
古着	ふるぎ	furugi
部外	ぶがい	bugai
走者	そうしゃ	sousha
投げつける	なげつける	nagetsukeru
全曲	ぜんきょく	zennkyoku
申出る	もうしでる	moushideru
かき氷	かきごおり	kakigoori
終電	しゅうでん	shuudenn
気品	きひん	kihinn
研ぐ	とぐ	togu
写り	うつり	utsuri
大昔	おおむかし	oomukashi
安物	やすもの	yasumono
負け犬	まけいぬ	makeinu
大学院生	だいがくいんせい	daigakuinnsei
本意	ほんい	honni
遊び心	あそびごころ	asobigokoro
遊び場	あそびば	asobiba
年始	ねんし	nennshi
部族	ぶぞく	buzoku
白身	しろみ|はくしん	shiromi|hakushinn
転校	てんこう	tennkou
口実	こうじつ	koujitsu
取り返し	とりかえし	torikaeshi
歯肉	はにく	haniku
和やか	なごやか|にこやか	nagoyaka|nikoyaka
船員	せんいん	senninn
気配り	きくばり	kikubari
前歯	まえば	maeba
相乗	そうじょう	soujou
耳鼻	じび	jibi
面子	めんこ|めんつ	mennko|menntsu
美形	びけい	bikei
見返し	みかえし	mikaeshi
女医	じょい	joi
室温	しつおん	shitsuonn
重合	じゅうごう	juugou
絵の具	えのぐ	enogu
両社	りょうしゃ	ryousha
区立	くりつ	kuritsu
転入	てんにゅう	tennnyuu
軽食	けいしょく	keishoku
思い起こす	おもいおこす	omoiokosu
植生	しょくせい	shokusei
気取る	きどる|けどる	kidoru|kedoru
運気	うんき	unnki
全土	ぜんど	zenndo
身動き	みうごき	miugoki
起る	おこる	okoru
写す	うつす	utsusu
部局	ぶきょく	bukyoku
生き返る	いきかえる	ikikaeru
根ざす	ねざす	nezasu
お花畑	おはなばたけ	ohanabatake
対する	たいする	taisuru
直筆	じきひつ|ちょくひつ	jikihitsu|tyokuhitsu
聞き流す	ききながす	kikinagasu
和らげる	やわらげる	yawarageru
等身	とうしん	toushinn
文庫本	ぶんこぼん	bunnkobonn
見返り	みかえり	mikaeri
出港	しゅっこう	shukkou
定理	ていり	teiri
消息	しょうそく	shousoku
真正面	ましょうめん|まっしょうめん	mashoumenn|masshoumenn
同定	どうてい	doutei
追いやる	おいやる	oiyaru
題目	だいもく	daimoku
悪寒	おかん	okann
食い物	くいもの	kuimono
売主	うりぬし	urinushi
命題	めいだい	meidai
助長	じょちょう	jotyou
炭水化物	たんすいかぶつ	tannsuikabutsu
鼻血	はなぢ|はなじ	hanadi|hanaji
重んじる	おもんじる	omonnjiru
言い放つ	いいはなつ	iihanatsu
指さす	ゆびさす	yubisasu
七福神	しちふくじん	shichifukujinn
第一線	だいいっせん	daiissenn
切り落とす	きりおとす	kiriotosu
同業	どうぎょう	dougyou
白血病	はっけつびょう	hakketsubyou
短所	たんしょ	tannsho
平年	へいねん	heinenn
鉄分	てつぶん	tetsubunn
色調	しきちょう	shikityou
球根	きゅうこん	kyuukonn
安っぽい	やすっぽい	yasuppoi
入港	にゅうこう	nyuukou
医科	いか	ika
自決	じけつ	jiketsu
読取る	よみとる	yomitoru
図式	ずしき	zushiki
度数	どすう	dosuu
味わい深い	あじわいぶかい	ajiwaibukai
手放す	てばなす	tebanasu
祭礼	さいれい	sairei
長身	ちょうしん	tyoushinn
相反	あいはん|そうはん	aihann|souhann
死す	しす	shisu
向かい合う	むかいあう|むかいおう	mukaiau|mukaiou
湯気	ゆげ	yuge
泳げる	およげる	oyogeru
合言葉	あいことば	aikotoba
細身	ほそみ	hosomi
子役	こやく	koyaku
真っ青	まっさお	massao
原酒	げんしゅ	gennshu
暑中	しょちゅう	shotyuu
係り	かかり|かかわり|がかり	kakari|kakawari|gakari
小道具	こどうぐ	kodougu
有意	ゆうい	yuui
左岸	さがん	sagann
見開く	みひらく	mihiraku
神学	しんがく|しんがっ	shinngaku|shinngaxtu
家主	やぬし|いえぬし|いえあるじ	yanushi|ienushi|iearuji
乗っかる	のっかる	nokkaru
薬事	やくじ	yakuji
通所	つうしょ	tsuusho
開局	かいきょく	kaikyoku
次号	じごう	jigou
助っ人	すけっと	suketto
軽度	けいど	keido
配色	はいしょく	haishoku
決起	けっき	kekki
放る	ほうる|ひる|ぽる	houru|hiru|poru
使いこなせる	つかいこなせる	tsukaikonaseru
箱入り	はこいり	hakoiri
両日	りょうじつ	ryoujitsu
打ち明ける	うちあける	uchiakeru
数式	すうしき	suushiki
決めつける	きめつける	kimetsukeru
後頭部	こうとうぶ	koutoubu
同乗	どうじょう	doujou
配下	はいか	haika
死人	しにん|しびと	shininn|shibito
ごま油	ごまあぶら	gomaabura
命日	めいにち	meinichi
書院	しょいん	shoinn
右岸	うがん	ugann
思い返す	おもいかえす	omoikaesu
打ち切る	うちきる	uchikiru
安らか	やすらか	yasuraka
真上	まうえ	maue
申し分	もうしぶん	moushibunn
地球人	ちきゅうじん	chikyuujinn
返上	へんじょう	hennjou
歯止め	はどめ	hadome
上半期	かみはんき	kamihannki
調合	ちょうごう	tyougou
受入	うけいれ	ukeire
回遊	かいゆう	kaiyuu
開園	かいえん	kaienn
受けとめる	うけとめる	uketomeru
校区	こうく	kouku
一昔	ひとむかし	hitomukashi
送電	そうでん	soudenn
冬期	とうき	touki
心意気	こころいき	kokoroiki
起立	きりつ	kiritsu
全う	まっとう	mattou
新調	しんちょう	shinntyou
同化	どうか	douka
運休	うんきゅう	unnkyuu
売り物	うりもの	urimono
悪者	わるもの	warumono
実地	じっち	jicchi
行き着く	いきつく|ゆきつく	ikitsuku|yukitsuku
歌集	かしゅう	kashuu
手っ取り早い	てっとりばやい	tettoribayai
気取り	きどり|けどり	kidori|kedori
品等	ひんとう	hinntou
放り出す	ほうりだす|ひりだす	houridasu|hiridasu
持分	もちぶん	mochibunn
外注	がいちゅう	gaityuu
画集	がしゅう	gashuu
使用人	しようにん	shiyouninn
安売り	やすうり	yasuuri
漢文	かんぶん	kannbunn
薬味	やくみ	yakumi
乗組	のりくみ	norikumi
流氷	りゅうひょう	ryuuhyou
風化	ふうか	fuuka
一体化	いったいか	ittaika
申しあげる	もうしあげる	moushiageru
送れる	おくれる	okureru
集る	たかる|だかる|あつまる	takaru|dakaru|atsumaru
薬学	やくがく|やくがっ	yakugaku|yakugaxtu
身勝手	みがって	migatte
住戸	じゅうこ	juuko
悪事	あくじ	akuji
内湯	うちゆ	uchiyu
消え去る	きえさる	kiesaru
反感	はんかん	hannkann
号車	ごうしゃ	gousha
味見	あじみ	ajimi
水遊び	みずあそび	mizuasobi
一様	いちよう	ichiyou
三十路	みそじ	misoji
整数	せいすう	seisuu
直球	ちょっきゅう	tyokkyuu
息苦しい	いきぐるしい	ikigurushii
受動	じゅどう	judou
同年代	どうねんだい	dounenndai
名勝	めいしょう	meishou
祭日	さいじつ	saijitsu
表向き	おもてむき	omotemuki
見開き	みひらき	mihiraki
引き返す	ひきかえす	hikikaesu
全社	ぜんしゃ	zennsha
打点	だてん	datenn
仕立	したて|じたて	shitate|jitate
院生	いんせい	innsei
開山	かいさん|かいざん	kaisann|kaizann
炭化	たんか	tannka
打ち出す	うちだす	uchidasu
子持ち	こもち	komochi
金銀	きんぎん	kinnginn
手取り	てどり|てとり|てっとり	tedori|tetori|tettori
ひっくり返る	ひっくりかえる	hikkurikaeru
来期	らいき	raiki
品番	ひんばん|しなばん	hinnbann|shinabann
万事	ばんじ	bannji
学業	がくぎょう	gakugyou
心温まる	こころあたたまる	kokoroatatamaru
受け皿	うけざら	ukezara
天守	てんしゅ	tennshu
ひな祭り	ひなまつり	hinamatsuri
客船	きゃくせん	kyakusenn
強者	きょうしゃ|つわもの	kyousha|tsuwamono
他界	たかい	takai
まな板	まないた	manaita
相まって	あいまって	aimatte
球体	きゅうたい	kyuutai
注意深い	ちゅういぶかい	tyuuibukai
秋祭り	あきまつり	akimatsuri
皮切り	かわきり	kawakiri
客車	きゃくしゃ	kyakusha
追い風	おいかぜ	oikaze
化物	ばけもの	bakemono
万年筆	まんねんひつ	mannnennhitsu
野宿	のじゅく	nojuku
後進	こうしん	koushinn
中指	なかゆび	nakayubi
想起	そうき	souki
風速	ふうそく	fuusoku
平屋	ひらや	hiraya
書庫	しょこ	shoko
引き受ける	ひきうける	hikiukeru
取り調べる	とりしらべる	torishiraberu
放水	ほうすい	housui
起し	おこし|きし	okoshi|kishi
鉄橋	てっきょう	tekkyou
対空	たいくう	taikuu
生身	なまみ	namami
使い物	つかいもの	tsukaimono
集金	しゅうきん	shuukinn
風流	ふうりゅう|ふりゅう	fuuryuu|furyuu
短め	みじかめ	mijikame
ぬるま湯	ぬるまゆ	nurumayu
絵葉書	えはがき	ehagaki
注力	ちゅうりょく	tyuuryoku
上向き	うわむき	uwamuki
命がけ	いのちがけ	inochigake
ハンセン病	はんせんびょう	hannsennbyou
自習	じしゅう	jishuu
中流	ちゅうりゅう	tyuuryuu
手品	てじな	tejina
息づく	いきづく	ikiduku
身代わり	みがわり	migawari
下取り	したどり	shitadori
洋館	ようかん	youkann
合板	ごうはん|ごうばん	gouhann|goubann
中長期	ちゅうちょうき	tyuutyouki
羽化	うか	uka
発火	はっか	hakka
後発	こうはつ	kouhatsu
人命	じんめい	jinnmei
流れ星	ながれぼし	nagareboshi
所用	しょよう	shoyou
一部分	いちぶぶん	ichibubunn
商号	しょうごう	shougou
茶道具	ちゃどうぐ	tyadougu
進学校	しんがくこう	shinngakukou
取水	しゅすい	shusui
新薬	しんやく	shinnyaku
多方面	たほうめん	tahoumenn
草の根	くさのね	kusanone
意気	いき|いく	iki|iku
心待ち	こころまち	kokoromachi
後ろ向き	うしろむき	ushiromuki
温かみ	あたたかみ	atatakami
ご時世	ごじせい	gojisei
定形	ていけい	teikei
調度	ちょうど	tyoudo
転出	てんしゅつ	tennshutsu
持ちかける	もちかける	mochikakeru
油絵	あぶらえ	aburae
急坂	きゅうざか|きゅうはん	kyuuzaka|kyuuhann
歯石	しせき	shiseki
主語	しゅご	shugo
着心地	きごこち	kigokochi
歩道橋	ほどうきょう	hodoukyou
開業医	かいぎょうい	kaigyoui
等分	とうぶん	toubunn
手相	てそう	tesou
公庫	こうこ	kouko
家業	かぎょう	kagyou
決す	けっす	kessu
県下	けんか	kennka
漢詩	からうた|かんし	karauta|kannshi
多面	ためん	tamenn
万物	ばんぶつ|よろずもの	bannbutsu|yorozumono
生業	せいぎょう|なりわい|すぎわい	seigyou|nariwai|sugiwai
住まう	すまう|ずまう	sumau|zumau
気球	ききゅう	kikyuu
取り合い	とりあい	toriai
和らぐ	やわらぐ	yawaragu
歌曲	かきょく	kakyoku
真言	しんごん	shinngonn
新都	しんと	shinnto
軽油	けいゆ	keiyu
名品	めいひん	meihinn
肉屋	にくや	nikuya
真っ向	まっこう	makkou
引き出物	ひきでもの	hikidemono
手放せる	てばなせる	tebanaseru
取っ手	とって	totte
悲しむ	かなしむ	kanashimu
回送	かいそう	kaisou
乗員	じょういん	jouinn
時短	じたん	jitann
遊び方	あそびかた	asobikata
受入れ	うけいれ	ukeire
死語	しご	shigo
持ち上がる	もちあがる	mochiagaru
美少年	びしょうねん	bishounenn
美顔	びがん	bigann
息切れ	いきぎれ	ikigire
正会員	せいかいいん	seikaiinn
追いつめる	おいつめる	oitsumeru
下り坂	くだりざか	kudarizaka
取り引き	とりひき	torihiki
取り立て	とりたて	toritate
下級	かきゅう	kakyuu
投薬	とうやく	touyaku
持病	じびょう	jibyou
屋号	やごう	yagou
直流	ちょくりゅう	tyokuryuu
気流	きりゅう	kiryuu
手の平	てのひら	tenohira
物言い	ものいい|ものゆい	monoii|monoyui
感ずる	かんずる	kannzuru
同族	どうぞく	douzoku
表皮	ひょうひ	hyouhi
飲用	いんよう	innyou
羊毛	ようもう	youmou
悪しい	あしい	ashii
大根おろし	だいこんおろし	daikonnoroshi
名医	めいい	meii
朝礼	ちょうれい	tyourei
守れる	まもれる	mamoreru
世相	せそう	sesou
予後	よご	yogo
死角	しかく	shikaku
一期一会	いちごいちえ	ichigoichie
言い返す	いいかえす	iikaesu
宿す	しゅくす|やどす	shukusu|yadosu
流れ出る	ながれでる	nagarederu
何様	なにさま	nanisama
勝ち負け	かちまけ	kachimake
反落	はんらく	hannraku
発つ	たつ	tatsu
深度	しんど	shinndo
病死	びょうし	byoushi
世話人	せわにん	sewaninn
目薬	めぐすり	megusuri
湖面	こめん	komenn
上皮	じょうひ|うわかわ	jouhi|uwakawa
転身	てんしん	tennshinn
前夜祭	ぜんやさい	zennyasai
子息	しそく	shisoku
平たい	ひらたい	hiratai
練り歩く	ねりあるく	neriaruku
一助	いちじょ	ichijo
仕上る	しあがる	shiagaru
急所	きゅうしょ	kyuusho
配役	はいやく	haiyaku
入湯	にゅうとう	nyuutou
手荷物	てにもつ	tenimotsu
始業	しぎょう	shigyou
駅長	えきちょう	ekityou
サラダ油	さらだゆ	saradayu
世にも	よにも	yonimo
荷台	にだい	nidai
取り組める	とりくめる	torikumeru
食味	しょくみ	shokumi
面目	めんぼく|めんもく	mennboku|mennmoku
向上心	こうじょうしん	koujoushinn
寒波	かんぱ	kannpa
注記	ちゅうき	tyuuki
手間取る	てまどる	temadoru
重ね合う	かさねあう|かさねおう	kasaneau|kasaneou
商い	あきない	akinai
知育	ちいく	chiiku
追いつける	おいつける	oitsukeru
今昔	こんじゃく	konnjaku
地平線	ちへいせん	chiheisenn
度重なる	たびかさなる	tabikasanaru
助役	じょやく	joyaku
流木	りゅうぼく	ryuuboku
身軽	みがる	migaru
たどり着ける	たどりつける	tadoritsukeru
ひと味	ひとあじ	hitoaji
整列	せいれつ	seiretsu
白血球	はっけっきゅう	hakkekkyuu
落花生	らっかせい	rakkasei
古式	こしき	koshiki
分業	ぶんぎょう	bunngyou
工期	こうき	kouki
乗り切れる	のりきれる	norikireru
定点	ていてん	teitenn
真横	まよこ	mayoko
化身	けしん	keshinn
苦言	くげん	kugenn
理学部	りがくぶ	rigakubu
走り去る	はしりさる	hashirisaru
聞き返す	ききかえす	kikikaesu
新酒	しんしゅ	shinnshu
持ち直す	もちなおす	mochinaosu
配水	はいすい	haisui
一役	ひとやく	hitoyaku
開国	かいこく	kaikoku
王族	おうぞく	ouzoku
赤身	あかみ	akami
薬指	くすりゆび	kusuriyubi
月面	げつめん	getsumenn
落着	らくちゃく|らくじゃく	rakutyaku|rakujaku
引受	ひきうけ	hikiuke
反米	はんべい	hannbei
商船	しょうせん	shousenn
屋形船	やかたぶね	yakatabune
主君	しゅくん	shukunn
見放す	みはなす	mihanasu
用水路	ようすいろ	yousuiro
一元化	いちげんか	ichigennka
引き落とし	ひきおとし	hikiotoshi
電荷	でんか	dennka
遊女	ゆうじょ	yuujo
形相	ぎょうそう|けいそう	gyousou|keisou
自他	じた	jita
思想家	しそうか	shisouka
お開き	おひらき	ohiraki
音速	おんそく	onnsoku
明暗	めいあん	meiann
四苦八苦	しくはっく	shikuhakku
反り	そり|ぞり	sori|zori
波乗り	なみのり	naminori
使い手	つかいて	tsukaite
外界	がいかい	gaikai
身上	しんしょう|しんじょう	shinnshou|shinnjou
品名	ひんめい	hinnmei
お日様	おひさま	ohisama
入庫	にゅうこ	nyuuko
使い分ける	つかいわける	tsukaiwakeru
人一倍	ひといちばい	hitoichibai
強打	きょうだ	kyouda
仕打ち	しうち	shiuchi
油分	ゆぶん	yubunn
通期	つうき	tsuuki
物音	ものおと	monooto
先客	せんきゃく	sennkyaku
下界	げかい|かかい	gekai|kakai
住み着く	すみつく	sumitsuku
打ち消す	うちけす	uchikesu
赤血球	せっけっきゅう	sekkekkyuu
動じる	どうじる	doujiru
悪行	あくぎょう|あっこう	akugyou|akkou
年号	ねんごう	nenngou
見向く	みむく	mimuku
神体	しんたい	shinntai
切り返し	きりかえし	kirikaeshi
安上がり	やすあがり	yasuagari
酒飲み	さけのみ	sakenomi
主事	しゅじ	shuji
取り決め	とりきめ	torikime
次週	じしゅう	jishuu
小品	しょうひん	shouhinn
短パン	たんぱん	tannpann
庭先	にわさき	niwasaki
教区	きょうく	kyouku
行進曲	こうしんきょく	koushinnkyoku
球界	きゅうかい	kyuukai
横ばい	よこばい	yokobai
重荷	おもに	omoni
入植	にゅうしょく	nyuushoku
進級	しんきゅう	shinnkyuu
同列	どうれつ	douretsu
客員	かくいん|きゃくいん	kakuinn|kyakuinn
運べる	はこべる	hakoberu
家路	いえじ	ieji
長調	ちょうちょう	tyoutyou
品数	しなかず	shinakazu
お茶屋	おちゃや	otyaya
草取り	くさとり	kusatori
起こせる	おこせる	okoseru
作業場	さぎょうば	sagyouba
定植	ていしょく	teishoku
勉学	べんがく	benngaku
打ち合う	うちあう|うちおう	uchiau|uchiou
血小板	けっしょうばん	kesshoubann
山の幸	やまのさち	yamanosachi
追究	ついきゅう	tsuikyuu
事物	じぶつ	jibutsu
面白み	おもしろみ	omoshiromi
用命	ようめい	youmei
真っ当	まっとう	mattou
同院	どういん	douinn
転校生	てんこうせい	tennkousei
代り	かわり|がわり	kawari|gawari
黄身	きみ	kimi
茶の湯	ちゃのゆ	tyanoyu
お受け取り	おうけとり	ouketori
十字路	じゅうじろ	juujiro
内服	ないふく	naifuku
流れ出す	ながれだす	nagaredasu
仕返し	しかえし	shikaeshi
仕組む	しくむ	shikumu
面持ち	おももち	omomochi
自筆	じひつ	jihitsu
急死	きゅうし	kyuushi
むし歯	むしば	mushiba
落ちつく	おちつく	ochitsuku
受け持つ	うけもつ	ukemotsu
飲茶	やむちゃ|いんさ	yamutya|innsa
洋式	ようしき	youshiki
局員	きょくいん	kyokuinn
仕入れる	しいれる	shiireru
馬主	ばしゅ	bashu
服薬	ふくやく	fukuyaku
実生活	じっせいかつ	jisseikatsu
寺子屋	てらこや	terakoya
送球	そうきゅう	soukyuu
取り返す	とりかえす	torikaesu
落す	おとす	otosu
味気	あじけ|あじき	ajike|ajiki
写本	しゃほん	shahonn
に対しまして	にたいしまして	nitaishimashite
代役	だいやく	daiyaku
くり返し	くりかえし	kurikaeshi
終業	しゅうぎょう	shuugyou
全店	ぜんてん	zenntenn
氷点下	ひょうてんか	hyoutennka
深部	しんぶ	shinnbu
全館	ぜんかん	zennkann
開帳	かいちょう|がいちょう	kaityou|gaityou
雨具	あまぐ	amagu
川遊び	かわあそび	kawaasobi
短調	たんちょう	tanntyou
重箱	じゅうばこ	juubako
両院	りょういん	ryouinn
感服	かんぷく	kannpuku
口笛	くちぶえ	kuchibue
進言	しんげん	shinngenn
物心	ぶっしん|ものごころ	busshinn|monogokoro
流血	りゅうけつ	ryuuketsu
安らぐ	やすらぐ	yasuragu
追い上げ	おいあげ	oiage
重体	じゅうたい	juutai
登れる	のぼれる	noboreru
習字	しゅうじ	shuuji
乗合	のりあい	noriai
宿主	しゅくしゅ|やどぬし	shukushu|yadonushi
号外	ごうがい	gougai
真新しい	まあたらしい	maatarashii
暑苦しい	あつくるしい	atsukurushii
農学部	のうがくぶ	nougakubu
向き直る	むきなおる	mukinaoru
酒気	しゅき|さかけ	shuki|sakake
自助	じじょ	jijo
植毛	しょくもう	shokumou
島国	しまぐに	shimaguni
一番乗り	いちばんのり	ichibannnori
持ち前	もちまえ	mochimae
乗っける	のっける	nokkeru
決死	けっし	kesshi
小皿	こざら	kozara
外面	がいめん|そとづら|げめん	gaimenn|sotodura|gemenn
申し受ける	もうしうける	moushiukeru
横向き	よこむき	yokomuki
天界	てんかい|てんがい	tennkai|tenngai
曲調	きょくちょう	kyokutyou
玉手箱	たまてばこ	tamatebako
切り取り	きりとり	kiritori
名指し	なざし	nazashi
取調べ	とりしらべ	torishirabe
所作	しょさ	shosa
新進	しんしん	shinnshinn
取りかかる	とりかかる	torikakaru
他校	たこう	takou
取り下げ	とりさげ	torisage
重油	じゅうゆ	juuyu
所内	しょない	shonai
決する	けっする	kessuru
飲ます	のます	nomasu
落ちこぼれ	おちこぼれ	ochikobore
列強	れっきょう	rekkyou
切り身	きりみ	kirimi
県南	けんなん	kennnann
手仕事	てしごと	teshigoto
打ち勝つ	うちかつ	uchikatsu
発起人	ほっきにん	hokkininn
風向き	かざむき|かぜむき	kazamuki|kazemuki
局地	きょくち	kyokuchi
病弱	びょうじゃく	byoujaku
三流	さんりゅう	sannryuu
苦心	くしん	kushinn
悪気	わるぎ	warugi
乗用	じょうよう	jouyou
鉄工	てっこう	tekkou
全会	ぜんかい	zennkai
医局	いきょく	ikyoku
音階	おんかい	onnkai
帰着	きちゃく	kityaku
頭取	とうどり	toudori
急きょ	きゅうきょ	kyuukyo
土着	どちゃく	dotyaku
面する	めんする	mennsuru
委員会	いいんかい	iinnkai
何度	なんど	nanndo
一度	いちど|ひとたび	ichido|hitotabi
商取引	しょうとりひき	shoutorihiki
事業者	じぎょうしゃ	jigyousha
委員長	いいんちょう	iinntyou
研究会	けんきゅうかい	kennkyuukai
飲食店	いんしょくてん	innshokutenn
一発	いっぱつ	ippatsu
度目	どめ	dome
研究者	けんきゅうしゃ	kennkyuusha
事業所	じぎょうしょ	jigyousho
一面	いちめん	ichimenn
期間中	きかんちゅう	kikanntyuu
旅行記	りょこうき	ryokouki
二重	にじゅう|ふたえ	nijuu|futae
日本酒	にほんしゅ	nihonnshu
写真集	しゃしんしゅう	shashinnshuu
理事長	りじちょう	rijityou
研究室	けんきゅうしつ	kennkyuushitsu
市区町村	しくちょうそん	shikutyousonn
発売日	はつばいび	hatsubaibi
代理店	だいりてん	dairitenn
運転手	うんてんしゅ	unntennshu
動物園	どうぶつえん	doubutsuenn
発表会	はっぴょうかい	happyoukai
食感	しょっかん	shokkann
勉強会	べんきょうかい	bennkyoukai
暗号化	あんごうか	anngouka
当院	とういん	touinn
新商品	しんしょうひん	shinnshouhinn
文字列	もじれつ	mojiretsu
所有者	しょゆうしゃ	shoyuusha
定休日	ていきゅうび	teikyuubi
二度	にど	nido
代表者	だいひょうしゃ	daihyousha
組合員	くみあいいん	kumiaiinn
理事会	りじかい	rijikai
予定日	よていび	yoteibi
化合物	かごうぶつ	kagoubutsu
用語集	ようごしゅう	yougoshuu
日用品	にちようひん	nichiyouhinn
事実上	じじつじょう	jijitsujou
交流会	こうりゅうかい	kouryuukai
発電所	はつでんしょ	hatsudennsho
登山口	とざんぐち	tozannguchi
家庭用	かていよう	kateiyou
大部分	だいぶぶん	daibubunn
電話帳	でんわちょう	dennwatyou
取引所	とりひきしょ|とりひきじょ	torihikisho|torihikijo
会社員	かいしゃいん	kaishainn
回答者	かいとうしゃ	kaitousha
相談所	そうだんしょ|そうだんじょ	soudannsho|soudannjo
工作員	こうさくいん	kousakuinn
先進国	せんしんこく	sennshinnkoku
県外	けんがい	kenngai
放送局	ほうそうきょく	housoukyoku
集中力	しゅうちゅうりょく	shuutyuuryoku
取引先	とりひきさき	torihikisaki
文化祭	ぶんかさい	bunnkasai
研究科	けんきゅうか	kennkyuuka
発売中	はつばいちゅう	hatsubaityuu
野球部	やきゅうぶ	yakyuubu
注意点	ちゅういてん	tyuuitenn
科学者	かがくしゃ	kagakusha
使用者	しようしゃ	shiyousha
写真館	しゃしんかん	shashinnkann
公開中	こうかいちゅう	koukaityuu
作曲家	さっきょくか	sakkyokuka
遊園地	ゆうえんち	yuuennchi
食育	しょくいく	shokuiku
次会	じかい	jikai
開発者	かいはつしゃ	kaihatsusha
予想外	よそうがい	yosougai
研究員	けんきゅういん	kennkyuuinn
全室	ぜんしつ	zennshitsu
意見書	いけんしょ	ikennsho
写真家	しゃしんか	shashinnka
歩行者	ほこうしゃ	hokousha
出身者	しゅっしんしゃ	shusshinnsha
多様化	たようか	tayouka
安心感	あんしんかん	annshinnkann
出身地	しゅっしんち	shusshinnchi
仕事中	しごとちゅう	shigototyuu
実用化	じつようか	jitsuyouka
本年度	ほんねんど	honnnenndo
近代化	きんだいか	kinndaika
生物学	せいぶつがく	seibutsugaku
旅行者	りょこうしゃ	ryokousha
起業家	きぎょうか	kigyouka
工事中	こうじちゅう	koujityuu
入学式	にゅうがくしき	nyuugakushiki
問題集	もんだいしゅう	monndaishuu
商品化	しょうひんか	shouhinnka
代表作	だいひょうさく	daihyousaku
一人旅	ひとりたび	hitoritabi
正当化	せいとうか	seitouka
植物園	しょくぶつえん	shokubutsuenn
思春期	ししゅんき	shishunnki
作品集	さくひんしゅう	sakuhinnshuu
活動中	かつどうちゅう	katsudoutyuu
大集合	だいしゅうごう	daishuugou
海岸線	かいがんせん	kaigannsenn
期間内	きかんない	kikannnai
部活動	ぶかつどう	bukatsudou
事業主	じぎょうぬし	jigyounushi
小売業	こうりぎょう	kourigyou
来場者	らいじょうしゃ	raijousha
美白	びはく	bihaku
本部長	ほんぶちょう	honnbutyou
自動化	じどうか	jidouka
生活者	せいかつしゃ	seikatsusha
上級者	じょうきゅうしゃ	joukyuusha
物理学	ぶつりがく	butsurigaku
自由度	じゆうど	jiyuudo
新発売	しんはつばい	shinnhatsubai
練習場	れんしゅうじょう	rennshuujou
合理化	ごうりか	gourika
進行中	しんこうちゅう	shinnkoutyuu
開放感	かいほうかん	kaihoukann
研究家	けんきゅうか	kennkyuuka
仕入	しいれ	shiire
茶葉	ちゃば	tyaba
生命力	せいめいりょく	seimeiryoku
間取	まどり	madori
登山者	とざんしゃ	tozannsha
作業員	さぎょういん	sagyouinn
申出	もうしで	moushide
一級	いっきゅう	ikkyuu
放送中	ほうそうちゅう	housoutyuu
円安	えんやす	ennyasu
他人事	たにんごと|ひとごと	taninngoto|hitogoto
教育長	きょういくちょう	kyouikutyou
人気者	にんきもの	ninnkimono
部屋数	へやかず	heyakazu
感想文	かんそうぶん	kannsoubunn
町役場	まちやくば	machiyakuba
安定感	あんていかん	annteikann
安定所	あんていしょ	annteisho
新年度	しんねんど	shinnnenndo
科学館	かがくかん	kagakukann
号館	ごうかん	goukann
中古品	ちゅうこひん	tyuukohinn
作業中	さぎょうちゅう	sagyoutyuu
行動力	こうどうりょく	koudouryoku
開発中	かいはつちゅう	kaihatsutyuu
小動物	しょうどうぶつ	shoudoubutsu
地消	ちしょう	chishou
血流	けつりゅう	ketsuryuu
金運	きんうん	kinnunn
学園祭	がくえんさい	gakuennsai
歯科医	しかい	shikai
原作者	げんさくしゃ	gennsakusha
元首相	もとしゅしょう	motoshushou
酒店	さけてん|しゅてん	saketenn|shutenn
音楽祭	おんがくさい	onngakusai
安定化	あんていか	annteika
同県	どうけん	doukenn
内定者	ないていしゃ	naiteisha
電気代	でんきだい	dennkidai
駅間	えきかん	ekikann
三者	さんしゃ	sannsha
具体化	ぐたいか	gutaika
出発点	しゅっぱつてん	shuppatsutenn
自由化	じゆうか	jiyuuka
家庭内	かていない	kateinai
開始日	かいしひ	kaishihi
作業所	さぎょうしょ	sagyousho
他県	たけん	takenn
他店	たてん	tatenn
野球場	やきゅうじょう	yakyuujou
注目度	ちゅうもくど	tyuumokudo
高度化	こうどか	koudoka
相談員	そうだんいん	soudanninn
顔写真	かおじゃしん|かおしゃしん	kaojashinn|kaoshashinn
県人	けんじん	kennjinn
新登場	しんとうじょう	shinntoujou
食事会	しょくじかい	shokujikai
生命体	せいめいたい	seimeitai
駅近	えきちか	ekichika
立命	りつめい	ritsumei
耳鼻科	じびか	jibika
出発日	しゅっぱつび	shuppatsubi
次回作	じかいさく	jikaisaku
運動場	うんどうじょう	unndoujou
親近感	しんきんかん	shinnkinnkann
読取	よみと|よみとり	yomito|yomitori
落語家	らくごか	rakugoka
対日	たいにち	tainichi
活動家	かつどうか	katsudouka
体育会	たいいくかい	taiikukai
二世	にせい|にせ	nisei|nise
外科医	げかい	gekai
大公開	だいこうかい	daikoukai
学習者	がくしゅうしゃ	gakushuusha
前号	ぜんごう	zenngou
活発化	かっぱつか	kappatsuka
天板	てんばん|てんいた	tennbann|tennita
等身大	とうしんだい	toushinndai
神起	しんき	shinnki
交通局	こうつうきょく	koutsuukyoku
血中	けっちゅう	kettyuu
相談者	そうだんしゃ	soudannsha
発毛	はつもう	hatsumou
定食屋	ていしょくや	teishokuya
運転者	うんてんしゃ	unntennsha
日記帳	にっきちょう	nikkityou
高速化	こうそくか	kousokuka
二期	にき	niki
予定者	よていしゃ	yoteisha
乗組員	のりくみいん	norikumiinn
角部屋	かどべや	kadobeya
運転中	うんてんちゅう	unntenntyuu
決算書	けっさんしょ	kessannsho
発送日	はっそうび	hassoubi
年式	ねんしき	nennshiki
仕事人	しごとにん	shigotoninn
名湯	めいとう	meitou
新世界	しんせかい	shinnsekai
同業者	どうぎょうしゃ	dougyousha
農業者	のうぎょうしゃ	nougyousha
開始時	かいしじ	kaishiji
配送先	はいそうさき	haisousaki
小部屋	こべや	kobeya
練習中	れんしゅうちゅう	rennshuutyuu
弱体化	じゃくたいか	jakutaika
仕様書	しようしょ	shiyousho
注文日	ちゅうもんび	tyuumonnbi
電子化	でんしか	dennshika
高感度	こうかんど	koukanndo
発行者	はっこうしゃ	hakkousha
休館日	きゅうかんび	kyuukannbi
大流行	おおはやり|だいりゅうこう	oohayari|dairyuukou
役員会	やくいんかい	yakuinnkai
前駅	ぜんえき	zenneki
間取図	まどりず	madorizu
水平線	すいへいせん	suiheisenn
代引	だいびき	daibiki
歯列	しれつ	shiretsu
配当金	はいとうきん	haitoukinn
工作物	こうさくぶつ	kousakubutsu
事業化	じぎょうか	jigyouka
一本化	いっぽんか	ipponnka
福音書	ふくいんしょ	fukuinnsho
何物	なにもの	nanimono
急登	きゅうとう	kyuutou
期待感	きたいかん	kitaikann
実業家	じつぎょうか	jitsugyouka
員数	いんずう	innzuu
見放題	みほうだい	mihoudai
竹炭	ちくたん	chikutann
北西部	ほくせいぶ	hokuseibu
高級車	こうきゅうしゃ	koukyuusha
温度計	おんどけい	onndokei
一問	いちもん	ichimonn
事業場	じぎょうじょう	jigyoujou
教育者	きょういくしゃ	kyouikusha
実力者	じつりょくしゃ	jitsuryokusha
想定外	そうていがい	souteigai
号室	ごうしつ	goushitsu
予定表	よていひょう	yoteihyou
両目	りょうめ	ryoume
入場者	にゅうじょうしゃ	nyuujousha
全話	ぜんわ	zennwa
練習会	れんしゅうかい	rennshuukai
新世代	しんせだい	shinnsedai
流行語	りゅうこうご	ryuukougo
速読	そくどく	sokudoku
県内外	けんないがい	kennnaigai
南西部	なんせいぶ	nannseibu
倍速	ばいそく	baisoku
仕上	しあげ|しあが	shiage|shiaga
文学者	ぶんがくしゃ	bunngakusha
原曲	げんきょく	gennkyoku
手指	しゅし	shushi
同表	どうひょう	douhyou
大都会	だいとかい	daitokai
色味	いろみ	iromi
作曲者	さっきょくしゃ	sakkyokusha
表面化	ひょうめんか	hyoumennka
定年後	ていねんご	teinenngo
細分化	さいぶんか	saibunnka
北東部	ほくとうぶ	hokutoubu
学会員	がっかいいん	gakkaiinn
一筆	いっぴつ|ひとふで	ippitsu|hitofude
都心部	としんぶ	toshinnbu
次年度	じねんど	jinenndo
文学館	ぶんがくかん	bunngakukann
宿場町	しゅくばまち	shukubamachi
年度内	ねんどない	nenndonai
集客力	しゅうきゃくりょく	shuukyakuryoku
地理院	ちりいん	chiriinn
談話室	だんわしつ	dannwashitsu
計算式	けいさんしき	keisannshiki
曲集	きょくしゅう	kyokushuu
定形外	ていけいがい	teikeigai
木箱	きばこ	kibako
数学者	すうがくしゃ	suugakusha
両岸	りょうがん	ryougann
同行者	どうこうしゃ	doukousha
部内	ぶない	bunai
年祭	ねんさい	nennsai
家庭科	かていか	kateika
使命感	しめいかん	shimeikann
同号	どうごう	dougou
進行形	しんこうけい	shinnkoukei
全国区	ぜんこくく	zennkokuku
全道	ぜんどう	zenndou
病原体	びょうげんたい	byougenntai
洋食屋	ようしょくや	youshokuya