必要	ひつよう	hitsuyou
利用	りよう	riyou
登録	とうろく	touroku
最近	さいきん	saikinn
参加	さんか	sannka
以下	いか	ika
関連	かんれん	kannrenn
最新	さいしん	saishinn
無料	むりょう	muryou
参考	さんこう	sannkou
希望	きぼう	kibou
追加	ついか	tsuika
説明	せつめい	setsumei
目的	もくてき	mokuteki
作成	さくせい	sakusei
周辺	しゅうへん	shuuhenn
予約	よやく	yoyaku
関係	かんけい	kannkei
友達	ともだち	tomodachi
大変	たいへん	taihenn
求人	きゅうじん	kyuujinn
結果	けっか	kekka
送信	そうしん	soushinn
案内	あんない	annnai
重要	じゅうよう	juuyou
協力	きょうりょく	kyouryoku
健康	けんこう	kennkou
最後	さいご	saigo
無理	むり	muri
以上	いじょう	ijou
昨日	きのう|さくじつ	kinou|sakujitsu
最初	さいしょ	saisho
残念	ざんねん	zannnenn
方法	ほうほう	houhou
便利	べんり	bennri
機会	きかい	kikai
成功	せいこう	seikou
送料	そうりょう	souryou
料理	りょうり	ryouri
変化	へんか|へんげ	hennka|hennge
当然	とうぜん	touzenn
自然	しぜん|じねん	shizenn|jinenn
体験	たいけん	taikenn
投票	とうひょう	touhyou
参照	さんしょう	sannshou
観光	かんこう	kannkou
完成	かんせい	kannsei
特集	とくしゅう	tokushuu
失敗	しっぱい	shippai
位置	いち	ichi
管理	かんり	kannri
返信	へんしん	hennshinn
形成	けいせい	keisei
満足	まんぞく	mannzoku
料金	りょうきん	ryoukinn
要望	ようぼう	youbou
季節	きせつ	kisetsu
記録	きろく	kiroku
成長	せいちょう	seityou
自信	じしん	jishinn
努力	どりょく	doryoku
配信	はいしん	haishinn
特定	とくてい	tokutei
失礼	しつれい	shitsurei
受付	うけつけ	uketsuke
大阪	おおさか	oosaka
不安	ふあん	fuann
約束	やくそく	yakusoku
以前	いぜん	izenn
印刷	いんさつ	innsatsu
種類	しゅるい	shurui
英語	えいご	eigo
成立	せいりつ	seiritsu
達成	たっせい	tassei
不明	ふめい	fumei
要求	ようきゅう	youkyuu
以外	いがい	igai
改正	かいせい	kaisei
馬鹿	ばか|ばかげ	baka|bakage
目標	もくひょう	mokuhyou
最高	さいこう	saikou
関心	かんしん	kannshinn
試合	しあい|じあい|しあう	shiai|jiai|shiau
沖縄	おきなわ	okinawa
法人	ほうじん	houjinn
発信	はっしん	hasshinn
課題	かだい	kadai
特化	とっか	tokka
分類	ぶんるい	bunnrui
未来	みらい	mirai
区別	くべつ	kubetsu
共通	きょうつう	kyoutsuu
共有	きょうゆう	kyouyuu
出席	しゅっせき	shusseki
低下	ていか	teika
各号	かくごう	kakugou
小説	しょうせつ	shousetsu
配置	はいち	haichi
取材	しゅざい	shuzai
放置	ほうち	houchi
記念	きねん	kinenn
最大	さいだい	saidai
苦労	くろう|ぐろう	kurou|gurou
各種	かくしゅ	kakushu
笑顔	えがお	egao
完全	かんぜん	kannzenn
観察	かんさつ	kannsatsu
工夫	くふう|こうふ	kufuu|koufu
受信	じゅしん	jushinn
不足	ふそく|ぶそく	fusoku|busoku
氏名	しめい	shimei
生産	せいさん	seisann
昨年	さくねん	sakunenn
育成	いくせい	ikusei
固定	こてい	kotei
辞書	じしょ	jisho
公共	こうきょう	koukyou
教養	きょうよう	kyouyou
卒業	そつぎょう	sotsugyou
健全	けんぜん	kennzenn
祝日	しゅくじつ	shukujitsu
交付	こうふ	koufu
土産	みやげ|どさん	miyage|dosann
追求	ついきゅう|おいもとめ	tsuikyuu|oimotome
加工	かこう	kakou
老人	ろうじん	roujinn
市民	しみん	shiminn
建物	たてもの|たてもん	tatemono|tatemonn
食材	しょくざい	shokuzai
必死	ひっし	hisshi
加入	かにゅう	kanyuu
国民	こくみん|くにたみ	kokuminn|kunitami
送付	そうふ	soufu
散歩	さんぽ	sannpo
無事	ぶじ	buji
有無	うむ	umu
法令	ほうれい	hourei
勝利	しょうり	shouri
連想	れんそう	rennsou
結局	けっきょく	kekkyoku
加算	かさん	kasann
成果	せいか	seika
不要	ふよう	fuyou
結成	けっせい	kessei
倉庫	そうこ	souko
何卒	なにとぞ	nanitozo
主要	しゅよう	shuyou
愛用	あいよう	aiyou
反省	はんせい	hannsei
特別	とくべつ	tokubetsu
特典	とくてん	tokutenn
入札	にゅうさつ	nyuusatsu
信用	しんよう	shinnyou
勇気	ゆうき	yuuki
題材	だいざい	daizai
連動	れんどう	renndou
感覚	かんかく	kannkaku
会議	かいぎ	kaigi
戦争	せんそう	sennsou
出産	しゅっさん	shussann
単語	たんご	tanngo
業種	ぎょうしゅ	gyoushu
通信	つうしん	tsuushinn
機器	きき	kiki
選出	せんしゅつ	sennshutsu
自覚	じかく	jikaku
野菜	やさい	yasai
育児	いくじ	ikuji
事例	じれい	jirei
連続	れんぞく	rennzoku
受験	じゅけん	jukenn
各社	かくしゃ	kakusha
完売	かんばい	kannbai
発達	はったつ	hattatsu
持参	じさん	jisann
生成	せいせい	seisei
飲料	いんりょう|のみりょう	innryou|nomiryou
建立	こんりゅう	konnryuu
加筆	かひつ	kahitsu
風景	ふうけい	fuukei
変動	へんどう	henndou
冷静	れいせい	reisei
香水	こうすい	kousui
生徒	せいと	seito
選手	せんしゅ	sennshu
配達	はいたつ	haitatsu
梅雨	つゆ|ばいう|づゆ	tsuyu|baiu|duyu
順調	じゅんちょう	junntyou
大量	たいりょう	tairyou
順位	じゅんい	junni
日付	ひづけ	hiduke
商標	しょうひょう	shouhyou
埼玉	さいたま	saitama
原料	げんりょう	gennryou
選定	せんてい	senntei
祝福	しゅくふく	shukufuku
出典	しゅってん	shuttenn
材料	ざいりょう	zairyou
伝説	でんせつ	dennsetsu
観点	かんてん	kanntenn
店側	みせがわ	misegawa
最悪	さいあく	saiaku
有料	ゆうりょう	yuuryou
人材	じんざい	jinnzai
発覚	はっかく	hakkaku
戸建	こだて	kodate
議長	ぎちょう	gityou
景色	けしき|げしき	keshiki|geshiki
協議	きょうぎ	kyougi
徒然	つれづれ|とぜん	tsuredure|tozenn
例外	れいがい	reigai
当選	とうせん	tousenn
徒歩	とほ	toho
不満	ふまん	fumann
順番	じゅんばん	junnbann
外観	がいかん	gaikann
光景	こうけい	koukei
満開	まんかい	mannkai
愛知	あいち	aichi
選挙	せんきょ	sennkyo
加速	かそく	kasoku
変身	へんしん	hennshinn
省令	しょうれい	shourei
好感	こうかん	koukann
安置	あんち	annchi
児童	じどう	jidou
共感	きょうかん	kyoukann
地位	ちい	chii
面積	めんせき	mennseki
兵庫	ひょうご	hyougo
焼肉	やきにく	yakiniku
付着	ふちゃく	futyaku
最強	さいきょう	saikyou
対戦	たいせん	taisenn
滋賀	しが	shiga
天候	てんこう	tennkou
周知	しゅうち	shuuchi
最長	さいちょう	saityou
実験	じっけん	jikkenn
念頭	ねんとう	nenntou
初期	しょき	shoki
改良	かいりょう	kairyou
考案	こうあん	kouann
待機	たいき	taiki
満面	まんめん	mannmenn
週末	しゅうまつ	shuumatsu
節約	せつやく	setsuyaku
書類	しょるい	shorui
調節	ちょうせつ	tyousetsu
見積	みつもり|みつも	mitsumori|mitsumo
集約	しゅうやく	shuuyaku
手順	てじゅん	tejunn
達人	たつじん	tatsujinn
有利	ゆうり	yuuri
録画	ろくが	rokuga
標高	ひょうこう	hyoukou
静岡	しずおか	shizuoka
各地	かくち	kakuchi
不幸	ふこう	fukou
夜景	やけい	yakei
命令	めいれい	meirei
録音	ろくおん	rokuonn
照合	しょうごう	shougou
未然	みぜん	mizenn
落札	らくさつ	rakusatsu
良好	りょうこう	ryoukou
全然	ぜんぜん	zennzenn
帰省	きせい	kisei
信号	しんごう	shinngou
付加	ふか	fuka
試験	しけん	shikenn
苦笑	くしょう	kushou
最低	さいてい	saitei
借金	しゃっきん	shakkinn
苦戦	くせん	kusenn
新潟	にいがた	niigata
観戦	かんせん	kannsenn
最中	さいちゅう|もなか|さなか	saityuu|monaka|sanaka
不正	ふせい	fusei
楽器	がっき	gakki
議決	ぎけつ	giketsu
不便	ふべん	fubenn
産業	さんぎょう	sanngyou
差別	さべつ|しゃべつ	sabetsu|shabetsu
特筆	とくひつ	tokuhitsu
園芸	えんげい	enngei
当初	とうしょ	tousho
特色	とくしょく	tokushoku
成分	せいぶん	seibunn
付近	ふきん	fukinn
民宿	みんしゅく	minnshuku
機種	きしゅ	kishu
完結	かんけつ	kannketsu
民主	みんしゅ	minnshu
改変	かいへん	kaihenn
記法	きほう	kihou
訓練	くんれん	kunnrenn
単発	たんぱつ	tannpatsu
岐阜	ぎふ	gifu
強要	きょうよう	kyouyou
手法	しゅほう	shuhou
連結	れんけつ	rennketsu
考察	こうさつ	kousatsu
未定	みてい	mitei
連発	れんぱつ	rennpatsu
続出	ぞくしゅつ	zokushutsu
利点	りてん	ritenn
味覚	みかく	mikaku
協働	きょうどう	kyoudou
戦後	せんご	senngo
単位	たんい	tanni
分散	ぶんさん	bunnsann
持続	じぞく	jizoku
愛犬	あいけん	aikenn
直結	ちょっけつ	tyokketsu
照会	しょうかい	shoukai
上位	じょうい	joui
根底	こんてい	konntei
浴衣	ゆかた	yukata
訓令	くんれい	kunnrei
産地	さんち	sannchi
大別	たいべつ	taibetsu
欠落	けつらく	ketsuraku
熱心	ねっしん	nesshinn
参戦	さんせん	sannsenn
年末	ねんまつ	nennmatsu
連休	れんきゅう	rennkyuu
養成	ようせい	yousei
関節	かんせつ	kannsetsu
理念	りねん	rinenn
議題	ぎだい	gidai
共同	きょうどう	kyoudou
数量	すうりょう	suuryou
多岐	たき	taki
機械	きかい	kikai
愛車	あいしゃ	aisha
助成	じょせい	josei
住民	じゅうみん	juuminn
事典	じてん	jitenn
成約	せいやく	seiyaku
例年	れいねん	reinenn
最短	さいたん	saitann
愛読	あいどく	aidoku
待望	たいぼう	taibou
合成	ごうせい	gousei
愛媛	えひめ	ehime
戦場	せんじょう|いくさば	sennjou|ikusaba
残業	ざんぎょう	zanngyou
欠品	けっぴん	keppinn
極上	ごくじょう	gokujou
極意	ごくい	gokui
街中	まちじゅう|まちなか	machijuu|machinaka
散見	さんけん	sannkenn
調達	ちょうたつ	tyoutatsu
浴室	よくしつ	yokushitsu
標的	ひょうてき	hyouteki
養子	ようし	youshi
右側	みぎがわ|うそく	migigawa|usoku
矢印	やじるし	yajirushi
集結	しゅうけつ	shuuketsu
結合	けつごう	ketsugou
試算	しさん	shisann
原案	げんあん	gennann
栄養	えいよう	eiyou
分岐	ぶんき	bunnki
要約	ようやく	youyaku
佐賀	さが	saga
各国	かくこく|かっこく	kakukoku|kakkoku
発令	はつれい	hatsurei
上司	じょうし	joushi
徳島	とやま	toyama
各課	かくか	kakuka
以内	いない	inai
上陸	じょうりく	jouriku
通貨	つうか	tsuuka
改定	かいてい	kaitei
終結	しゅうけつ	shuuketsu
鳥類	ちょうるい	tyourui
議会	ぎかい	gikai
決議	けつぎ	ketsugi
手続	てつづき	tetsuduki
熱中	ねっちゅう	nettyuu
給料	きゅうりょう	kyuuryou
連行	れんこう	rennkou
以来	いらい	irai
勇者	ゆうしゃ	yuusha
左側	ひだりがわ|さそく	hidarigawa|sasoku
協会	きょうかい	kyoukai
相続	そうぞく	souzoku
議員	ぎいん	giinn
人種	じんしゅ	jinnshu
民族	みんぞく	minnzoku
原付	げんつき	genntsuki
群生	ぐんせい	gunnsei
競売	きょうばい|けいばい|せりうり	kyoubai|keibai|seriuri
右折	うせつ	usetsu
側面	そくめん	sokumenn
必見	ひっけん	hikkenn
好意	こうい	koui
社説	しゃせつ	shasetsu
日産	にっさん	nissann
改行	かいぎょう	kaigyou
左折	させつ	sasetsu
欠点	けってん	kettenn
不服	ふふく	fufuku
改名	かいめい	kaimei
労働	ろうどう	roudou
生協	せいきょう	seikyou
内包	ないほう	naihou
各自	かくじ	kakuji
県民	けんみん	kennminn
栃木	とちぎ	tochigi
観客	かんきゃく	kannkyaku
列挙	れっきょ	rekkyo
同課	どうか	douka
松竹	しょうちく	shouchiku
群馬	ぐんま	gunnma
初日	しょにち|はつひ|はつび	shonichi|hatsuhi|hatsubi
指標	しひょう	shihyou
連日	れんじつ	rennjitsu
日課	にっか	nikka
課金	かきん	kakinn
初回	しょかい	shokai
種別	しゅべつ	shubetsu
部類	ぶるい	burui
加味	かみ	kami
競争	きょうそう	kyousou
点灯	てんとう	tenntou
特選	とくせん	tokusenn
交差	こうさ	kousa
満天	まんてん	manntenn
無線	むせん	musenn
工芸	こうげい	kougei
良品	りょうひん	ryouhinn
未知	みち	michi
司会	しかい	shikai
好調	こうちょう	koutyou
特長	とくちょう	tokutyou
信念	しんねん	shinnnenn
初音	はつね	hatsune
月別	つきべつ	tsukibetsu
山積	さんせき|やまづみ	sannseki|yamadumi
小児	しょうに	shouni
結集	けっしゅう	kesshuu
不利	ふり	furi
参画	さんかく	sannkaku
金利	きんり	kinnri
給食	きゅうしょく	kyuushoku
気候	きこう	kikou
外灯	がいとう	gaitou
安静	あんせい	annsei
人類	じんるい	jinnrui
別人	べつじん	betsujinn
不当	ふとう	futou
大笑	たいしょう	taishou
人達	ひとたち	hitotachi
辞典	じてん	jitenn
便乗	びんじょう	binnjou
究極	きゅうきょく	kyuukyoku
景観	けいかん	keikann
参入	さんにゅう	sannnyuu
察知	さっち	sacchi
機関	きかん	kikann
同席	どうせき	douseki
単品	たんぴん	tannpinn
成人	せいじん	seijinn
調印	ちょういん	tyouinn
茨城	いばらぎ	ibaragi
不動	ふどう	fudou
世辞	せじ	seji
消失	しょうしつ|きえうせ	shoushitsu|kieuse
軍配	ぐんばい	gunnbai
残暑	ざんしょ	zannsho
酒類	しゅるい	shurui
借入	かりいれ	kariire
最速	さいそく	saisoku
用法	ようほう	youhou
初夏	しょか	shoka
景気	けいき|げいき	keiki|geiki
建学	けんがく	kenngaku
底本	ていほん	teihonn
食器	しょっき	shokki
本案	ほんあん	honnann
共生	きょうせい	kyousei
照明	しょうめい	shoumei
以後	いご	igo
目印	めじるし	mejirushi
満席	まんせき	mannseki
借家	しゃくや|しゃっか|かりいえ	shakuya|shakka|kariie
入浴	にゅうよく	nyuuyoku
挙行	きょこう	kyokou
改札	かいさつ	kaisatsu
各週	かくしゅう	kakushuu
初心	うぶ|しょしん	ubu|shoshinn
健勝	けんしょう	kennshou
思案	しあん|じあん	shiann|jiann
各店	かくてん	kakutenn
続行	ぞっこう	zokkou
各氏	かくし	kakushi
部位	ぶい	bui
好天	こうてん	koutenn
失望	しつぼう	shitsubou
始末	しまつ	shimatsu
受給	じゅきゅう	jukyuu
大差	たいさ	taisa
法事	ほうじ	houji
節目	ふしめ	fushime
自愛	じあい	jiai
包丁	ほうちょう|ぼうちょう	houtyou|boutyou
平然	へいぜん	heizenn
産学	さんがく	sanngaku
参列	さんれつ	sannretsu
最終	さいしゅう	saishuu
副業	ふくぎょう	fukugyou
変形	へんけい	hennkei
号給	ごうきゅう	goukyuu
品種	ひんしゅ	hinnshu
天井	てんじょう|てんせい	tennjou|tennsei
内側	うちがわ|ないそく	uchigawa|naisoku
昨夜	さくや|ゆうべ|ゆんべ	sakuya|yuube|yunnbe
借主	かりぬし	karinushi
伝達	でんたつ	denntatsu
近辺	きんぺん	kinnpenn
失念	しつねん	shitsunenn
戦国	せんごく	senngoku
集積	しゅうせき	shuuseki
道順	みちじゅん	michijunn
教材	きょうざい	kyouzai
民間	みんかん	minnkann
清栄	せいえい	seiei
発散	はっさん	hassann
国産	こくさん	kokusann
的中	てきちゅう	tekityuu
不覚	ふかく	fukaku
挙式	きょしき	kyoshiki
焼失	しょうしつ	shoushitsu
戦死	せんし	sennshi
子孫	しそん	shisonn
産物	さんぶつ	sannbutsu
無茶	むちゃ	mutya
神官	しんかん	shinnkann
不育	ふいく	fuiku
北側	きたがわ	kitagawa
取付	とりつけ	toritsuke
商材	しょうざい	shouzai
競馬	けいば	keiba
教訓	きょうくん	kyoukunn
議事	ぎじ	giji
試読	しどく	shidoku
力説	りきせつ	rikisetsu
熱意	ねつい	netsui
郡名	ぐんめい	gunnmei
投信	とうしん	toushinn
文芸	ぶんげい	bunngei
天然	てんねん	tennnenn
上達	じょうたつ	joutatsu
標語	ひょうご	hyougo
水辺	すいへん|みずべ	suihenn|mizube
用量	ようりょう	youryou
山梨	やまなし|やまなし	yamanashi|yamanashi
所要	しょよう	shoyou
老後	ろうご	rougo
願書	がんしょ	gannsho
年季	ねんき	nennki
念願	ねんがん	nenngann
満月	まんげつ	manngetsu
英和	えいわ	eiwa
栄光	えいこう	eikou
愛想	あいそ|あいそう	aiso|aisou
切望	せつぼう	setsubou
同法	どうほう	douhou
借地	しゃくち	shakuchi
愛着	あいちゃく|あいじゃく	aityaku|aijaku
別名	べつめい|べつみょう	betsumei|betsumyou
談笑	だんしょう	dannshou
手札	しゅさつ|てふだ	shusatsu|tefuda
無言	むごん	mugonn
実例	じつれい	jitsurei
最良	さいりょう	sairyou
送達	そうたつ	soutatsu
学位	がくい	gakui
米軍	べいぐん	beigunn
終戦	しゅうせん	shuusenn
日清	にっしん	nisshinn
各界	かくかい|かっかい	kakukai|kakkai
車種	しゃしゅ	shashu
通例	つうれい	tsuurei
未満	みまん	mimann
争点	そうてん	soutenn
連番	れんばん	rennbann
英数	えいすう	eisuu
折角	せっかく	sekkaku
試食	ししょく	shishoku
物議	ぶつぎ	butsugi
別物	べつもの	betsumono
食料	しょくりょう	shokuryou
昨今	さっこん	sakkonn
満室	まんしつ	mannshitsu
無実	むじつ	mujitsu
功名	こうみょう	koumyou
変色	へんしょく	hennshoku
静止	せいし	seishi
戦前	せんぜん	sennzenn
事案	じあん	jiann
産科	さんか	sannka
飛来	ひらい	hirai
未読	みどく	midoku
観念	かんねん	kannnenn
熱気	ねっき	nekki
野望	やぼう	yabou
最小	さいしょう	saishou
完食	かんしょく	kannshoku
街道	かいどう	kaidou
発案	はつあん	hatsuann
合唱	がっしょう	gasshou
西側	にしがわ	nishigawa
無数	むすう|むしゅ	musuu|mushu
共用	きょうよう	kyouyou
新卒	しんそつ	shinnsotsu
給付	きゅうふ	kyuufu
花束	はなたば	hanataba
整然	せいぜん	seizenn
信徒	しんと	shinnto
芸人	げいにん	geininn
養育	よういく	youiku
印字	いんじ	innji
別送	べっそう	bessou
時候	じこう	jikou
文例	ぶんれい	bunnrei
強固	きょうこ	kyouko
付帯	ふたい	futai
食塩	しょくえん	shokuenn
果物	くだもの	kudamono
用例	ようれい	yourei
新種	しんしゅ	shinnshu
南側	みなみがわ	minamigawa
名残	なごり	nagori
機体	きたい	kitai
通関	つうかん	tsuukann
熱戦	ねっせん	nessenn
外側	そとがわ	sotogawa
結末	けつまつ	ketsumatsu
海辺	うみべ|かいへん	umibe|kaihenn
同然	どうぜん	douzenn
連立	れんりつ	rennritsu
放牧	ほうぼく	houboku
熱望	ねつぼう	netsubou
好物	こうぶつ	koubutsu
節分	せつぶん	setsubunn
東側	ひがしがわ	higashigawa
古典	こてん	kotenn
極道	ごくどう	gokudou
不用	ふよう	fuyou
続発	ぞくはつ	zokuhatsu
多量	たりょう	taryou
入試	にゅうし	nyuushi
加熱	かねつ	kanetsu
愛飲	あいいん	aiinn
所管	しょかん	shokann
付記	ふき	fuki
重量	じゅうりょう	juuryou
便所	べんじょ	bennjo
伝送	でんそう	dennsou
初見	しょけん	shokenn
配付	はいふ	haifu
量産	りょうさん	ryousann
法的	ほうてき	houteki
夕飯	ゆうはん|ゆうめし	yuuhann|yuumeshi
散会	さんかい	sannkai
試着	しちゃく	shityaku
和英	わえい	waei
落選	らくせん	rakusenn
競合	きょうごう	kyougou
全焼	ぜんしょう	zennshou
配管	はいかん	haikann
所以	ゆえん	yuenn
画材	がざい	gazai
無知	むち	muchi
反旗	はんき	hannki
建機	けんき	kennki
香料	こうりょう	kouryou
必読	ひつどく	hitsudoku
協同	きょうどう	kyoudou
新法	しんぽう	shinnpou
不良	ふりょう	furyou
牧場	ぼくじょう|まきば	bokujou|makiba
日別	ひべつ	hibetsu
必然	ひつぜん	hitsuzenn
不意	ふい	fui
式典	しきてん	shikitenn
手芸	しゅげい	shugei
時給	じきゅう	jikyuu
特養	とくよう	tokuyou
単身	たんしん	tannshinn
予選	よせん	yosenn
敗北	はいぼく	haiboku
協定	きょうてい	kyoutei
不調	ふちょう|ぶちょう	futyou|butyou
少量	しょうりょう	shouryou
残高	ざんだか	zanndaka
工法	こうほう	kouhou
連中	れんちゅう|れんじゅう	renntyuu|rennjuu
人参	にんじん	ninnjinn
満車	まんしゃ	mannsha
英日	えいにち	einichi
民法	みんぽう	minnpou
害虫	がいちゅう	gaityuu
公約	こうやく	kouyaku
信教	しんきょう	shinnkyou
各駅	かくえき	kakueki
関知	かんち	kannchi
着陸	ちゃくりく	tyakuriku
反戦	はんせん	hannsenn
府令	ふれい	furei
産声	うぶごえ	ubugoe
試作	しさく	shisaku
高卒	こうそつ	kousotsu
順次	じゅんじ	junnji
光栄	こうえい	kouei
軽量	けいりょう	keiryou
初耳	はつみみ	hatsumimi
別表	べっぴょう	beppyou
公的	こうてき	kouteki
治安	ちあん	chiann
大輪	たいりん|だいりん	tairinn|dairinn
短信	たんしん	tannshinn
期末	きまつ	kimatsu
礼節	れいせつ	reisetsu
建国	けんこく	kennkoku
実印	じついん	jitsuinn
労力	ろうりょく	rouryoku
方位	ほうい	houi
器材	きざい	kizai
寺伝	じでん	jidenn
司法	しほう	shihou
積雪	せきせつ	sekisetsu
主観	しゅかん	shukann
白衣	はくい|びゃくえ|びゃくい	hakui|byakue|byakui
機運	きうん	kiunn
空席	くうせき	kuuseki
試練	しれん	shirenn
産出	さんしゅつ	sannshutsu
集成	しゅうせい	shuusei
主菜	しゅさい	shusai
無礼	ぶれい	burei
民家	みんか	minnka
機材	きざい	kizai
祝辞	しゅくじ	shukuji
発熱	はつねつ	hatsunetsu
無用	むよう	muyou
線香	せんこう	sennkou
英文	えいぶん	eibunn
無休	むきゅう	mukyuu
公然	こうぜん	kouzenn
包帯	ほうたい	houtai
家臣	かしん	kashinn
極力	きょくりょく	kyokuryoku
副菜	ふくさい	fukusai
同省	どうしょう	doushou
説教	せっきょう	sekkyou
道標	どうひょう|みちしるべ	douhyou|michishirube
大臣	だいじん|おおおみ|おとど	daijinn|ooomi|otodo
季語	きご	kigo
選別	せんべつ	sennbetsu
器具	きぐ	kigu
未見	みけん	mikenn
対極	たいきょく	taikyoku
低温	ていおん	teionn
着信	ちゃくしん	tyakushinn
必定	ひつじょう	hitsujou
衣服	いふく	ifuku
熱唱	ねっしょう	nesshou
特例	とくれい	tokurei
奈落	ならく	naraku
県別	けんべつ	kennbetsu
社伝	しゃでん	shadenn
敗戦	はいせん	haisenn
定説	ていせつ	teisetsu
時差	じさ	jisa
勝敗	しょうはい	shouhai
最期	さいご	saigo
急変	きゅうへん	kyuuhenn
末日	まつじつ	matsujitsu
連帯	れんたい	renntai
転機	てんき	tennki
熱湯	ねっとう|あつゆ	nettou|atsuyu
民話	みんわ	minnwa
月末	げつまつ|つきずえ	getsumatsu|tsukizue
果実	かじつ	kajitsu
大鹿	おおしか	ooshika
法案	ほうあん	houann
産直	さんちょく	sanntyoku
号泣	ごうきゅう	goukyuu
岐路	きろ	kiro
世帯	しょたい|せたい|じょたい	shotai|setai|jotai
選考	せんこう	sennkou
観月	かんげつ	kanngetsu
具材	ぐざい	guzai
滋養	じよう	jiyou
新芽	しんめ	shinnme
山菜	さんさい	sannsai
無残	むざん	muzann
筆順	ひつじゅん	hitsujunn
首席	しゅせき	shuseki
辞表	じひょう	jihyou
欠席	けっせき	kesseki
有害	ゆうがい	yuugai
清流	せいりゅう	seiryuu
利口	りこう	rikou
例会	れいかい	reikai
初物	はつもの	hatsumono
必着	ひっちゃく	hittyaku
別紙	べっし	besshi
月給	げっきゅう	gekkyuu
伝来	でんらい	dennrai
街角	まちかど	machikado
例文	れいぶん	reibunn
浴用	よくよう	yokuyou
借景	しゃっけい	shakkei
良貨	りょうか	ryouka
兆候	ちょうこう	tyoukou
冬季	とうき	touki
置物	おきもの	okimono
愛国	あいこく	aikoku
白熱	はくねつ	hakunetsu
挙手	きょしゅ	kyoshu
両側	りょうがわ|りょうそく	ryougawa|ryousoku
城主	じょうしゅ	joushu
外伝	がいでん	gaidenn
参道	さんどう	sanndou
塩分	えんぶん	ennbunn
下位	かい	kai
通説	つうせつ	tsuusetsu
産生	さんせい	sannsei
前節	ぜんせつ	zennsetsu
良心	りょうしん	ryoushinn
白菜	はくさい|しろな	hakusai|shirona
不通	ふつう	futsuu
浴場	よくじょう	yokujou
手塩	てしお	teshio
悲願	ひがん	higann
今季	こんき	konnki
冷水	ひやみず|れいすい	hiyamizu|reisui
血管	けっかん	kekkann
平静	へいせい	heisei
健食	けんしょく	kennshoku
主夫	しゅふ	shufu
民度	みんど	minndo
類語	るいご	ruigo
気功	きこう	kikou
無力	むりょく	muryoku
希求	ききゅう|けく|けぐ	kikyuu|keku|kegu
要所	ようしょ	yousho
木材	もくざい	mokuzai
国別	くにべつ	kunibetsu
力量	りきりょう	rikiryou
国旗	こっき	kokki
特売	とくばい	tokubai
花輪	はなわ	hanawa
各校	かくこう|かっこう	kakukou|kakkou
法要	ほうよう	houyou
縄文	じょうもん	joumonn
大陸	たいりく	tairiku
法相	ほうしょう|ほっそう	houshou|hossou
未練	みれん	mirenn
人民	じんみん	jinnminn
失意	しつい	shitsui
初級	しょきゅう	shokyuu
底力	そこぢから	sokodikara
養生	ようじょう	youjou
決戦	けっせん	kessenn
満員	まんいん	manninn
残金	ざんきん	zannkinn
車輪	しゃりん	sharinn
共産	きょうさん	kyousann
官位	かんい	kanni
本機	ほんき	honnki
英字	えいじ	eiji
続投	ぞくとう	zokutou
軍隊	ぐんたい	gunntai
熱愛	ねつあい	netsuai
改悪	かいあく	kaiaku
試乗	しじょう	shijou
		
良い	いい|よい	ii|yoi
無い	ない	nai
好き	すき|こうき|よき|ずき	suki|kouki|yoki|zuki
お願い	おねがい	onegai
続く	つづく	tsuduku
変わる	かわる	kawaru
初めて	はじめて	hajimete
特に	とくに	tokuni
続ける	つづける	tsudukeru
求める	もとめる	motomeru
選ぶ	えらぶ	erabu
置く	おく	oku
付け	つけ|づけ	tsuke|duke
残る	のこる	nokoru
付き	つき|づき	tsuki|duki
必ず	かならず	kanarazu
変える	かえる	kaeru
大好き	だいすき	daisuki
名無し	ななし	nanashi
覚える	おぼえる	oboeru
加える	くわえる	kuwaeru
付く	つく|づく	tsuku|duku
残す	のこす	nokosu
最も	もっとも|いとも	mottomo|itomo
願う	ねがう|ねごう	negau|negou
信じる	しんじる	shinnjiru
低い	ひくい|ひきい	hikui|hikii
働く	はたらく|ばたらく	hataraku|bataraku
笑う	わらう|わろう	warau|warou
周り	まわり	mawari
例えば	たとえば	tatoeba
香り	かおり	kaori
伝え	つたえ|づたえ	tsutae|dutae
飛ぶ	とぶ	tobu
一戸建て	いっこだて	ikkodate
連れ	つれ|づれ	tsure|dure
焼き	やき|たき	yaki|taki
試し	ためし|だめし	tameshi|dameshi
選び	えらび	erabi
借りる	かりる|がりる	kariru|gariru
別に	べつに	betsuni
失う	うしなう|うしのう|のう	ushinau|ushinou|nou
残り	のこり	nokori
ご飯	ごはん	gohann
戦い	たたかい|おののい|そよい	tatakai|ononoi|soyoi
熱い	あつい|あちい	atsui|achii
建てる	たてる|だてる	tateru|dateru
関わる	かかわる	kakawaru
静か	しずか	shizuka
好み	このみ|ごのみ	konomi|gonomi
伝わる	つたわる	tsutawaru
手続き	てつづき	tetsuduki
泣く	なく	naku
辺り	あたり	atari
笑い	わらい	warai
働き	はたらき|ばたらき	hataraki|bataraki
挙げる	あげる	ageru
初め	はじめ|そめ|ぞめ	hajime|some|zome
戦う	たたかう|たたこう	tatakau|tatakou
望む	のぞむ	nozomu
改めて	あらためて	aratamete
気付く	きづく	kiduku
別れ	わかれ	wakare
愛しい	いとしい	itoshii
相変わらず	あいかわらず	aikawarazu
結ぶ	むすぶ	musubu
冷たい	つめたい|つべたい	tsumetai|tsubetai
果たす	はたす	hatasu
お伝え	おつたえ	otsutae
単に	たんに	tannni
努める	つとめる	tsutomeru
無くなる	なくなる	nakunaru
辞める	やめる	yameru
伝える	つたえる	tsutaeru
焼く	やく|たく	yaku|taku
折る	おる	oru
飛ばす	とばす	tobasu
包む	つつむ|くるむ	tsutsumu|kurumu
泣き	なき	naki
受け付け	うけつけ	uketsuke
引き続き	ひきつづき	hikitsuduki
付ける	つける|づける	tsukeru|dukeru
参る	まいる	mairu
選べる	えらべる	eraberu
積む	つむ|づむ	tsumu|dumu
極めて	きわめて	kiwamete
満たす	みたす	mitasu
共に	ともに	tomoni
取り付け	とりつけ	toritsuke
付き合い	つきあい|づきあい	tsukiai|dukiai
治る	なおる|おさまる	naoru|osamaru
単なる	たんなる	tannnaru
付き合う	つきあう|つきおう	tsukiau|tsukiou
成る	なる	naru
仲良く	なかよく	nakayoku
見積もり	みつもり	mitsumori
愛する	あいする	aisuru
加わる	くわわる	kuwawaru
試み	こころみ	kokoromi
愛す	あいす	aisu
お笑い	おわらい	owarai
達す	たっす	tassu
浴びる	あびる	abiru
お祝い	おいわい	oiwai
笑える	わらえる	waraeru
満ちる	みちる	michiru
見積り	みつもり	mitsumori
固い	かたい	katai
お手伝い	おてつだい	otetsudai
祝い	いわい|ほがい|ほい	iwai|hogai|hoi
争い	あらそい|あらがい	arasoi|aragai
果たして	はたして	hatashite
要る	いる	iru
飛び出す	とびだす	tobidasu
手伝い	てつだい	tetsudai
観る	みる	miru
笑み	えみ	emi
例える	たとえる	tatoeru
要するに	ようするに	yousuruni
固め	かため|がため	katame|gatame
必ずしも	かならずしも	kanarazushimo
未だに	いまだに	imadani
散る	ちる|あかる	chiru|akaru
未だ	いまだ|まだ	imada|mada
建つ	たつ|だつ	tatsu|datsu
照らす	てらす	terasu
治す	なおす|しろす	naosu|shirosu
浅い	あさい	asai
利く	きく	kiku
要する	ようする	yousuru
固まる	かたまる	katamaru
果て	はて	hate
好む	このむ	konomu
お好み焼き	おこのみやき	okonomiyaki
目覚め	めざめ	mezame
覚める	さめる|ざめる	sameru|zameru
成り立つ	なりたつ	naritatsu
冷え	ひえ|びえ|つめてえ|つべてえ	hie|bie|tsumetee|tsubetee
手伝う	てつだう|てつどう	tetsudau|tetsudou
唱える	となえる	tonaeru
関わり	かかわり	kakawari
差し	さし|ざし	sashi|zashi
冷やす	ひやす	hiyasu
説く	とく	toku
結び	むすび|けつび	musubi|ketsubi
群れ	むれ|むらがれ	mure|muragare
望み	のぞみ	nozomi
選び方	えらびかた	erabikata
欠け	かけ	kake
味付け	あじつけ	ajitsuke
泣ける	なける	nakeru
産む	うむ	umu
焼け	やけ	yake
日焼け	ひやけ	hiyake
改め	あらため	aratame
敗れる	やぶれる	yabureru
望ましい	のぞましい	nozomashii
便り	たより|だより	tayori|dayori
要は	ようは	youha
位置づけ	いちづけ	ichiduke
生き残る	いきのこる	ikinokoru
争う	あらそう|あらがう|あらごう	arasou|aragau|aragou
積もる	つもる	tsumoru
好ましい	このましい	konomashii
富む	とむ	tomu
冷める	さめる|ざめる	sameru|zameru
日差し	ひざし	hizashi
焼き鳥	やきとり	yakitori
仲良し	なかよし	nakayoshi
帯びる	おびる	obiru
差し上げる	さしあげる	sashiageru
養う	やしなう|やしのう	yashinau|yashinou
包み	つつみ|くるみ|づつみ|ぐるみ|ずつみ	tsutsumi|kurumi|dutsumi|gurumi|zutsumi
ご苦労	ごくろう	gokurou
無理やり	むりやり	muriyari
気持ち良い	きもちよい	kimochiyoi
置き場	おきば	okiba
結びつく	むすびつく	musubitsuku
祝う	いわう|いおう	iwau|iou
試す	ためす	tamesu
折り返し	おりかえし	orikaeshi
お参り	おまいり	omairi
積み重ね	つみかさね	tsumikasane
競う	きそう|きおう	kisou|kiou
名付け	なづけ	naduke
働ける	はたらける	hatarakeru
達する	たっする	tassuru
たこ焼き	たこやき	takoyaki
欠く	かく	kaku
要す	ようす	yousu
焼きそば	やきそば	yakisoba
菜の花	なのはな	nanohana
変る	かわる	kawaru
差し出す	さしだす|さしいだす	sashidasu|sashiidasu
成す	なす	nasu
無くす	なくす	nakusu
案の定	あんのじょう	annnojou
買い求める	かいもとめる	kaimotomeru
栄え	はえ|さかえ|ばえ	hae|sakae|bae
覚ます	さます	samasu
生まれ変わる	うまれかわる	umarekawaru
望める	のぞめる	nozomeru
察し	さっし	sasshi
欠ける	かける	kakeru
着付け	きつけ	kitsuke
極め	きめ|きわめ|ぎめ	kime|kiwame|gime
満つ	みつ	mitsu
付す	ふす	fusu
夕焼け	ゆうやけ	yuuyake
付け加える	つけくわえる	tsukekuwaeru
産まれる	うまれる	umareru
戦える	たたかえる	tatakaeru
働きかけ	はたらきかけ	hatarakikake
折りたたみ	おりたたみ	oritatami
香ばしい	こうばしい	koubashii
老い	おい	oi
見極め	みきわめ	mikiwame
飛べる	とべる	toberu
灯り	ともり|あかり	tomori|akari
結びつける	むすびつける	musubitsukeru
省く	はぶく	habuku
お便り	おたより	otayori
見失う	みうしなう|みうしのう	miushinau|miushinou
課す	かす	kasu
置ける	おける	okeru
焼き肉	やきにく	yakiniku
利回り	りまわり	rimawari
散らし	ちらし	chirashi
飛び交う	とびかう|とびこう	tobikau|tobikou
照れ	てれ	tere
愛らしい	あいらしい	airashii
積み上げ	つみあげ	tsumiage
順に	じゅんに	junnni
位置付け	いちづけ	ichiduke
近付く	ちかづく	chikaduku
子連れ	こづれ	kodure
好い	よい|こうい|すい|いい	yoi|koui|sui|ii
差し入れ	さしいれ	sashiire
欠かす	かかす	kakasu
残せる	のこせる	nokoseru
別れる	わかれる	wakareru
取り付ける	とりつける	toritsukeru
目覚まし	めざまし	mezamashi
産み	うみ	umi
すき焼き	すきやき	sukiyaki
改める	あらためる	aratameru
好く	すく|よく	suku|yoku
生き残り	いきのこり	ikinokori
連なる	つらなる	tsuranaru
大笑い	おおわらい	oowarai
気が付く	きがつく	kigatsuku
健やか	すこやか	sukoyaka
不味い	まずい|まじい	mazui|majii
戸建て	こだて	kodate
内祝い	うちいわい	uchiiwai
低め	ひくめ	hikume
兆し	きざし	kizashi
笑い声	わらいごえ	waraigoe
治まる	おさまる	osamaru
折り紙	おりがみ	origami
取付け	とりつけ	toritsuke
願い事	ねがいごと	negaigoto
課する	かする	kasuru
差す	さす	sasu
差し引く	さしひく	sashihiku
仲間入り	なかまいり	nakamairi
付け根	つけね	tsukene
伝う	つたう|つとう	tsutau|tsutou
試みる	こころみる	kokoromiru
極める	きわめる|きめる	kiwameru|kimeru
塩焼き	しおやき	shioyaki
連ね	つらね	tsurane
人差し指	ひとさしゆび	hitosashiyubi
焼き上げる	やきあげる	yakiageru
博す	はくす	hakusu
香る	かおる	kaoru
取り残す	とりのこす	torinokosu
目覚める	めざめる	mezameru
覚せい	かくせい	kakusei
飛び立つ	とびたつ	tobitatsu
泣かせる	なかせる	nakaseru
申し付ける	もうしつける	moushitsukeru
台無し	だいなし	dainashi
笑わせる	わらわせる	warawaseru
生まれ変わり	うまれかわり	umarekawari
清める	きよめる	kiyomeru
治める	おさめる	osameru
お札	おさつ|おふだ	osatsu|ofuda
果てしない	はてしない	hateshinai
散らす	ちらす	chirasu
気付け	きつけ|きづけ	kitsuke|kiduke
植え付け	うえつけ	uetsuke
果たせる	はたせる	hataseru
挙がる	あがる	agaru
苦笑い	にがわらい|わらい	nigawarai|warai
成り立ち	なりたち	naritachi
浴びせる	あびせる	abiseru
焼き物	やきもの	yakimono
求む	もとむ|とむ	motomu|tomu
極まりない	きわまりない	kiwamarinai
飛びつく	とびつく	tobitsuku
選りすぐる	えりすぐる|よりすぐる	erisuguru|yorisuguru
梅雨入り	つゆいり	tsuyuiri
清い	きよい	kiyoi
飛び回る	とびまわる	tobimawaru
芽生え	めばえ	mebae
真っ最中	まっさいちゅう	massaityuu
受付ける	うけつける	uketsukeru
固める	かためる|がためる	katameru|gatameru
失せる	うせる	useru
群がる	むらがる	muragaru
うろ覚え	うろおぼえ	urooboe
見栄え	みばえ	mibae
言い伝え	いいつたえ	iitsutae
働かせる	はたらかせる	hatarakaseru
改ざん	かいざん	kaizann
見覚え	みおぼえ	mioboe
散らばる	ちらばる	chirabaru
飛び散る	とびちる	tobichiru
老ける	ふける	fukeru
冷える	ひえる|びえる	hieru|bieru
類する	るいする	ruisuru
平然と	へいぜんと	heizennto
見極める	みきわめる	mikiwameru
折れる	おれる	oreru
根付く	ねつく|ねづく	netsuku|neduku
極み	きわみ	kiwami
静けさ	しずけさ	shizukesa
司る	つかさどる	tsukasadoru
清らか	きよらか	kiyoraka
祝い金	いわいきん	iwaikinn
立て続け	たてつづけ	tatetsuduke
お産	おさん	osann
前置き	まえおき	maeoki
折りたたむ	おりたたむ	oritatamu
置き去り	おきざり|おきさり	okizari|okisari
長続き	ながつづき	nagatsuduki
不向き	ふむき	fumuki
照り	てり|でり	teri|deri
切り札	きりふだ	kirifuda
成り行き	なりゆき	nariyuki
種まき	たねまき	tanemaki
害する	がいする	gaisuru
泣かす	なかす	nakasu
追い求める	おいもとめる	oimotomeru
買い付け	かいつけ	kaitsuke
山積み	やまづみ	yamadumi
借り入れ	かりいれ	kariire
飛び出る	とびでる	tobideru
冷ます	さます	samasu
引き続く	ひきつづく	hikitsuduku
見付け	みつけ	mitsuke
刷り	すり|ずり	suri|zuri
給う	たまう|たもう	tamau|tamou
見積もる	みつもる	mitsumoru
どん底	どんぞこ	donnzoko
左利き	ひだりきき	hidarikiki
連れ出す	つれだす	tsuredasu
お初	おはつ	ohatsu
害す	がいす	gaisu
生き残れる	いきのこれる	ikinokoreru
競い合う	きそいあう|きそいおう	kisoiau|kisoiou
焼ける	やける	yakeru
束ね	たばね|つかね	tabane|tsukane
変わり目	かわりめ	kawarime
漁る	あさる|すなどる	asaru|sunadoru
つ折り	つおり	tsuori
行く末	ゆくすえ	yukusue
信ずる	しんずる	shinnzuru
待ち望む	まちのぞむ	machinozomu
宮参り	みやまいり	miyamairi
末っ子	すえっこ	suekko
束の間	つかのま	tsukanoma
初日の出	はつひので	hatsuhinode
変り	かわり|がわり	kawari|gawari
然し	しかし	shikashi
取り付く	とりつく	toritsuku
仲直り	なかなおり	nakanaori
連れ去る	つれさる	tsuresaru
見せ付ける	みせつける	misetsukeru
辞す	じす	jisu
泣く泣く	なくなく	nakunaku
働きかける	はたらきかける	hatarakikakeru
関す	かんす	kannsu
泣き声	なきごえ	nakigoe
馬鹿馬鹿しい	ばかばかしい	bakabakashii
念入り	ねんいり	nenniri
差し歯	さしば	sashiba
折り合い	おりあい	oriai
愛せる	あいせる	aiseru
別売り	べつうり	betsuuri
取り置く	とりおく	torioku
飛び乗る	とびのる	tobinoru
信ぴょう	しんぴょう	shinnpyou
炭焼き	すみやき	sumiyaki
朝焼け	あさやけ	asayake
飛び入り	とびいり	tobiiri
目玉焼き	めだまやき	medamayaki
愛し合う	あいしあう|あいしおう	aishiau|aishiou
散りばめる	ちりばめる	chiribameru
輪切り	わぎり	wagiri
残り少ない	のこりすくない	nokorisukunai
お仕置き	おしおき	oshioki
結び付ける	むすびつける	musubitsukeru
的外れ	まとはずれ	matohazure
言い残す	いいのこす	iinokosu
灯す	ともす	tomosu
散らかす	ちらかす	chirakasu
省ける	はぶける	habukeru
年老いる	としおいる	toshioiru
愛でる	めでる	mederu
治せる	なおせる	naoseru
競り	せり|ぜり	seri|zeri
積み立て	つみたて	tsumitate
利上げ	りあげ	riage
共働き	ともばたらき	tomobataraki
念じる	ねんじる	nennjiru
積める	つめる	tsumeru
心残り	こころのこり	kokoronokori
思い付く	おもいつく	omoitsuku
勇ましい	いさましい	isamashii
向かい側	むかいがわ	mukaigawa
付け足す	つけたす	tsuketasu
底上げ	そこあげ	sokoage
笑い話	わらいばなし	waraibanashi
焼き魚	やきざかな	yakizakana
案じ	あんじ	annji
付け方	つけかた	tsukekata
受け付ける	うけつける	uketsukeru
不意打ち	ふいうち	fuiuchi
馬鹿げる	ばかげる	bakageru
散らかる	ちらかる	chirakaru
省みる	かえりみる	kaerimiru
口説く	くどく	kudoku
結う	ゆう|むすう	yuu|musuu
空き巣	あきす	akisu
出来栄え	できばえ	dekibae
お孫さん	おまごさん	omagosann
照れくさい	てれくさい	terekusai
極まる	きわまる|きまる	kiwamaru|kimaru
追い付く	おいつく	oitsuku
使い果たす	つかいはたす	tsukaihatasu
ぶっ飛ばす	ぶっとばす	buttobasu
必ずや	かならずや	kanarazuya
折り曲げる	おりまげる	orimageru
相成る	あいなる	ainaru
冷す	ひやす	hiyasu
刷る	する|ずる	suru|zuru
建て直す	たてなおす	tatenaosu
もんじゃ焼き	もんじゃやき	monnjayaki
利食い	りぐい	rigui
冷やかす	ひやかす	hiyakasu
引き付ける	ひきつける	hikitsukeru
差し止め	さしとめ|さしどめ	sashitome|sashidome
様変わり	さまがわり	samagawari
飛び上がる	とびあがる	tobiagaru
冷ややか	ひややか	hiyayaka
仲良い	なかよい	nakayoi
すっ飛ぶ	すっとぶ	suttobu
勇気づける	ゆうきづける	yuukidukeru
残れる	のこれる	nokoreru
巣立つ	すだつ	sudatsu
かつお節	かつおぶし	katsuobushi
結び方	むすびかた	musubikata
目利き	めきき	mekiki
買付け	かいつけ	kaitsuke
口付け	くちづけ	kuchiduke
付きまとう	つきまとう	tsukimatou
量る	はかる	hakaru
静まり返る	しずまりかえる	shizumarikaeru
連ねる	つらねる	tsuraneru
最たる	さいたる	saitaru
積み木	つみき	tsumiki
事欠く	ことかく	kotokaku
焼き付け	やきつけ	yakitsuke
試せる	ためせる	tameseru
書き残す	かきのこす	kakinokosu
道連れ	みちづれ	michidure
関する	かんする	kannsuru
積み重なる	つみかさなる	tsumikasanaru
利下げ	りさげ	risage
成り下がる	なりさがる	narisagaru
整然と	せいぜんと	seizennto
覚え書き	おぼえがき	oboegaki
浅はか	あさはか	asahaka
灯る	ともる	tomoru
売れ残る	うれのこる	urenokoru
泣き虫	なきむし	nakimushi
打ち付ける	うちつける	uchitsukeru
売れ残り	うれのこり	urenokori
勝ち残る	かちのこる	kachinokoru
果す	はたす	hatasu
馬鹿らしい	ばからしい	bakarashii
勇む	いさむ	isamu
夜泣き	よなき	yonaki
祝い事	いわいごと	iwaigoto
産める	うめる	umeru
位置決め	いちぎめ	ichigime
然るべき	しかるべき	shikarubeki
聞き覚え	ききおぼえ	kikioboe
借入れ	かりいれ	kariire
満たせる	みたせる	mitaseru
水浴び	みずあび	mizuabi
香典返し	こうでんがえし	koudenngaeshi
は種	はしゅ	hashu
愛くるしい	あいくるしい	aikurushii
照る	てる	teru
火照る	ほてる	hoteru
人付き合い	ひとづきあい	hitodukiai
折り返す	おりかえす	orikaesu
照れる	てれる	tereru
残り物	のこりもの	nokorimono
冷や	ひや	hiya
色付く	いろづく	iroduku
木の芽	きのめ|このめ	kinome|konome
極めつけ	きわめつけ	kiwametsuke
名残り	なごり	nagori
結び目	むすびめ	musubime
酒好き	さけずき	sakezuki
巣立ち	すだち	sudachi
飛び道具	とびどうぐ	tobidougu
静まる	しずまる	shizumaru
石積み	いしつみ|いしづみ	ishitsumi|ishidumi
作付け	さくづけ|つくりつけ|さくつけ	sakuduke|tsukuritsuke|sakutsuke
焼き付く	やきつく	yakitsuku
位置づける	いちづける	ichidukeru
変わり者	かわりもの	kawarimono
熱っぽい	ねつっぽい	netsuppoi
連なり	つらなり	tsuranari
焼きうどん	やきうどん	yakiudonn
間借り	まがり	magari
果ては	はては	hateha
言い争う	いいあらそう	iiarasou
笑いかける	わらいかける	waraikakeru
改まる	あらたまる	aratamaru
察する	さっする	sassuru
沖合い	おきあい	okiai
物差し	ものさし	monosashi
泣きつく	なきつく	nakitsuku
照りつける	てりつける	teritsukeru
気付かす	きづかす	kidukasu
働き者	はたらきもの	hatarakimono
口説き	くどき	kudoki
物好き	ものずき	monozuki
労う	ねぎらう|ねぎろう	negirau|negirou
飛び起きる	とびおきる	tobiokiru
お人好し	おひとよし	ohitoyoshi
関連づける	かんれんづける	kannrenndukeru
結べる	むすべる	musuberu
折り目	おりめ	orime
香の物	こうのもの	kounomono
手付かず	てつかず	tetsukazu
飛び火	とびひ	tobihi
借り物	かりもの	karimono
しめ縄	しめなわ	shimenawa
果てる	はてる	hateru
差し置く	さしおく	sashioku
付する	ふする	fusuru
風変わり	ふうがわり	fuugawari
成りすます	なりすます	narisumasu
願い出る	ねがいでる	negaideru
近付ける	ちかづける	chikadukeru
物静か	ものしずか	monoshizuka
漁り	いさり|あさり|すなどり	isari|asari|sunadori
指折り	ゆびおり	yubiori
泣きじゃくる	なきじゃくる	nakijakuru
差し引き	さしひき	sashihiki
女好き	おんなずき	onnnazuki
季節外れ	きせつはずれ	kisetsuhazure
取り付き	とりつき	toritsuki
丸焼き	まるやき	maruyaki
消え失せる	きえうせる	kieuseru
成り上がる	なりあがる	nariagaru
泣き顔	なきがお	nakigao
見付かる	みつかる	mitsukaru
働かす	はたらかす	hatarakasu
心無い	こころない	kokoronai
借り手	かりて	karite
野焼き	のやき	noyaki
祝す	しゅくす	shukusu
選び出す	えらびだす	erabidasu
連れ帰る	つれかえる	tsurekaeru
思い付き	おもいつき	omoitsuki
栄える	さかえる|はえる|ばえる	sakaeru|haeru|baeru
ご苦労さん	ごくろうさん	gokurousann
上積み	うわづみ	uwadumi
底なし	そこなし	sokonashi
引続き	ひきつづき	hikitsuduki
積み重ねる	つみかさねる	tsumikasaneru
果して	はたして	hatashite
泣き言	なきごと	nakigoto
ご苦労さま	ごくろうさま	gokurousama
笑い飛ばす	わらいとばす	waraitobasu
早変わり	はやがわり	hayagawari
火付け	ひつけ	hitsuke
最果て	さいはて	saihate
ほくそ笑む	ほくそえむ	hokusoemu
満ち足りる	みちたりる	michitariru
焼き立て	やきたて	yakitate
感極まる	かんきわまる	kannkiwamaru
季節はずれ	きせつはずれ	kisetsuhazure
結び付く	むすびつく	musubitsuku
まき散らす	まきちらす	makichirasu
然るに	しかるに	shikaruni
高笑い	たかわらい	takawarai
売り飛ばす	うりとばす	uritobasu
笑む	えむ	emu
名付け親	なづけおや	nadukeoya
目覚しい	めざましい	mezamashii
地の利	ちのり	chinori
束ねる	たばねる|つかねる	tabaneru|tsukaneru
連れ合い	つれあい	tsureai
近付き	ちかづき	chikaduki
借り上げ	かりあげ	kariage
量り売り	はかりうり	hakariuri
関が原	せきがはら	sekigahara
飛び石	とびいし	tobiishi
借り受ける	かりうける	kariukeru
法る	のっとる	nottoru
不治の病	ふじのやまい	fujinoyamai
静める	しずめる	shizumeru
関の山	せきのやま	sekinoyama
立て札	たてふだ	tatefuda
は虫類	はちゅうるい	hatyuurui
投げ飛ばす	なげとばす	nagetobasu
付き合える	つきあえる	tsukiaeru
折れ曲がる	おれまがる	oremagaru
飛びかかる	とびかかる	tobikakaru
芽生える	めばえる	mebaeru
付け合せ	つけあわせ	tsukeawase
鏡開き	かがみびらき	kagamibiraki
利き手	ききて	kikite
色付け	いろづけ	iroduke
積り	つもり|づもり	tsumori|dumori
心置き	こころおき	kokorooki
買い置き	かいおき	kaioki
競り合い	せりあい|ぜりあい	seriai|zeriai
笑わす	わらわす	warawasu
連れ立つ	つれだつ|つれたつ	tsuredatsu|tsuretatsu
手伝える	てつだえる	tetsudaeru
失す	しっす|うす	shissu|usu
あざ笑う	あざわらう|あざわろう	azawarau|azawarou
積み上げる	つみあげる	tsumiageru
折しも	おりしも	orishimo
初乗り	はつのり	hatsunori
小競り合い	こぜりあい	kozeriai
完ぺき	かんぺき	kannpeki
笑い転げる	わらいころげる	waraikorogeru
飛び地	とびち	tobichi
目覚ましい	めざましい	mezamashii
仲間はずれ	なかまはずれ	nakamahazure
付き物	つきもの	tsukimono
つけ加える	つけくわえる	tsukekuwaeru
無理強い	むりじい|むりつよい	murijii|muritsuyoi
口利き	くちきき	kuchikiki
仲よく	なかよく	nakayoku
別れ話	わかればなし	wakarebanashi
折れ線	おれせん	oresenn
街なか	まちなか	machinaka
病み付き	やみつき	yamitsuki
巣食う	すくう	sukuu
清清しい	すがすがしい	sugasugashii
選る	よる|えらべる|える	yoru|eraberu|eru
戦ふ	たたかふ|たたこふ	tatakafu|tatakofu
考え付く	かんがえつく	kanngaetsuku
案ずる	あんずる	annzuru
つ折	つおり	tsuori
日照り	ひでり	hideri
食い初め	くいぞめ	kuizome
焼け野原	やけのはら	yakenohara
庭付き	にわつき	niwatsuki
泣き笑い	なきわらい	nakiwarai
組み付ける	くみつける	kumitsukeru
ご法度	ごはっと	gohatto
お節	おせち	osechi
静まりかえる	しずまりかえる	shizumarikaeru
浅ましい	あさましい	asamashii
願いごと	ねがいごと	negaigoto
植え付ける	うえつける	uetsukeru
参じる	さんじる	sannjiru
笑いもの	わらいもの	waraimono
付き人	つきびと	tsukibito
共食い	ともぐい	tomogui
お新香	おしんこ	oshinnko
焼入れ	やきいれ	yakiire
老いる	おいる	oiru
もらい泣き	もらいなき	morainaki
群れる	むれる	mureru
取付ける	とりつける	toritsukeru
変わり果てる	かわりはてる	kawarihateru
お家芸	おいえげい	oiegei
輪っか	わっか	wakka
約す	やくす	yakusu
一つ覚え	ひとつおぼえ	hitotsuoboe
下積み	したづみ	shitadumi
差し向ける	さしむける	sashimukeru
へし折る	へしおる	heshioru
種明かし	たねあかし	taneakashi
買い漁る	かいあさる	kaiasaru
書き初め	かきぞめ	kakizome
変じる	へんじる	hennjiru
折り重なる	おりかさなる	orikasanaru
笑い事	わらいごと	waraigoto
訓読み	くんよみ	kunnyomi
お達し	おたっし	otasshi
焼け石	やけいし	yakeishi
横付け	よこづけ	yokoduke
灯ろう	とうろう|ともろう|どうろう	tourou|tomorou|dourou
ひ孫	ひまご	himago
冷え冷え	ひえびえ	hiebie
伝え聞く	つたえきく	tsutaekiku
位置付ける	いちづける	ichidukeru
量り	はかり	hakari
輪投げ	わなげ	wanage
不幸せ	ふしあわせ	fushiawase
植付け	うえつけ	uetsuke
心変わり	こころがわり	kokorogawari
例へば	たとへば	tatoheba
かっ飛ばす	かっとばす	kattobasu
折り合う	おりあう|おりおう	oriau|oriou
飛びこむ	とびこむ	tobikomu
陸続き	りくつづき	rikutsuduki
競り勝つ	せりかつ	serikatsu
水差し	みずさし	mizusashi
肉付き	にくづき|ししつき	nikuduki|shishitsuki
折返し	おりかえし	orikaeshi
照れ笑い	てれわらい	terewarai
満ち欠け	みちかけ	michikake
付け合わせる	つけあわせる	tsukeawaseru
思い残す	おもいのこす	omoinokosu
好き好む	すきこのむ	sukikonomu
続けざま	つづけざま	tsudukezama
松ぼっくり	まつぼっくり	matsubokkuri
浅黒い	あさぐろい	asaguroi
残り香	のこりが|のこりか	nokoriga|nokorika
書き散らす	かきちらす	kakichirasu
手付き	てつき	tetsuki
連れ子	つれこ	tsureko
根差す	ねざす	nezasu
差止め	さしどめ|さしとめ	sashidome|sashitome
巣くう	すくう	sukuu
別ける	わける	wakeru
目付き	めつき	metsuki
花便り	はなだより	hanadayori
競り合う	せりあう|せりおう	seriau|seriou
然しながら	しかしながら	shikashinagara
街かど	まちかど	machikado
高利回り	こうりまわり	kourimawari
消し飛ぶ	けしとぶ	keshitobu
高望み	たかのぞみ	takanozomi
負け戦	まけいくさ	makeikusa
花冷え	はなびえ	hanabie
お礼参り	おれいまいり	oreimairi
案じる	あんじる	annjiru
湯浴み	ゆあみ	yuami
覚ませる	さませる	samaseru
地続き	じつづき	jitsuduki
札入れ	さついれ	satsuire
焼き飯	やきめし	yakimeshi
引っ付く	ひっつく	hittsuku
変わり種	かわりだね	kawaridane
底入れ	そこいれ	sokoire
取り続ける	とりつづける	toritsudukeru
利かす	きかす	kikasu
産す	むす	musu
心地好い	ここちよい	kokochiyoi
付合い	つきあい|づきあい	tsukiai|dukiai
未練がましい	みれんがましい	mirenngamashii
名付ける	なづける	nadukeru
産み落とす	うみおとす	umiotosu
変り種	かわりだね	kawaridane
置いてきぼり	おいてきぼり	oitekibori
底冷え	そこびえ	sokobie
根付け	ねつけ|ねづけ	netsuke|neduke
利する	りする	risuru
冷や冷や	ひやひや	hiyahiya
積み残す	つみのこす	tsuminokosu
結び付き	むすびつき	musubitsuki
置き時計	おきどけい	okidokei
湯冷め	ゆざめ	yuzame
飛び上がり	とびあがり	tobiagari
塩もみ	しおもみ	shiomomi
見初める	みそめる	misomeru
飛び出せる	とびだせる	tobidaseru
候う	そうろう|そうらう	sourou|sourau
成さん	せいさん	seisann
お松	おまつ	omatsu
かくし芸	かくしげい	kakushigei
願わくは	ねがわくは	negawakuha
乗り付ける	のりつける	noritsukeru
唱う	うたう|うとう	utau|utou
さん付け	さんづけ	sannduke
借金取り	しゃっきんとり	shakkinntori
念ずる	ねんずる	nennzuru
末広がり	すえひろがり	suehirogari
焼き付ける	やきつける	yakitsukeru
顔付き	かおつき	kaotsuki
見付ける	みつける	mitsukeru
富める	とめる	tomeru
肉付け	にくづけ	nikuduke
働き手	はたらきて	hatarakite
勇み足	いさみあし	isamiashi
書初め	かきぞめ	kakizome
失ふ	うしなふ|うしのふ	ushinafu|ushinofu
働きがい	はたらきがい	hatarakigai
生き別れ	いきわかれ	ikiwakare
敗ける	まける	makeru
ほほ笑む	ほほえむ	hohoemu
焼付け	やきつけ	yakitsuke
老いぼれる	おいぼれる	oiboreru
争える	あらそえる	arasoeru
重み付け	おもみづけ	omomiduke
こびり付く	こびりつく	kobiritsuku
借り切る	かりきる	karikiru
連れ回す	つれまわす	tsuremawasu
利す	りす	risu
冷やせる	ひやせる	hiyaseru
熱す	ねっす	nessu
手折る	たおる	taoru
産み付ける	うみつける	umitsukeru
円建て	えんだて	enndate
松の内	まつのうち	matsunouchi
付け所	つけどころ	tsukedokoro
塩ゆで	しおゆで	shioyude
覚る	さとる	satoru
位する	くらいする	kuraisuru
ふっ飛ぶ	ふっとぶ	futtobu
下働き	したばたらき	shitabataraki
付け入る	つけいる	tsukeiru
ぶっ続け	ぶっつづけ	buttsuduke
目覚し	めざまし	mezamashi
すすり泣く	すすりなく	susurinaku
照り返す	てりかえす	terikaesu
投げ付ける	なげつける	nagetsukeru
山焼き	やまやき	yamayaki
菜っ葉	なっぱ	nappa
飛びだす	とびだす	tobidasu
飛びまわる	とびまわる	tobimawaru
飛び飛び	とびとび	tobitobi
成れる	なれる	nareru
男泣き	おとこなき	otokonaki
冷や水	ひやみず	hiyamizu
声変わり	こえがわり	koegawari
極楽とんぼ	ごくらくとんぼ	gokurakutonnbo
目付け	めつけ	metsuke
差しかかる	さしかかる	sashikakaru
飛び付く	とびつく	tobitsuku
仲間外れ	なかまはずれ	nakamahazure
料る	りょうる	ryouru
動機付ける	どうきづける	doukidukeru
人好き	ひとずき	hitozuki
別もの	べつもの	betsumono
選り好み	えりごのみ|よりごのみ	erigonomi|yorigonomi
仕置き	しおき	shioki
先付け	さきづけ	sakiduke
送り付ける	おくりつける	okuritsukeru
相変わる	あいかわる	aikawaru
せせら笑う	せせらわらう|せせらわろう	seserawarau|seserawarou
積み荷	つみに	tsumini
浴びせかける	あびせかける	abisekakeru
世話焼き	せわやき	sewayaki
仲よし	なかよし	nakayoshi
泣きわめく	なきわめく	nakiwameku
香しい	かぐわしい	kaguwashii
包める	つつめる|くるめる	tsutsumeru|kurumeru
散り散り	ちりぢり|ちりじり	chiridiri|chirijiri
めん類	めんるい	mennrui
焼きつける	やきつける	yakitsukeru
便せん	びんせん	binnsenn
観音開き	かんのんびらき	kannnonnbiraki
成り代わる	なりかわる	narikawaru
作り笑い	つくりわらい	tsukuriwarai
積み立てる	つみたてる	tsumitateru
求まる	もとまる	motomaru
極まり	きわまり|きまり	kiwamari|kimari
借上げ	かりあげ	kariage
書き付ける	かきつける	kakitsukeru
焼きいも	やきいも	yakiimo
色刷り	いろずり	irozuri
結わえる	ゆわえる	yuwaeru
物覚え	ものおぼえ	monooboe
横好き	よこずき	yokozuki
成れの果て	なれのはて	narenohate
仲立ち	なかだち	nakadachi
節回し	ふしまわし	fushimawashi
養える	やしなえる	yashinaeru
印す	しるす|いんす	shirusu|innsu
借る	かる	karu
積立て	つみたて	tsumitate
置きかえる	おきかえる	okikaeru
的はずれ	まとはずれ	matohazure
寺参り	てらまいり	teramairi
建て前	たてまえ	tatemae
世話好き	せわずき	sewazuki
月の輪	つきのわ	tsukinowa
続き物	つづきもの	tsudukimono
差し出せる	さしだせる	sashidaseru
重量挙げ	じゅうりょうあげ	juuryouage
風前の灯	ふうぜんのともしび	fuuzennnotomoshibi
差し出がましい	さしでがましい	sashidegamashii
置き引き	おきびき	okibiki
つぼ焼き	つぼやき	tsuboyaki
置き物	おきもの	okimono
孫の手	まごのて	magonote
ごま塩	ごましお	gomashio
熱る	ほてる|いきる	hoteru|ikiru
こぼれ種	こぼれだね	koboredane
願い下げ	ねがいさげ	negaisage
関連付ける	かんれんづける	kannrenndukeru
一足飛び	いっそくとび	issokutobi
差引く	さしひく	sashihiku
競る	せる|きそえる|ぜる	seru|kisoeru|zeru
組み付く	くみつく	kumitsuku
高飛び	たかとび	takatobi
失する	しっする|うする	shissuru|usuru
すし飯	すしめし	sushimeshi
焼きもの	やきもの	yakimono
差し金	さしがね	sashigane
積み出す	つみだす	tsumidasu
借り出す	かりだす	karidasu
かば焼き	かばやき	kabayaki
出初め	でぞめ	dezome
冷やか	ひややか	hiyayaka
希う	こいねがう|こいねごう|ねがう|ねごう	koinegau|koinegou|negau|negou
年の功	としのこう	toshinokou
祝える	いわえる	iwaeru
飯ごう	はんごう	hanngou
すすり泣き	すすりなき	susurinaki
結い上げる	ゆいあげる	yuiageru
男好き	おとこずき	otokozuki
さく井	さくせい	sakusei
じん帯	じんたい	jinntai
どら焼	どらやき	dorayaki
産みつける	うみつける	umitsukeru
くぎ付け	くぎづけ	kugiduke
初っぱな	しょっぱな	shoppana
船積み	ふなづみ	funadumi
泣き所	なきどころ	nakidokoro
塩っぱい	しょっぱい	shoppai
底無し	そこなし	sokonashi
巣ごもる	すごもる	sugomoru
焼け死ぬ	やけしぬ	yakeshinu
差せる	させる	saseru
お側	おそば	osoba
建て売り	たてうり	tateuri
積み下ろし	つみおろし	tsumioroshi
給する	きゅうする	kyuusuru
徒に	いたずらに	itazurani
冷や飯	ひやめし	hiyameshi
借り方	かりかた	karikata
置き手紙	おきてがみ	okitegami
あきれ果てる	あきれはてる	akirehateru
切り付ける	きりつける	kiritsukeru
口説き落とす	くどきおとす	kudokiotosu
いけ好かない	いけすかない	ikesukanai
ほほ笑み	ほほえみ	hohoemi
浅まい	あさまい	asamai
差し入れる	さしいれる	sashiireru
取っ付き	とっつき	tottsuki
行き付け	いきつけ|ゆきつけ	ikitsuke|yukitsuke
挙る	あがる|こぞる	agaru|kozoru
折り紙付き	おりがみつき	origamitsuki
かん養	かんよう	kannyou
根無し草	ねなしぐさ	nenashigusa
富くじ	とみくじ	tomikuji
さい帯	さいたい	saitai
力試し	ちからだめし	chikaradameshi
かんきつ類	かんきつるい	kannkitsurui
生まれ変われる	うまれかわれる	umarekawareru
飛び切り	とびきり	tobikiri
焼き場	やきば	yakiba
内輪もめ	うちわもめ	uchiwamome
覚す	さます|ざます	samasu|zamasu
何気無い	なにげない	nanigenai
差入れ	さしいれ	sashiire
焼きもち	やきもち	yakimochi
加さん	かさん	kasann
差出す	さしだす	sashidasu
岡っ引き	おかっぴき	okappiki
付きっきり	つきっきり	tsukikkiri
ひとっ飛び	ひとっとび	hitottobi
上げ底	あげぞこ	agezoko
ぼう然	ぼうぜん	bouzenn
し笑	ししょう	shishou
心付け	こころづけ	kokoroduke
残りもの	のこりもの	nokorimono
辞する	じする	jisuru
説き明かす	ときあかす	tokiakasu
買い付ける	かいつける	kaitsukeru
覚り	さとり	satori
労しい	いたわしい	itawashii
浴する	よくする	yokusuru
むせび泣く	むせびなく	musebinaku
残り火	のこりび	nokoribi
生焼け	なまやけ	namayake
選り分ける	えりわける|よりわける	eriwakeru|yoriwakeru
焼き印	やきいん	yakiinn
湯冷まし	ゆざまし	yuzamashi
前借り	まえがり	maegari
向う側	むこうがわ	mukougawa
飛び下りる	とびおりる	tobioriru
組付ける	くみつける	kumitsukeru
売り付ける	うりつける	uritsukeru
たい積	たいせき	taiseki
果てし	はてし	hateshi
焼け付く	やけつく	yaketsuku
目差す	めざす	mezasu
観ずる	かんずる	kannzuru
祝い酒	いわいざけ	iwaizake
栃の木	とちのき	tochinoki
種もみ	たねもみ	tanemomi
笑い返す	わらいかえす	waraikaesu
位取り	くらいどり	kuraidori
書き置き	かきおき	kakioki
孫引き	まごびき	magobiki
付合う	つきあう|つきおう	tsukiau|tsukiou
産みの親	うみのおや	uminooya
借り主	かりぬし	karinushi
差しのべる	さしのべる	sashinoberu
はじき飛ばす	はじきとばす	hajikitobasu
横っ飛び	よこっとび	yokottobi
願える	ねがえる	negaeru
はえ縄	はえなわ	haenawa
付きもの	つきもの	tsukimono
色変わり	いろがわり	irogawari
景気づけ	けいきづけ	keikiduke
お付	おつき	otsuki
死に別れる	しにわかれる	shiniwakareru
好もしい	このもしい	konomoshii
見積る	みつもる	mitsumoru
借り出し	かりだし	karidashi
不ぞろい	ふぞろい	fuzoroi
差し止める	さしとめる	sashitomeru
月極め	つきぎめ	tsukigime
焼きとり	やきとり	yakitori
利ざや	りざや	rizaya
議す	ぎす	gisu
お冷	おひや	ohiya
説ける	とける	tokeru
口説ける	くどける	kudokeru
借り入れる	かりいれる	kariireru
取って置き	とっておき	totteoki
黒焼き	くろやき	kuroyaki
手付け	てつけ	tetsuke
約する	やくする	yakusuru
別れ道	わかれみち	wakaremichi
差上げる	さしあげる	sashiageru
飛び立てる	とびたてる	tobitateru
たて続け	たてつづけ	tatetsuduke
照り付ける	てりつける	teritsukeru
仲たがい	なかたがい	nakatagai
宿無し	やどなし	yadonashi
改む	あらたむ	aratamu
面差し	おもざし	omozashi
持て成す	もてなす	motenasu
側が	そくが	sokuga
貝焼き	かいやき	kaiyaki
労り	いたわり	itawari
漁り火	いさりび	isaribi
積上げる	つみあげる	tsumiageru
笑い飛ばせる	わらいとばせる	waraitobaseru
売付ける	うりつける	uritsukeru
産気づく	さんけづく	sannkeduku
塩引き	しおびき	shiobiki
飛び魚	とびうお	tobiuo
切り結ぶ	きりむすぶ	kirimusubu
事も無げ	こともなげ	kotomonage
芽出し	めだし	medashi
言い付ける	いいつける	iitsukeru
馬鹿笑い	ばかわらい	bakawarai
書置き	かきおき	kakioki
戦く	おののく	ononoku
子別れ	こわかれ	kowakare
てん菜	てんさい	tennsai
泣き付く	なきつく	nakitsuku
無いものねだり	ないものねだり	naimononedari
果せる	おおせる|はたせる|おうせる	ooseru|hataseru|ouseru
あ然	あぜん	azenn
清ら	きよら	kiyora
焼き切る	やききる	yakikiru
願かけ	がんかけ	gannkake
文無し	もんなし	monnnashi
付け上がる	つけあがる	tsukeagaru
老い先	おいさき	oisaki
前祝い	まえいわい	maeiwai
側仕え	そばづかえ	sobadukae
る説	るせつ	rusetsu
松かさ	まつかさ	matsukasa
つづら折り	つづらおり	tsuduraori
読み札	よみふだ	yomifuda
覚束無い	おぼつかない	obotsukanai
照焼き	てりやき	teriyaki
無い物ねだり	ないものねだり	naimononedari
好きずき	すきずき	sukizuki
当り散らす	あたりちらす	atarichirasu
物別れ	ものわかれ	monowakare
お菜	おさい	osai
物笑い	ものわらい	monowarai
焼け出す	やけだす	yakedasu
成立つ	なりたつ	naritatsu
戦ぐ	そよぐ	soyogu
勝ち戦	かちいくさ	kachiikusa
灯台もと暗し	とうだいもとくらし	toudaimotokurashi
立ち働く	たちはたらく	tachihataraku
選り取り	よりどり|よりとり	yoridori|yoritori
大事無い	だいじない	daijinai
由無い	よしない	yoshinai
成行き	なりゆき	nariyuki
別刷り	べつづり|べつずり	betsuduri|betsuzuri
もの静か	ものしずか	monoshizuka
極め付ける	きめつける	kimetsukeru
うれし泣き	うれしなき	ureshinaki
作り付け	つくりつけ	tsukuritsuke
芽ばえ	めばえ	mebae
聞き付ける	ききつける	kikitsukeru
申し伝える	もうしつたえる	moushitsutaeru
百度参り	ひゃくどまいり	hyakudomairi
散じる	さんじる	sannjiru
刷り上がる	すりあがる	suriagaru
取付き	とりつき	toritsuki
当たり散らす	あたりちらす	atarichirasu
冷えこむ	ひえこむ	hiekomu
やむ無い	やむない	yamunai
差しだす	さしだす	sashidasu
焼き打ち	やきうち	yakiuchi
泣きはらす	なきはらす	nakiharasu
熱苦しい	あつくるしい	atsukurushii
試し切り	ためしぎり	tameshigiri
初める	そめる|ぞめる|はじめる	someru|zomeru|hajimeru
ひとつ覚え	ひとつおぼえ	hitotsuoboe
飛出す	とびだす	tobidasu
形無し	かたなし	katanashi
いわく付き	いわくつき	iwakutsuki
以ての外	もってのほか	mottenohoka
極め付き	きわめつき	kiwametsuki
付きっ切り	つきっきり	tsukikkiri
然して	しかして|さして|しこうして	shikashite|sashite|shikoushite
地固め	じがため	jigatame
なまり節	なまりぶし	namaribushi
変ずる	へんずる	hennzuru
願わしい	ねがわしい	negawashii
初初しい	ういういしい	uiuishii
冷っこい	ひやっこい	hiyakkoi
えり好み	えりごのみ	erigonomi
差しあげる	さしあげる	sashiageru
続き間	つづきあい	tsudukiai
鏡もち	かがみもち	kagamimochi
別れ別れ	わかれわかれ	wakarewakare
験し	ためし|けんし|だめし	tameshi|kennshi|dameshi
口伝え	くちづたえ	kuchidutae
付けどころ	つけどころ	tsukedokoro
差し当たり	さしあたり	sashiatari
残り多い	のこりおおい|のこりおうい	nokoriooi|nokorioui
試そう	しそう|ためそう	shisou|tamesou
はせ参じる	はせさんじる	hasesannjiru
なすり付ける	なすりつける	nasuritsukeru
ばら積み	ばらづみ	baradumi
老いらく	おいらく	oiraku
残多い	のこりおおい|のこりおうい	nokoriooi|nokorioui
せん無い	せんない	sennnai
飛びたつ	とびたつ	tobitatsu
順送り	じゅんおくり	junnokuri
丸焼け	まるやけ	maruyake
浅ぐろい	あさぐろい	asaguroi
借受ける	かりうける	kariukeru
好いたらしい	すいたらしい	suitarashii
差出がましい	さしでがましい	sashidegamashii
散歩みち	さんぽみち	sannpomichi
別して	べっして	besshite
果し合い	はたしあい	hatashiai
付け出し	つけだし	tsukedashi
冷や麦	ひやむぎ	hiyamugi
然ること	さること	sarukoto
結える	ゆわえる	yuwaeru
意味付ける	いみづける	imidukeru
つつが無い	つつがない	tsutsuganai
よんどころ無い	よんどころない	yonndokoronai
種取り	たねとり	tanetori
笑いごと	わらいごと	waraigoto
梅雨晴れ	つゆばれ	tsuyubare
類さん	るいさん	ruisann
見目好い	みめよい	mimeyoi
便無い	びんない	binnnai
清すがしい	すがすがしい	sugasugashii
付せん	ふせん	fusenn
笑い物	わらいもの	waraimono
縄のれん	なわのれん	nawanorenn
競り市	せりいち	seriichi
労労い	ろうろうい	rouroui
こん包	こんぽう	konnpou
さび付く	さびつく	sabitsuku
博する	はくする	hakusuru
すがり付く	すがりつく	sugaritsuku
初もの	はつもの	hatsumono
成りたつ	なりたつ	naritatsu
泣き泣き	なきなき	nakinaki
分別らしい	ふんべつらしい	funnbetsurashii
清けい	さやけい	sayakei
見好い	みよい	miyoi
愛づらい	めづらい	medurai
無くする	なくする	nakusuru
失くなる	なくなる	nakunaru
積重ねる	つみかさねる	tsumikasaneru
焼き塩	やきしお	yakishio
何心無い	なにごころない	nanigokoronai
好き好きい	すきずきい	sukizukii
君付け	くんづけ	kunnduke
本意無い	ほいない	hoinai
好きずきい	すきずきい	sukizukii
飛びこみ	とびこみ	tobikomi
連れる	つれる|づれる	tsureru|dureru
初ういしい	ういういしい	uiuishii
あえ無い	あえない	aenai
覚えず	おぼえず	oboezu
観する	かんする	kannsuru
てん末	てんまつ	tennmatsu
調子付く	ちょうしづく	tyoushiduku
焼け太り	やけぶとり	yakebutori
所帯持ち	しょたいもち	shotaimochi
芽ぶく	めぶく	mebuku
標す	しるす	shirusu
着付ける	きつける	kitsukeru
立て付け	たてつけ	tatetsuke
果たし合い	はたしあい	hatashiai
低める	ひくめる	hikumeru
参ろう	さんろう|まいろう	sannrou|mairou
笑いこける	わらいこける	waraikokeru
言挙げ	ことあげ	kotoage
笑いころげる	わらいころげる	waraikorogeru
梅ぼし	うめぼし	umeboshi
係り結び	かかりむすび	kakarimusubi
付出し	つけだし	tsukedashi
付け加わる	つけくわわる	tsukekuwawaru
輪乗り	わのり	wanori
折り返せる	おりかえせる	orikaeseru
札止め	ふだどめ	fudadome
折り重ねる	おりかさねる	orikasaneru
うす焼き	うすやき	usuyaki
菜っぱ	なっぱ	nappa
底引き	そこびき	sokobiki
言付け	ことづけ|いいつけ	kotoduke|iitsuke
名折れ	なおれ	naore
初参り	はつまいり	hatsumairi
言祝ぐ	ことほぐ	kotohogu
松やに	まつやに	matsuyani
色好み	いろごのみ	irogonomi
旗持ち	はたもち	hatamochi
笑い種	わらいぐさ	waraigusa
菜ばし	さいばし	saibashi
月参り	つきまいり	tsukimairi
加われる	くわわれる	kuwawareru
付け人	つけびと	tsukebito
なつ印	なついん	natsuinn
競べ	くらべ	kurabe
身欠きにしん	みがきにしん	migakinishinn
便る	たよる	tayoru
建売り	たてうり	tateuri
祝ひ	ほがい|いわい	hogai|iwai
卒する	そっする|しゅっする	sossuru|shussuru
働きもの	はたらきもの	hatarakimono
約束ごと	やくそくごと	yakusokugoto
給わる	たまわる	tamawaru
笑いとばす	わらいとばす	waraitobasu
がく然	がくぜん	gakuzenn
差っ引く	さっぴく	sappiku
無げ	なげ	nage
力付ける	ちからづける	chikaradukeru
熱冷まし	ねつさまし	netsusamashi
		