情報	じょうほう	jouhou
表示	ひょうじ	hyouji
対応	たいおう	taiou
画像	がぞう|えぞう	gazou|ezou
内容	ないよう	naiyou
質問	しつもん	shitsumonn
設定	せってい	settei
現在	げんざい	gennzai
物件	ぶっけん	bukkenn
理解	りかい	rikai
可能	かのう	kanou
条件	じょうけん	joukenn
規定	きてい	kitei
興味	きょうみ	kyoumi
評価	ひょうか	hyouka
広告	こうこく	koukoku
判断	はんだん	hanndann
報告	ほうこく	houkoku
責任	せきにん	sekininn
機能	きのう	kinou
実際	じっさい	jissai
実現	じつげん	jitsugenn
対象	たいしょう	taishou
状態	じょうたい	joutai
設置	せっち	secchi
非常	ひじょう	hijou
過去	かこ	kako
運営	うんえい	unnei
転職	てんしょく	tennshoku
編集	へんしゅう	hennshuu
経験	けいけん	keikenn
移動	いどう	idou
原因	げんいん	genninn
保証	ほしょう	hoshou
適用	てきよう	tekiyou
感謝	かんしゃ	kannsha
有効	ゆうこう	yuukou
禁止	きんし	kinnshi
価格	かかく	kakaku
取得	しゅとく|とりえ	shutoku|torie
採用	さいよう	saiyou
表現	ひょうげん	hyougenn
提出	ていしゅつ	teishutsu
女性	じょせい|にょしょう	josei|nyoshou
想像	そうぞう	souzou
帰属	きぞく	kizoku
在庫	ざいこ	zaiko
提案	ていあん	teiann
新築	しんちく	shinnchiku
効果	こうか	kouka
解決	かいけつ	kaiketsu
豊富	ほうふ	houfu
構成	こうせい	kousei
確保	かくほ	kakuho
保護	ほご	hogo
準備	じゅんび	junnbi
個人	こじん	kojinn
修正	しゅうせい	shuusei
導入	どうにゅう	dounyuu
調査	ちょうさ	tyousa
歴史	れきし	rekishi
整備	せいび	seibi
印象	いんしょう	innshou
直接	ちょくせつ	tyokusetsu
指導	しどう	shidou
意識	いしき	ishiki
主張	しゅちょう	shutyou
無効	むこう	mukou
適切	てきせつ	tekisetsu
美容	びよう	biyou
正確	せいかく	seikaku
解説	かいせつ	kaisetsu
出演	しゅつえん	shutsuenn
新規	しんき	shinnki
製造	せいぞう	seizou
許可	きょか	kyoka
保管	ほかん	hokann
設立	せつりつ	setsuritsu
絶対	ぜったい	zettai
複数	ふくすう	fukusuu
増加	ぞうか	zouka
営業	えいぎょう	eigyou
資格	しかく	shikaku
評判	ひょうばん	hyoubann
複製	ふくせい	fukusei
通報	つうほう	tsuuhou
独自	どくじ	dokuji
証明	しょうめい	shoumei
制作	せいさく	seisaku
移転	いてん	itenn
報道	ほうどう	houdou
現状	げんじょう	gennjou
確立	かくりつ	kakuritsu
開設	かいせつ	kaisetsu
明確	めいかく	meikaku
基本	きほん	kihonn
構築	こうちく	kouchiku
技術	ぎじゅつ	gijutsu
損害	そんがい	sonngai
素材	そざい	sozai
建設	けんせつ	kennsetsu
知識	ちしき	chishiki
支持	しじ	shiji
限定	げんてい	genntei
資料	しりょう	shiryou
前提	ぜんてい	zenntei
格安	かくやす	kakuyasu
経過	けいか	keika
事件	じけん	jikenn
判明	はんめい	hannmei
受賞	じゅしょう	jushou
減少	げんしょう	gennshou
記述	きじゅつ	kijutsu
提示	ていじ	teiji
設計	せっけい	sekkei
条例	じょうれい	jourei
防止	ぼうし	boushi
基準	きじゅん	kijunn
出版	しゅっぱん	shuppann
設備	せつび	setsubi
復活	ふっかつ	fukkatsu
反応	はんのう	hannnou
所属	しょぞく	shozoku
総合	そうごう	sougou
刊行	かんこう	kannkou
規則	きそく	kisoku
原則	げんそく	gennsoku
金額	きんがく	kinngaku
職業	しょくぎょう	shokugyou
指示	しじ|さししめせ	shiji|sashishimese
医師	いし|くすし	ishi|kusushi
製品	せいひん	seihinn
接続	せつぞく	setsuzoku
省略	しょうりゃく	shouryaku
政治	せいじ	seiji
容易	ようい|たやす	youi|tayasu
経営	けいえい	keiei
職種	しょくしゅ	shokushu
開示	かいじ	kaiji
公布	こうふ	koufu
回復	かいふく	kaifuku
表情	ひょうじょう	hyoujou
解消	かいしょう	kaishou
事情	じじょう	jijou
結構	けっこう	kekkou
男性	だんせい	dannsei
得意	とくい	tokui
停止	ていし|ちょうじ	teishi|tyouji
合格	ごうかく	goukaku
支配	しはい	shihai
過言	かごん|かげん	kagonn|kagenn
制限	せいげん	seigenn
現実	げんじつ	gennjitsu
配布	はいふ	haifu
識別	しきべつ	shikibetsu
予告	よこく	yokoku
利益	りえき|りやく	rieki|riyaku
確信	かくしん	kakushinn
再現	さいげん	saigenn
類似	るいじ	ruiji
授業	じゅぎょう	jugyou
弁当	べんとう	benntou
支給	しきゅう	shikyuu
無断	むだん	mudann
製作	せいさく	seisaku
個別	こべつ	kobetsu
好評	こうひょう	kouhyou
実績	じっせき	jisseki
通常	つうじょう	tsuujou
確定	かくてい	kakutei
保有	ほゆう	hoyuu
修理	しゅうり|しゅり	shuuri|shuri
快適	かいてき	kaiteki
最適	さいてき	saiteki
演出	えんしゅつ	ennshutsu
移行	いこう	ikou
限界	げんかい	gennkai
政令	せいれい	seirei
解放	かいほう	kaihou
何故	なぜ|なにゆえ	naze|naniyue
組織	そしき	soshiki
速報	そくほう	sokuhou
見解	けんかい	kennkai
事故	じこ	jiko
業務	ぎょうむ	gyoumu
投資	とうし	toushi
定義	ていぎ	teigi
夢中	むちゅう	mutyuu
検出	けんしゅつ	kennshutsu
査定	さてい	satei
講演	こうえん	kouenn
通過	つうか|とおりすぎ	tsuuka|toorisugi
再生	さいせい	saisei
確実	かくじつ	kakujitsu
文句	もんく	monnku
布団	ふとん|ぶとん	futonn|butonn
再度	さいど	saido
軽減	けいげん	keigenn
再開	さいかい	saikai
規約	きやく	kiyaku
職員	しょくいん	shokuinn
費用	ひよう	hiyou
程度	ていど	teido
出現	しゅつげん	shutsugenn
制定	せいてい	seitei
予測	よそく	yosoku
余談	よだん	yodann
準用	じゅんよう	junnyou
適当	てきとう	tekitou
検査	けんさ	kennsa
測定	そくてい	sokutei
基点	きてん	kitenn
周囲	しゅうい	shuui
講師	こうし|こうじ	koushi|kouji
現地	げんち	gennchi
能力	のうりょく	nouryoku
加減	かげん	kagenn
保険	ほけん	hokenn
貸家	かしや	kashiya
重複	じゅうふく|ちょうふく	juufuku|tyoufuku
殺害	さつがい|せつがい	satsugai|setsugai
品質	ひんしつ	hinnshitsu
現場	げんじょう|げんば	gennjou|gennba
新刊	しんかん	shinnkann
予防	よぼう	yobou
事務	じむ	jimu
事態	じたい	jitai
統一	とういつ	touitsu
出張	しゅっちょう|でば	shuttyou|deba
正解	せいかい	seikai
保持	ほじ	hoji
大勢	おおぜい|たいせい|たいぜい	oozei|taisei|taizei
芸能	げいのう	geinou
統計	とうけい	toukei
手術	しゅじゅつ	shujutsu
採点	さいてん	saitenn
要素	ようそ	youso
検定	けんてい	kenntei
正常	せいじょう	seijou
経由	けいゆ	keiyu
独立	どくりつ	dokuritsu
任意	にんい	ninni
件数	けんすう	kennsuu
中断	ちゅうだん	tyuudann
付属	ふぞく	fuzoku
復元	ふくげん	fukugenn
検証	けんしょう	kennshou
最寄	もより	moyori
素直	すなお	sunao
新設	しんせつ	shinnsetsu
新型	しんがた	shinngata
適正	てきせい	tekisei
職場	しょくば	shokuba
日刊	にっかん	nikkann
日常	にちじょう	nichijou
建築	けんちく	kennchiku
適合	てきごう	tekigou
余計	よけい	yokei
相性	あいしょう|そうしょう	aishou|soushou
解明	かいめい	kaimei
雑貨	ざっか	zakka
基調	きちょう	kityou
特性	とくせい	tokusei
定評	ていひょう	teihyou
常識	じょうしき	joushiki
団体	だんたい	danntai
現代	げんだい	genndai
可決	かけつ	kaketsu
受講	じゅこう	jukou
招待	しょうたい	shoutai
真似	まね	mane
義務	ぎむ	gimu
前述	ぜんじゅつ	zennjutsu
性格	せいかく	seikaku
実態	じったい	jittai
完備	かんび	kannbi
不快	ふかい	fukai
輸入	ゆにゅう	yunyuu
特設	とくせつ	tokusetsu
日程	にってい	nittei
墓地	ぼち	bochi
任命	にんめい	ninnmei
構造	こうぞう	kouzou
混雑	こんざつ	konnzatsu
賛成	さんせい	sannsei
統合	とうごう	tougou
提起	ていき	teiki
習得	しゅうとく	shuutoku
観測	かんそく	kannsoku
公演	こうえん	kouenn
国際	こくさい	kokusai
職務	しょくむ	shokumu
破損	はそん	hasonn
起因	きいん	kiinn
急増	きゅうぞう	kyuuzou
格好	かっこう|かっこ	kakkou|kakko
眼科	がんか	gannka
複雑	ふくざつ	fukuzatsu
告白	こくはく	kokuhaku
性別	せいべつ	seibetsu
余地	よち	yochi
伝統	でんとう	denntou
答弁	とうべん	toubenn
自殺	じさつ	jisatsu
態度	たいど	taido
仮定	かてい	katei
飼育	しいく	shiiku
制服	せいふく	seifuku
税金	ぜいきん	zeikinn
現金	げんきん	gennkinn
応用	おうよう	ouyou
版元	はんもと	hannmoto
的確	てきかく|てっかく	tekikaku|tekkaku
制度	せいど	seido
総務	そうむ	soumu
点在	てんざい	tennzai
判決	はんけつ	hannketsu
規制	きせい	kisei
修行	しゅぎょう	shugyou
断念	だんねん	dannnenn
提唱	ていしょう	teishou
判定	はんてい	hanntei
意義	いぎ	igi
消費	しょうひ	shouhi
移住	いじゅう	ijuu
絶賛	ぜっさん	zessann
研修	けんしゅう	kennshuu
賛同	さんどう	sanndou
伝授	でんじゅ	dennju
個室	こしつ	koshitsu
政府	せいふ	seifu
寄付	きふ|よせつけ	kifu|yosetsuke
明示	めいじ	meiji
防犯	ぼうはん	bouhann
入居	にゅうきょ	nyuukyo
同居	どうきょ	doukyo
告知	こくち	kokuchi
配属	はいぞく	haizoku
個性	こせい	kosei
強制	きょうせい	kyousei
行政	ぎょうせい	gyousei
留学	りゅうがく	ryuugaku
救急	きゅうきゅう	kyuukyuu
週刊	しゅうかん	shuukann
分解	ぶんかい	bunnkai
職歴	しょくれき	shokureki
要件	ようけん	youkenn
特価	とっか	tokka
性質	せいしつ	seishitsu
再建	さいけん|さいこん	saikenn|saikonn
精通	せいつう	seitsuu
要因	よういん	youinn
増大	ぞうだい	zoudai
永遠	えいえん|とわ	eienn|towa
本質	ほんしつ	honnshitsu
業績	ぎょうせき	gyouseki
効力	こうりょく	kouryoku
油断	ゆだん	yudann
絶大	ぜつだい	zetsudai
標準	ひょうじゅん	hyoujunn
国境	くにざかい|こっきょう	kunizakai|kokkyou
混在	こんざい	konnzai
改造	かいぞう	kaizou
規程	きてい	kitei
居住	きょじゅう	kyojuu
田舎	いなか	inaka
復帰	ふっき	fukki
再会	さいかい	saikai
断言	だんげん	danngenn
故意	こい	koi
証言	しょうげん	shougenn
予報	よほう	yohou
上演	じょうえん	jouenn
実情	じつじょう	jitsujou
講義	こうぎ	kougi
財布	さいふ	saifu
主婦	しゅふ	shufu
高額	こうがく	kougaku
上限	じょうげん	jougenn
選任	せんにん	sennninn
下限	かげん	kagenn
体制	たいせい	taisei
分布	ぶんぷ	bunnpu
損失	そんしつ	sonnshitsu
素人	しろうと	shirouto
解散	かいさん	kaisann
備考	びこう	bikou
謝罪	しゃざい	shazai
断然	だんぜん	dannzenn
成績	せいせき	seiseki
貯金	ちょきん	tyokinn
清潔	せいけつ	seiketsu
暗殺	あんさつ	annsatsu
精神	せいしん	seishinn
前条	ぜんじょう	zennjou
食堂	しょくどう|じきどう	shokudou|jikidou
武器	ぶき	buki
独断	どくだん	dokudann
実在	じつざい	jitsuzai
無限	むげん	mugenn
正義	せいぎ	seigi
才能	さいのう	sainou
実証	じっしょう	jisshou
面接	めんせつ	mennsetsu
不可	ふか	fuka
図版	ずはん	zuhann
不備	ふび	fubi
留意	りゅうい	ryuui
感情	かんじょう	kannjou
自在	じざい	jizai
習慣	しゅうかん	shuukann
多額	たがく	tagaku
得体	えたい	etai
愛情	あいじょう	aijou
大型	おおがた	oogata
有益	ゆうえき	yuueki
圧力	あつりょく	atsuryoku
逆転	ぎゃくてん	gyakutenn
率直	そっちょく	sottyoku
限度	げんど	genndo
広報	こうほう	kouhou
案件	あんけん	annkenn
挙句	あげく	ageku
混同	こんどう	konndou
課税	かぜい	kazei
博士	はかせ|はくし	hakase|hakushi
複写	ふくしゃ	fukusha
切断	せつだん	setsudann
効能	こうのう	kounou
芸術	げいじゅつ	geijutsu
独特	どくとく	dokutoku
低迷	ていめい	teimei
出資	しゅっし	shusshi
可愛	かわい	kawai
接近	せっきん	sekkinn
解体	かいたい	kaitai
物質	ぶっしつ	busshitsu
神経	しんけい	shinnkei
犯罪	はんざい	hannzai
資金	しきん	shikinn
開講	かいこう	kaikou
集団	しゅうだん	shuudann
保全	ほぜん	hozenn
停車	ていしゃ	teisha
総会	そうかい	soukai
採取	さいしゅ	saishu
財産	ざいさん	zaisann
現象	げんしょう	gennshou
輸出	ゆしゅつ	yushutsu
提言	ていげん	teigenn
編成	へんせい	hennsei
情熱	じょうねつ	jounetsu
適応	てきおう	tekiou
配備	はいび	haibi
過失	かしつ	kashitsu
編入	へんにゅう	hennnyuu
増進	ぞうしん	zoushinn
資産	しさん	shisann
迷子	まいご	maigo
意志	いし	ishi
説得	せっとく	settoku
分断	ぶんだん	bunndann
格別	かくべつ	kakubetsu
所在	しょざい	shozai
容量	ようりょう	youryou
境内	けいだい	keidai
風情	ふぜい	fuzei
共演	きょうえん	kyouenn
加圧	かあつ	kaatsu
接客	せっきゃく	sekkyaku
建造	けんぞう	kennzou
移植	いしょく	ishoku
委任	いにん	ininn
原告	げんこく	gennkoku
運勢	うんせい	unnsei
低減	ていげん	teigenn
打破	だは|うちやぶ	daha|uchiyabu
法規	ほうき	houki
墓石	はかいし|ぼせき	hakaishi|boseki
主眼	しゅがん	shugann
混入	こんにゅう	konnnyuu
許容	きょよう	kyoyou
血液	けつえき	ketsueki
現役	げんえき	genneki
往復	おうふく	oufuku
決断	けつだん	ketsudann
教授	きょうじゅ	kyouju
上質	じょうしつ	joushitsu
功績	こうせき	kouseki
評点	ひょうてん	hyoutenn
発刊	はっかん	hakkann
採決	さいけつ	saiketsu
形状	けいじょう	keijou
計測	けいそく	keisoku
作製	さくせい	sakusei
救出	きゅうしゅつ	kyuushutsu
経路	けいろ	keiro
断定	だんてい	danntei
適法	てきほう	tekihou
暗示	あんじ	annji
演技	えんぎ	enngi
書評	しょひょう	shohyou
性能	せいのう	seinou
形態	けいたい	keitai
教師	きょうし	kyoushi
天災	てんさい	tennsai
任期	にんき	ninnki
定率	ていりつ	teiritsu
防災	ぼうさい	bousai
夢見	ゆめみ	yumemi
総額	そうがく	sougaku
本件	ほんけん	honnkenn
移築	いちく	ichiku
雑談	ざつだん|ぞうたん	zatsudann|zoutann
支店	してん	shitenn
賞品	しょうひん	shouhinn
法則	ほうそく	housoku
保守	ほしゅ	hoshu
過程	かてい	katei
告示	こくじ	kokuji
復刊	ふくかん|ふっかん	fukukann|fukkann
標識	ひょうしき	hyoushiki
絶品	ぜっぴん	zeppinn
比例	ひれい|ぴれい	hirei|pirei
主演	しゅえん	shuenn
初版	しょはん	shohann
定額	ていがく|じょうがく	teigaku|jougaku
反逆	はんぎゃく	hanngyaku
支出	ししゅつ	shishutsu
実費	じっぴ	jippi
資本	しほん	shihonn
体質	たいしつ	taishitsu
精進	しょうじん	shoujinn
絶景	ぜっけい	zekkei
災害	さいがい	saigai
支度	したく|じたく	shitaku|jitaku
入賞	にゅうしょう	nyuushou
停電	ていでん	teidenn
仮面	かめん	kamenn
急務	きゅうむ	kyuumu
眼鏡	がんきょう|めがね	gannkyou|megane
容器	ようき	youki
制約	せいやく	seiyaku
留守	るす	rusu
上述	じょうじゅつ	joujutsu
保健	ほけん	hokenn
志望	しぼう	shibou
確約	かくやく	kakuyaku
苦情	くじょう	kujou
同条	どうじょう	doujou
指圧	しあつ	shiatsu
夫婦	ふうふ|めおと|みょうと	fuufu|meoto|myouto
解禁	かいきん	kaikinn
絶望	ぜつぼう	zetsubou
余念	よねん	yonenn
在住	ざいじゅう	zaijuu
倍率	ばいりつ	bairitsu
特許	とっきょ	tokkyo
立証	りっしょう	risshou
燃油	ねんゆ	nennyu
総力	そうりょく	souryoku
幹事	かんじ	kannji
測位	そくい	sokui
責務	せきむ	sekimu
絶版	ぜっぱん	zeppann
朝刊	ちょうかん	tyoukann
半減	はんげん	hanngenn
先制	せんせい	sennsei
戦略	せんりゃく	sennryaku
期限	きげん	kigenn
逆手	ぎゃくて|さかて	gyakute|sakate
交際	こうさい	kousai
人質	ひとじち	hitojichi
平均	へいきん	heikinn
病状	びょうじょう	byoujou
減額	げんがく	genngaku
暴行	ぼうこう	boukou
効率	こうりつ	kouritsu
常備	じょうび	joubi
素顔	すがお	sugao
件名	けんめい	kennmei
犯人	はんにん	hannninn
航空	こうくう	koukuu
業態	ぎょうたい	gyoutai
仏教	ぶっきょう	bukkyou
健在	けんざい	kennzai
修復	しゅうふく	shuufuku
移設	いせつ	isetsu
損保	そんぽ	sonnpo
適度	てきど	tekido
移管	いかん	ikann
地歴	ちれき	chireki
告発	こくはつ	kokuhatsu
判別	はんべつ	hannbetsu
包囲	ほうい	houi
招集	しょうしゅう	shoushuu
通告	つうこく	tsuukoku
倍増	ばいぞう	baizou
歴任	れきにん	rekininn
財務	ざいむ	zaimu
夕刊	ゆうかん	yuukann
月刊	げっかん	gekkann
境界	きょうかい|きょうがい|けいかい	kyoukai|kyougai|keikai
点検	てんけん	tennkenn
余分	よぶん	yobunn
時価	じか	jika
修得	しゅうとく	shuutoku
経年	けいねん	keinenn
絶句	ぜっく	zekku
火災	かさい	kasai
真価	しんか	shinnka
演歌	えんか	ennka
人妻	ひとづま	hitoduma
辞任	じにん	jininn
代弁	だいべん	daibenn
賞賛	しょうさん	shousann
運輸	うんゆ	unnyu
不在	ふざい	fuzai
過度	かど	kado
主導	しゅどう	shudou
絶好	ぜっこう	zekkou
後述	こうじゅつ	koujutsu
解任	かいにん	kaininn
平素	へいそ	heiso
武士	ぶし|もののふ	bushi|mononofu
申告	しんこく	shinnkoku
体現	たいげん	taigenn
所得	しょとく|ところえ	shotoku|tokoroe
防衛	ぼうえい	bouei
経歴	けいれき	keireki
対比	たいひ	taihi
職人	しょくにん	shokuninn
移送	いそう	isou
受領	じゅりょう|ずりょう	juryou|zuryou
保育	ほいく	hoiku
判然	はんぜん	hannzenn
同情	どうじょう	doujou
車検	しゃけん	shakenn
寄生	きせい	kisei
復旧	ふっきゅう	fukkyuu
復興	ふっこう	fukkou
心得	こころえ|こころう	kokoroe|kokorou
営利	えいり	eiri
暴力	ぼうりょく	bouryoku
単独	たんどく	tanndoku
半額	はんがく	hanngaku
比重	ひじゅう	hijuu
横断	おうだん	oudann
予断	よだん	yodann
貸切	かしきり|かしき	kashikiri|kashiki
志向	しこう	shikou
歴然	れきぜん	rekizenn
救助	きゅうじょ	kyuujo
賞味	しょうみ	shoumi
接待	せったい	settai
検挙	けんきょ	kennkyo
応対	おうたい	outai
造成	ぞうせい	zousei
比率	ひりつ	hiritsu
快挙	かいきょ	kaikyo
外構	がいこう	gaikou
領土	りょうど	ryoudo
散在	さんざい	sannzai
官報	かんぽう	kannpou
実務	じつむ	jitsumu
水準	すいじゅん	suijunn
構想	こうそう	kousou
公告	こうこく	koukoku
貧富	ひんぷ	hinnpu
技能	ぎのう	ginou
中略	ちゅうりゃく	tyuuryaku
採集	さいしゅう	saishuu
属性	ぞくせい	zokusei
迷宮	めいきゅう	meikyuu
歴代	れきだい	rekidai
保養	ほよう	hoyou
永久	えいきゅう|とこしえ|とわ|とこしなえ	eikyuu|tokoshie|towa|tokoshinae
名義	めいぎ	meigi
開演	かいえん	kaienn
制止	せいし	seishi
典型	てんけい	tennkei
河川	かせん	kasenn
精度	せいど	seido
初演	しょえん	shoenn
人格	じんかく	jinnkaku
友情	ゆうじょう	yuujou
発現	はつげん	hatsugenn
確率	かくりつ	kakuritsu
圧勝	あっしょう	asshou
信条	しんじょう	shinnjou
相応	そうおう|ふさわし	souou|fusawashi
照準	しょうじゅん	shoujunn
過料	かりょう	karyou
要領	ようりょう	youryou
増量	ぞうりょう	zouryou
図示	ずし	zushi
造営	ぞうえい	zouei
性的	せいてき	seiteki
常温	じょうおん	jouonn
年額	ねんがく	nenngaku
迷路	めいろ	meiro
美術	びじゅつ	bijutsu
公示	こうじ	kouji
散布	さんぷ	sannpu
制圧	せいあつ	seiatsu
気象	きしょう	kishou
講習	こうしゅう	koushuu
原型	げんけい	gennkei
次条	じじょう	jijou
殺人	さつじん	satsujinn
改築	かいちく	kaichiku
禁物	きんもつ	kinnmotsu
良質	りょうしつ	ryoushitsu
気絶	きぜつ	kizetsu
師事	しじ	shiji
協賛	きょうさん	kyousann
混合	こんごう	konngou
改修	かいしゅう	kaishuu
統治	とうち|とうじ	touchi|touji
運航	うんこう	unnkou
確固	かっこ	kakko
酸味	さんみ|すみ	sannmi|sumi
質屋	しちや	shichiya
県境	けんきょう|けんざかい	kennkyou|kennzakai
居城	きょじょう	kyojou
月額	げつがく	getsugaku
鉱物	こうぶつ	koubutsu
演芸	えんげい	enngei
快勝	かいしょう	kaishou
犯行	はんこう	hannkou
燃焼	ねんしょう	nennshou
電報	でんぽう	dennpou
神職	しんしょく	shinnshoku
公務	こうむ	koumu
無罪	むざい	muzai
築年	ちくねん	chikunenn
仏具	ぶつぐ	butsugu
解約	かいやく	kaiyaku
具備	ぐび	gubi
流布	るふ	rufu
根幹	こんかん	konnkann
悪夢	あくむ	akumu
正規	せいき	seiki
勢力	せいりょく	seiryoku
買得	かいどく	kaidoku
総理	そうり	souri
心境	しんきょう	shinnkyou
教示	きょうし|きょうじ	kyoushi|kyouji
増設	ぞうせつ	zousetsu
住基	じゅうき	juuki
暴走	ぼうそう	bousou
留置	とめおき|りゅうち	tomeoki|ryuuchi
製薬	せいやく	seiyaku
近接	きんせつ	kinnsetsu
和解	わかい	wakai
不測	ふそく	fusoku
防水	ぼうすい	bousui
逆行	ぎゃっこう	gyakkou
防音	ぼうおん	bouonn
再発	さいはつ	saihatsu
無職	むしょく|ぶしょく	mushoku|bushoku
競技	きょうぎ	kyougi
興信	こうしん	koushinn
再任	さいにん	saininn
仮説	かせつ	kasetsu
工程	こうてい	koutei
総研	そうけん	soukenn
差額	さがく	sagaku
金賞	きんしょう	kinnshou
貸借	たいしゃく	taishaku
法務	ほうむ	houmu
雑然	ざつぜん	zatsuzenn
冬型	ふゆがた	fuyugata
製法	せいほう	seihou
課程	かてい	katei
検知	けんち	kennchi
悪評	あくひょう	akuhyou
悪質	あくしつ	akushitsu
学費	がくひ	gakuhi
市政	しせい	shisei
在学	ざいがく	zaigaku
感性	かんせい	kannsei
条文	じょうぶん	joubunn
定価	ていか	teika
金属	きんぞく	kinnzoku
判例	はんれい	hannrei
貸出	かしだし	kashidashi
寄進	きしん	kishinn
順序	じゅんじょ	junnjo
有罪	ゆうざい	yuuzai
常連	じょうれん	jourenn
地価	ちか	chika
経費	けいひ	keihi
本格	ほんかく	honnkaku
快晴	かいせい	kaisei
財政	ざいせい	zaisei
居候	いそうろう	isourou
増築	ぞうちく	zouchiku
余程	よほど	yohodo
手際	てぎわ	tegiwa
保留	ほりゅう	horyuu
粉末	ふんまつ	funnmatsu
資質	ししつ	shishitsu
経理	けいり	keiri
人財	じんざい	jinnzai
続編	ぞくへん	zokuhenn
間接	かんせつ	kannsetsu
大賞	たいしょう	taishou
精製	せいせい	seisei
損金	そんきん	sonnkinn
音質	おんしつ	onnshitsu
在職	ざいしょく	zaishoku
築城	ちくじょう	chikujou
先述	せんじゅつ	sennjutsu
任務	にんむ	ninnmu
税率	ぜいりつ	zeiritsu
健保	けんぽ	kennpo
築造	ちくぞう	chikuzou
先導	せんどう	senndou
現行	げんこう	gennkou
型式	かたしき|けいしき	katashiki|keishiki
料率	りょうりつ	ryouritsu
電停	でんてい	denntei
眼下	がんか	gannka
銅像	どうぞう	douzou
修業	しゅうぎょう|しゅぎょう	shuugyou|shugyou
内在	ないざい	naizai
例示	れいじ	reiji
適量	てきりょう	tekiryou
間際	まぎわ	magiwa
安易	あんい	anni
規格	きかく	kikaku
冷製	れいせい	reisei
断固	だんこ	dannko
調製	ちょうせい	tyousei
高価	こうか|たか|だか	kouka|taka|daka
輸送	ゆそう	yusou
本領	ほんりょう	honnryou
加護	かご	kago
増強	ぞうきょう	zoukyou
血圧	けつあつ	ketsuatsu
燃料	ねんりょう	nennryou
役務	えきむ	ekimu
型番	かたばん	katabann
機構	きこう	kikou
血眼	ちまなこ|ちめ	chimanako|chime
着任	ちゃくにん	tyakuninn
破格	はかく	hakaku
造園	ぞうえん	zouenn
精査	せいさ	seisa
技法	ぎほう	gihou
体得	たいとく	taitoku
反故	ほうぐ|ほうご|ほぐ|ほご	hougu|hougo|hogu|hogo
文責	ぶんせき	bunnseki
労務	ろうむ	roumu
同義	どうぎ	dougi
接着	せっちゃく	settyaku
報知	ほうち	houchi
係留	けいりゅう	keiryuu
国営	こくえい	kokuei
貧血	ひんけつ	hinnketsu
均整	きんせい	kinnsei
均等	きんとう	kinntou
再録	さいろく	sairoku
特技	とくぎ	tokugi
築地	ついじ|つきじ	tsuiji|tsukiji
演説	えんぜつ	ennzetsu
条数	じょうすう	jousuu
質素	しっそ	shisso
天職	てんしょく	tennshoku
学歴	がくれき	gakureki
暴言	ぼうげん	bougenn
祖母	そぼ|おば|ばば	sobo|oba|baba
雑費	ざっぴ	zappi
国政	こくせい	kokusei
好演	こうえん	kouenn
広義	こうぎ	kougi
逆説	ぎゃくせつ	gyakusetsu
発布	はっぷ	happu
残留	ざんりゅう	zannryuu
資材	しざい	shizai
紀行	きこう	kikou
本能	ほんのう	honnnou
団長	だんちょう	danntyou
全容	ぜんよう	zennyou
木造	もくぞう	mokuzou
欠損	けっそん	kessonn
上告	じょうこく	joukoku
査読	さどく	sadoku
増減	ぞうげん	zougenn
格差	かくさ	kakusa
構図	こうず	kouzu
祖父	そふ|おおじ|じい|じじ	sofu|ooji|jii|jiji
永住	えいじゅう	eijuu
政界	せいかい	seikai
毛布	もうふ	moufu
基地	きち	kichi
軽快	けいかい	keikai
解答	かいとう	kaitou
快方	かいほう	kaihou
小型	こがた	kogata
果報	かほう	kahou
銀河	ぎんが	ginnga
品性	ひんせい	hinnsei
備品	びひん	bihinn
武力	ぶりょく	buryoku
弁明	べんめい	bennmei
入団	にゅうだん	nyuudann
増額	ぞうがく	zougaku
形容	けいよう	keiyou
常用	じょうよう	jouyou
大志	たいし	taishi
均一	きんいつ	kinnitsu
要職	ようしょく	youshoku
旧型	きゅうがた	kyuugata
再燃	さいねん	sainenn
再興	さいこう	saikou
不評	ふひょう	fuhyou
仏像	ぶつぞう	butsuzou
過信	かしん	kashinn
知財	ちざい	chizai
用件	ようけん	youkenn
支社	ししゃ	shisha
複合	ふくごう	fukugou
別条	べつじょう	betsujou
上程	じょうてい	joutei
禁断	きんだん	kinndann
増水	ぞうすい	zousui
自衛	じえい	jiei
防人	さきもり	sakimori
判示	はんじ	hannji
送検	そうけん	soukenn
花粉	かふん	kafunn
平易	へいい	heii
格言	かくげん	kakugenn
損益	そんえき	sonneki
減量	げんりょう	gennryou
雑記	ざっき	zakki
適職	てきしょく	tekishoku
公職	こうしょく	koushoku
祖国	そこく	sokoku
義理	ぎり	giri
雑感	ざっかん	zakkann
価額	かがく	kagaku
燃費	ねんぴ	nennpi
修整	しゅうせい	shuusei
製本	せいほん	seihonn
航行	こうこう	koukou
得点	とくてん	tokutenn
略歴	りゃくれき	ryakureki
過大	かだい	kadai
護衛	ごえい	goei
仮名	かな|かめい|がな|けみょう	kana|kamei|gana|kemyou
輸血	ゆけつ	yuketsu
夜桜	よざくら	yozakura
非業	ひごう	higou
食費	しょくひ	shokuhi
断行	だんこう	dannkou
個数	こすう	kosuu
短編	たんぺん	tannpenn
保身	ほしん	hoshinn
雑草	ざっそう	zassou
在日	ざいにち	zainichi
同士	どうし	doushi
益金	えききん	ekikinn
編曲	へんきょく	hennkyoku
複眼	ふくがん	fukugann
境地	きょうち	kyouchi
同額	どうがく	dougaku
後編	こうへん	kouhenn
情景	じょうけい	joukei
故人	こじん	kojinn
現物	げんぶつ	gennbutsu
住居	じゅうきょ|ずまい|すまい	juukyo|zumai|sumai
寄席	よせ	yose
実演	じつえん	jitsuenn
兵士	へいし	heishi
増長	ぞうちょう	zoutyou
市制	しせい	shisei
旧法	きゅうほう	kyuuhou
率先	そっせん	sossenn
採算	さいさん	saisann
会務	かいむ	kaimu
好適	こうてき	kouteki
事象	じしょう	jishou
復習	ふくしゅう	fukushuu
常設	じょうせつ	jousetsu
長居	ながい	nagai
転移	てんい	tenni
実益	じつえき	jitsueki
河童	かっぱ	kappa
財団	ざいだん	zaidann
米粉	こめこ|べいふん	komeko|beifunn
観賞	かんしょう	kannshou
墓所	はかしょ|はかどころ|ぼしょ|むしょ	hakasho|hakadokoro|bosho|musho
基因	きいん	kiinn
税別	ぜいべつ	zeibetsu
設営	せつえい	setsuei
画質	がしつ	gashitsu
木製	もくせい	mokusei
全編	ぜんぺん	zennpenn
良識	りょうしき	ryoushiki
打設	だせつ	dasetsu
紙版	かみはん	kamihann
眼前	がんぜん	gannzenn
厚意	こうい	koui
県政	けんせい	kennsei
代謝	たいしゃ	taisha
陽性	ようせい	yousei
不能	ふのう	funou
堂内	どうない	dounai
開基	かいき	kaiki
再選	さいせん	saisenn
酸化	さんか	sannka
条約	じょうやく	jouyaku
元祖	がんそ	gannso
体型	たいけい	taikei
肥料	ひりょう	hiryou
情勢	じょうせい	jousei
本性	ほんしょう|ほんせい	honnshou|honnsei
有志	ゆうし	yuushi
能開	のうかい	noukai
毒殺	どくさつ	dokusatsu
体格	たいかく	taikaku
世紀	せいき	seiki
慣例	かんれい	kannrei
理容	りよう	riyou
義歯	ぎし	gishi
老眼	ろうがん	rougann
薬効	やっこう	yakkou
主義	しゅぎ	shugi
本編	ほんぺん	honnpenn
引率	いんそつ	innsotsu
心情	しんじょう	shinnjou
賛美	さんび	sannbi
公営	こうえい	kouei
属国	ぞっこく	zokkoku
功罪	こうざい	kouzai
人脈	じんみゃく	jinnmyaku
別居	べっきょ	bekkyo
病態	びょうたい	byoutai
前編	ぜんぺん	zennpenn
文脈	ぶんみゃく	bunnmyaku
在留	ざいりゅう	zairyuu
支局	しきょく	shikyoku
衛星	えいせい	eisei
改編	かいへん	kaihenn
本堂	ほんどう	honndou
国益	こくえき	kokueki
過ぎる	すぎる|よぎる	sugiru|yogiru
確か	たしか	tashika
基づく	もとづく	motoduku
限り	かぎり	kagiri
示す	しめす	shimesu
増え	ふえ	fue
比べる	くらべる	kuraberu
可愛い	かわいい|かわい	kawaii|kawai
久しぶり	ひさしぶり	hisashiburi
素晴らしい	すばらしい	subarashii
殺す	ころす|ごろす	korosu|gorosu
過ごす	すごす	sugosu
限る	かぎる	kagiru
豊か	ゆたか	yutaka
常に	つねに	tsuneni
再び	ふたたび	futatabi
応じる	おうじる	oujiru
述べる	のべる	noberu
喜ぶ	よろこぶ	yorokobu
減る	へる|べる|める	heru|beru|meru
任せる	まかせる	makaseru
居る	いる|おる	iru|oru
得る	うる|える	uru|eru
禁じる	きんじる	kinnjiru
寄せ	よせ	yose
寄る	よる	yoru
喜び	よろこび	yorokobi
現れ	あらわれ	araware
慣れる	なれる	nareru
許す	ゆるす	yurusu
勢い	いきおい	ikioi
貸し	かし|がし	kashi|gashi
迷う	まよう	mayou
経つ	たつ	tatsu
判る	わかる	wakaru
囲む	かこむ	kakomu
増やす	ふやす	fuyasu
解る	わかる|ほどける	wakaru|hodokeru
ある程度	あるていど	aruteido
支え	ささえ|かえ|つかえ|つっかえ	sasae|kae|tsukae|tsukkae
防ぐ	ふせぐ	fusegu
張る	はる|ばる|ぱる	haru|baru|paru
設け	もうけ	mouke
備え	そなえ|ぞなえ	sonae|zonae
演じる	えんじる	ennjiru
取り寄せる	とりよせる	toriyoseru
効く	きく	kiku
保つ	たもつ|もつ	tamotsu|motsu
救う	すくう	sukuu
増える	ふえる	fueru
飼う	かう|がう|こう	kau|gau|kou
造り	つくり|づくり	tsukuri|dukuri
引っ張る	ひっぱる	hipparu
混ぜる	まぜる	mazeru
減らす	へらす	herasu
構う	かまう|かもう	kamau|kamou
何故か	なぜか	nazeka
余り	あまり	amari
応え	いらえ|こたえ|ごたえ	irae|kotae|gotae
似合う	にあう|におう	niau|niou
造る	つくる|づくる	tsukuru|dukuru
燃える	もえる	moeru
許し	ゆるし	yurushi
増し	まし|ぞうし	mashi|zoushi
解く	とく|ほどく	toku|hodoku
招く	まねく	maneku
移す	うつす	utsusu
張り	はり|ばり|ぱり	hari|bari|pari
築く	きずく|つく|づく	kizuku|tsuku|duku
立ち寄る	たちよる	tachiyoru
断る	ことわる	kotowaru
易い	やすい|やしい	yasui|yashii
導く	みちびく	michibiku
混む	こむ|ごむ	komu|gomu
務め	つとめ	tsutome
興味深い	きょうみぶかい	kyoumibukai
現れる	あらわれる	arawareru
支える	ささえる|つかえる|つっかえる	sasaeru|tsukaeru|tsukkaeru
仮に	かりに	karini
破る	やぶる|わる|やる	yaburu|waru|yaru
最寄り駅	もよりえき	moyorieki
採る	とる|どる	toru|doru
確かめる	たしかめる	tashikameru
混じる	こんじる|まじる	konnjiru|majiru
適す	てきす	tekisu
構え	かまえ|がまえ	kamae|gamae
移る	うつる	utsuru
謝る	あやまる	ayamaru
お断り	おことわり	okotowari
犯す	おかす	okasu
厚い	あつい|こうい|あちい	atsui|koui|achii
独り言	ひとりごと	hitorigoto
いい加減	いいかげん	iikagenn
見比べる	みくらべる	mikuraberu
年寄り	としより|どしより	toshiyori|doshiyori
在る	ある	aru
属する	ぞくする|しょくする	zokusuru|shokusuru
迷い	まよい	mayoi
お買い得	おかいどく	okaidoku
接す	せっす	sessu
救い	すくい	sukui
飼い主	かいぬし	kainushi
告げ	つげ	tsuge
許せる	ゆるせる	yuruseru
情けない	なさけない	nasakenai
過ごせる	すごせる	sugoseru
暴れ	あばれ	abare
余る	あまる	amaru
率いる	ひきいる	hikiiru
故に	ゆえに	yueni
営む	いとなむ	itonamu
務める	つとめる	tsutomeru
素早い	すばやい	subayai
お過ごし	おすごし	osugoshi
貯める	ためる	tameru
報じる	ほうじる	houjiru
測る	はかる	hakaru
解ける	とける|ほどける|どける	tokeru|hodokeru|dokeru
可愛らしい	かわいらしい	kawairashii
属す	ぞくす	zokusu
招き	まねき	maneki
接する	せっする	sessuru
貧しい	まずしい	mazushii
責め	せめ|ぜめ	seme|zeme
講じる	こうじる	koujiru
織る	おる	oru
留まる	とどまる|とまる|どまる	todomaru|tomaru|domaru
留め	とめ|とどめ|どめ	tome|todome|dome
因みに	ちなみに	chinamini
増す	ます	masu
現に	げんに	gennni
通り過ぎる	とおりすぎる	toorisugiru
貯まる	たまる	tamaru
設ける	もうける	moukeru
燃やす	もやす	moyasu
現す	あらわす	arawasu
厚み	あつみ	atsumi
告げる	つげる	tsugeru
破れ	やぶれ|やれ|われ	yabure|yare|ware
混ざる	まざる	mazaru
貸し出し	かしだし	kashidashi
応える	こたえる	kotaeru
編み	あみ	ami
絶える	たえる	taeru
移り	うつり	utsuri
気の毒	きのどく	kinodoku
損なう	そこなう	sokonau
独り	ひとり	hitori
近寄る	ちかよる	chikayoru
制す	せいす	seisu
費やす	ついやす	tsuiyasu
相応しい	ふさわしい	fusawashii
備える	そなえる	sonaeru
現われる	あらわれる	arawareru
在り方	ありかた	arikata
停める	とめる	tomeru
引き寄せる	ひきよせる	hikiyoseru
逆らう	さからう	sakarau
絶つ	たつ	tatsu
余りに	あまりに	amarini
昼過ぎ	ひるすぎ	hirusugi
際立つ	きわだつ	kiwadatsu
見慣れる	みなれる	minareru
最寄り	もより	moyori
則る	のっとる	nottoru
やむを得ない	やむをえない	yamuwoenai
略す	りゃくす	ryakusu
準じる	じゅんじる	junnjiru
格付け	かくづけ	kakuduke
有り得る	ありえる	arieru
快い	こころよい|いい|よい	kokoroyoi|ii|yoi
寄り道	よりみち	yorimichi
久しい	ひさしい	hisashii
冷え性	ひえしょう	hieshou
墓参り	はかまいり	hakamairi
お許し	おゆるし	oyurushi
眼差し	まなざし	manazashi
絶えず	たえず	taezu
読み解く	よみとく	yomitoku
貸す	かす|がす	kasu|gasu
編む	あむ	amu
寄せる	よせる	yoseru
可笑しい	おかしい	okashii
損ねる	そこねる	sokoneru
護る	まもる	mamoru
分厚い	ぶあつい|ぶあちい	buatsui|buachii
程よい	ほどよい	hodoyoi
張り付く	はりつく	haritsuku
たんぱく質	たんぱくしつ	tannpakushitsu
防げる	ふせげる	fusegeru
構える	かまえる	kamaeru
過ち	あやまち	ayamachi
断り	ことわり	kotowari
得する	とくする	tokusuru
資する	しする	shisuru
似合い	にあい	niai
険しい	けわしい	kewashii
任す	まかす	makasu
心構え	こころがまえ	kokorogamae
張り切る	はりきる	harikiru
営み	いとなみ	itonami
準ずる	じゅんずる	junnzuru
許可ない	きょかない	kyokanai
報う	むくう	mukuu
取り囲む	とりかこむ	torikakomu
取寄せる	とりよせる	toriyoseru
永い	ながい	nagai
志す	こころざす	kokorozasu
授かる	さずかる	sazukaru
義務付け	ぎむづけ	gimuduke
混ぜ合う	まぜあう	mazeau
見張る	みはる	miharu
暴く	あばく	abaku
備わる	そなわる	sonawaru
授ける	さづける|さずける	sadukeru|sazukeru
講ずる	こうずる	kouzuru
夢見る	ゆめみる	yumemiru
ろ過	ろか	roka
責める	せめる	semeru
解す	かいす|ほぐす|ほごす|ほつす|げす	kaisu|hogusu|hogosu|hotsusu|gesu
評す	ひょうす	hyousu
末永い	すえながい	suenagai
災い	わざわい	wazawai
お似合い	おにあい	oniai
義務づける	ぎむづける	gimudukeru
保てる	たもてる	tamoteru
格好いい	かっこういい	kakkouii
言い張る	いいはる	iiharu
総じて	そうじて	soujite
断つ	たつ|だつ	tatsu|datsu
過ぎ去る	すぎさる	sugisaru
断ち切る	たちきる	tachikiru
囲い	かこい|がこい	kakoi|gakoi
見張り	みはり	mihari
差し支える	さしつかえる	sashitsukaeru
潔い	いさぎよい	isagiyoi
それ程	それほど	sorehodo
手応え	てごたえ	tegotae
暴れる	あばれる	abareru
情け	なさけ	nasake
行き過ぎ	いきすぎ|ゆきすぎ	ikisugi|yukisugi
手造り	てづくり	tedukuri
慣らす	ならす	narasu
総て	すべて	subete
程遠い	ほどとおい	hodotooi
損する	そんする	sonnsuru
酸っぱい	すっぱい	suppai
喜ばしい	よろこばしい	yorokobashii
張り紙	はりがみ	harigami
耕す	たがやす	tagayasu
貸し切り	かしきり	kashikiri
導き出す	みちびきだす	michibikidasu
増やせる	ふやせる	fuyaseru
逆さ	さかさ	sakasa
移り変わり	うつりかわり	utsurikawari
囲う	かこう	kakou
無性に	むしょうに	mushouni
言い過ぎ	いいすぎ	iisugi
ご利益	ごりやく	goriyaku
かき混ぜる	かきまぜる	kakimazeru
人殺し	ひとごろし	hitogoroshi
基く	もとづく	motoduku
勢ぞろい	せいぞろい	seizoroi
因る	よる	yoru
印象深い	いんしょうぶかい	innshoubukai
夢みる	ゆめみる	yumemiru
報い	むくい	mukui
解き放つ	ときはなつ	tokihanatsu
効き目	ききめ	kikime
囲み	かこみ	kakomi
期限切れ	きげんぎれ	kigenngire
解き明かす	ときあかす	tokiakasu
見過ごす	みすごす	misugosu
築き上げる	きずきあげる|つきあげる	kizukiageru|tsukiageru
移り住む	うつりすむ	utsurisumu
見応え	みごたえ	migotae
打ち破る	うちやぶる	uchiyaburu
備え付け	そなえつけ	sonaetsuke
断じて	だんじて	dannjite
規則正しい	きそくただしい	kisokutadashii
酒造り	さけづくり	sakedukuri
帰り際	かえりぎわ	kaerigiwa
手厚い	てあつい|てあちい	teatsui|teachii
待ち構える	まちかまえる	machikamaeru
羽織る	はおる	haoru
雪解け	ゆきどけ	yukidoke
縄張り	なわばり	nawabari
殺る	やる|ころせる	yaru|koroseru
興す	おこす	okosu
比す	ひす	hisu
織りなす	おりなす	orinasu
燃え上がる	もえあがる	moeagaru
証す	あかす|しょうす	akasu|shousu
肥える	こえる	koeru
素通り	すどおり	sudoori
確固たる	かっこたる	kakkotaru
余す	あます	amasu
見破る	みやぶる	miyaburu
居合わせる	いあわせる	iawaseru
適う	かなう|かのう	kanau|kanou
やむを得ず	やむをえず	yamuwoezu
挙げ句	あげく	ageku
荷造り	にづくり	nidukuri
歩み寄る	あゆみよる	ayumiyoru
過す	すごす|すぐす	sugosu|sugusu
仕留める	しとめる	shitomeru
採れる	とれる	toreru
制する	せいする	seisuru
不慣れ	ふなれ	funare
持て余す	もてあます	moteamasu
留める	とどめる|とめる|どめる	todomeru|tomeru|domeru
お構い	おかまい	okamai
喜べる	よろこべる	yorokoberu
破たん	はたん	hatann
易しい	やさしい	yasashii
張り出し	はりだし	haridashi
比べ物	くらべもの	kurabemono
張り合う	はりあう|はりおう	hariau|hariou
絶する	ぜっする	zessuru
指し示す	さししめす	sashishimesu
寄り付き	よりつき	yoritsuki
張れる	はれる|ばれる|ぱれる	hareru|bareru|pareru
容れる	いれる	ireru
飼い犬	かいいぬ	kaiinu
絶え間	たえま	taema
証する	しょうする	shousuru
読み応え	よみごたえ	yomigotae
編み物	あみもの	amimono
買い得	かいどく	kaidoku
織り成す	おりなす	orinasu
きな粉	きなこ	kinako
興じる	きょうじる	kyoujiru
厚め	あつめ	atsume
程なく	ほどなく	hodonaku
救える	すくえる	sukueru
張り上げる	はりあげる	hariageru
不確か	ふたしか	futashika
往く	ゆく|いく	yuku|iku
貸出す	かしだす	kashidasu
経る	へる|ふる	heru|furu
夢にも	ゆめにも	yumenimo
得意げ	とくいげ	tokuige
せん断	せんだん	senndann
絶やす	たやす	tayasu
やり過ごす	やりすごす	yarisugosu
建ぺい率	けんぺいりつ	kennpeiritsu
慣れ親しむ	なれしたしむ	nareshitashimu
かわら版	かわらばん	kawarabann
解する	かいする|げする	kaisuru|gesuru
水増し	みずまし	mizumashi
打ち解ける	うちとける	uchitokeru
移ろい	うつろい	utsuroi
容易い	たやすい|たやしい	tayasui|tayashii
似せる	にせる	niseru
出っ張る	でっぱる	depparu
編み出す	あみだす	amidasu
持ち寄る	もちよる	mochiyoru
格上げ	かくあげ	kakuage
解らん	かいらん	kairann
お告げ	おつげ	otsuge
人混み	ひとごみ	hitogomi
逆立ち	さかだち	sakadachi
放し飼い	はなしがい	hanashigai
格下げ	かくさげ	kakusage
似る	にる	niru
わかり易い	わかりやすい	wakariyasui
貸し付け	かしつけ	kashitsuke
殺し合い	ころしあい	koroshiai
立寄る	たちよる	tachiyoru
居残る	いのこる	inokoru
似通う	にかよう	nikayou
移り変わる	うつりかわる	utsurikawaru
築ける	きづける|きずける	kidukeru|kizukeru
逆さま	さかさま	sakasama
素焼き	すやき	suyaki
書き留め	かきとめ|かきとどめ	kakitome|kakitodome
寄せ付ける	よせつける	yosetsukeru
任じる	にんじる	ninnjiru
石造り	いしづくり|いしずくり	ishidukuri|ishizukuri
店構え	みせがまえ	misegamae
波打ち際	なみうちぎわ	namiuchigiwa
断わる	ことわる	kotowaru
適する	てきする	tekisuru
手織り	ており	teori
肥やし	こやし	koyashi
修め	おさめ	osame
救い出す	すくいだす	sukuidasu
手編み	てあみ	teami
殺せる	ころせる|ごろせる	koroseru|goroseru
見限る	みかぎる	mikagiru
圧し	おし|あっし|へし|ぺし	oshi|asshi|heshi|peshi
張り付け	はりつけ	haritsuke
ご都合主義	ごつごうしゅぎ	gotsugoushugi
禁ずる	きんずる	kinnzuru
手招き	てまねき	temaneki
立ち往生	たちおうじょう	tachioujou
告ぐ	つぐ	tsugu
旧い	ふるい|ふりい	furui|furii
減じる	げんじる	gennjiru
手提げ	てさげ	tesage
読み比べる	よみくらべる	yomikuraberu
素っ気	そっけ	sokke
粉じん	ふんじん	funnjinn
身構え	みがまえ	migamae
相容れない	あいいれない	aiirenai
乗り移る	のりうつる	noriutsuru
持ち寄り	もちより	mochiyori
罪深い	つみぶかい	tsumibukai
厚かましい	あつかましい	atsukamashii
見殺し	みごろし	migoroshi
ねつ造	ねつぞう	netsuzou
燃やせる	もやせる	moyaseru
火の粉	ひのこ	hinoko
使い慣れる	つかいなれる	tsukainareru
編さん	へんさん	hennsann
しわ寄せ	しわよせ	shiwayose
演ずる	えんずる	ennzuru
移せる	うつせる	utsuseru
貸し出す	かしだす	kashidasu
破れる	やぶれる|われる	yabureru|wareru
ぶっ殺す	ぶっころす	bukkorosu
質す	ただす	tadasu
生え際	はえぎわ	haegiwa
有り余る	ありあまる	ariamaru
提げる	さげる|ひっさげる	sageru|hissageru
格好よい	かっこうよい	kakkouyoi
解せる	ほぐせる	hoguseru
人任せ	ひとまかせ	hitomakase
際どい	きわどい	kiwadoi
一点張り	いってんばり	ittennbari
解き方	ときかた	tokikata
能書き	のうがき	nougaki
桜えび	さくらえび	sakuraebi
印象づける	いんしょうづける	innshoudukeru
報いる	むくいる	mukuiru
日増しに	ひましに	himashini
精いっぱい	せいいっぱい	seiippai
独りよがり	ひとりよがり	hitoriyogari
救い主	すくいぬし	sukuinushi
金貸し	かねかし	kanekashi
耳寄り	みみより	mimiyori
枝分かれ	えだわかれ	edawakare
似つかわしい	につかわしい	nitsukawashii
送り状	おくりじょう	okurijou
けん制	けんせい	kennsei
応ずる	おうずる	ouzuru
破く	やぶく	yabuku
務まる	つとまる	tsutomaru
住み慣れる	すみなれる	suminareru
比べもの	くらべもの	kurabemono
採り入れる	とりいれる	toriireru
下支え	したざさえ	shitazasae
招き入れる	まねきいれる	manekiireru
造り上げる	つくりあげる	tsukuriageru
破ける	やぶける	yabukeru
歯応え	はごたえ	hagotae
久方ぶり	ひさかたぶり	hisakataburi
寄り付く	よりつく	yoritsuku
貸せる	かせる	kaseru
歩み寄り	あゆみより	ayumiyori
往き	ゆき|いき	yuki|iki
興ざめる	きょうざめる	kyouzameru
目移り	めうつり	meutsuri
出過ぎる	ですぎる	desugiru
気張る	きばる	kibaru
でん粉	でんぷん	dennpunn
取り留める	とりとめる	toritomeru
立ち居	たちい	tachii
義務付ける	ぎむづける	gimudukeru
確たる	かくたる	kakutaru
貸し借り	かしかり	kashikari
力任せ	ちからまかせ	chikaramakase
言い寄る	いいよる	iiyoru
採り上げる	とりあげる	toriageru
際だつ	きわだつ	kiwadatsu
板張り	いたばり	itabari
別れ際	わかれぎわ	wakaregiwa
寄せ書き	よせがき	yosegaki
引張る	ひっぱる	hipparu
打ち寄せる	うちよせる	uchiyoseru
居直る	いなおる	inaoru
か条	かじょう	kajou
織り上げる	おりあげる	oriageru
能無し	のうなし	nounashi
目減り	めべり	meberi
団らん	だんらん	dannrann
則す	そくす	sokusu
真似る	まねる	maneru
造り酒屋	つくりざかや	tsukurizakaya
因む	ちなむ	chinamu
貸切り	かしきり	kashikiri
引き際	ひきぎわ	hikigiwa
確り	しっかり|じっかり	shikkari|jikkari
張り出す	はりだす	haridasu
出張る	でばる	debaru
統べる	すべる	suberu
脈打つ	みゃくうつ	myakuutsu
弁える	わきまえる	wakimaeru
張り切り	はりきり	harikiri
造り出す	つくりだす	tsukuridasu
似つく	につく	nitsuku
ど根性	どこんじょう	dokonnjou
寄りかかる	よりかかる	yorikakaru
在りし	ありし	arishi
血迷う	ちまよう	chimayou
客寄せ	きゃくよせ	kyakuyose
報せ	しらせ	shirase
立ち寄れる	たちよれる	tachiyoreru
引き留める	ひきとめる|ひきとどめる	hikitomeru|hikitodomeru
羽織り	はおり|ばおり	haori|baori
能う	あたう|あとう	atau|atou
編み上げる	あみあげる	amiageru
張りつめる	はりつめる	haritsumeru
絶え絶え	たえだえ	taedae
飼える	かえる	kaeru
型破り	かたやぶり	katayaburi
解きほぐす	ときほぐす	tokihogusu
き損	きそん	kisonn
象る	かたどる	katadoru
暴れまくる	あばれまくる	abaremakuru
殺める	あやめる	ayameru
接ぎ木	つぎき	tsugiki
申し述べる	もうしのべる	moushinoberu
身寄り	みより	miyori
設える	しつらえる	shitsuraeru
寄り合い	よりあい	yoriai
見易い	みやすい	miyasui
出来損ない	できそこない	dekisokonai
毒づく	どくづく	dokuduku
意地っ張り	いじっぱり	ijippari
勢いづく	いきおいづく	ikioiduku
世の常	よのつね	yonotsune
学び舎	まなびや	manabiya
興る	おこる	okoru
復す	ふくす	fukusu
寄り切る	よりきる	yorikiru
見栄っ張り	みえっぱり	mieppari
仮住まい	かりずまい	karizumai
帯留め	おびどめ	obidome
さ迷う	さまよう	samayou
均しい	ひとしい	hitoshii
機織り	はたおり	hataori
歩留まり	ぶどまり	budomari
心許ない	こころもとない	kokoromotonai
過る	よぎる|すがる|すぎる	yogiru|sugaru|sugiru
身の程	みのほど	minohodo
内張り	うちばり|うちはり	uchibari|uchihari
うたい文句	うたいもんく	utaimonnku
序の口	じょのくち	jonokuchi
慣れっこ	なれっこ	narekko
修する	しゅうする	shuusuru
落ち武者	おちむしゃ	ochimusha
引っ張りだこ	ひっぱりだこ	hipparidako
得てして	えてして	eteshite
乗り過ごす	のりすごす	norisugosu
帰り支度	かえりじたく	kaerijitaku
手慣れる	てなれる	tenareru
ぶ厚い	ぶあつい|ぶあちい	buatsui|buachii
たい肥	たいひ	taihi
独り身	ひとりみ	hitorimi
耳慣れる	みみなれる	miminareru
示せる	しめせる	shimeseru
勝ち得る	かちえる	kachieru
半殺し	はんごろし	hanngoroshi
居合い	いあい	iai
貯え	たくわえ	takuwae
すり減る	すりへる	suriheru
生易しい	なまやさしい	namayasashii
身構える	みがまえる	migamaeru
測れる	はかれる	hakareru
責め立てる	せめたてる	semetateru
断固たる	だんこたる	dannkotaru
平謝り	ひらあやまり	hiraayamari
張り手	はりて	harite
居着く	いつく	itsuku
独り立ち	ひとりだち	hitoridachi
評する	ひょうする	hyousuru
枝打ち	えだうち	edauchi
暴れだす	あばれだす	abaredasu
独りぼっち	ひとりぼっち	hitoribocchi
張りつく	はりつく	haritsuku
数寄屋造り	すきやづくり	sukiyadukuri
導ける	みちびける	michibikeru
招へい	しょうへい	shouhei
永らく	ながらく	nagaraku
損じる	そんじる	sonnjiru
おびき寄せる	おびきよせる	obikiyoseru
肥やす	こやす	koyasu
すり寄る	すりよる	suriyoru
慣わし	ならわし	narawashi
右寄り	みぎより	migiyori
死に際	しにぎわ	shinigiwa
救ける	たすける	tasukeru
身の程知らず	みのほどしらず	minohodoshirazu
貸し付ける	かしつける	kashitsukeru
酸い	すい|しい	sui|shii
見過ごせる	みすごせる	misugoseru
死に絶える	しにたえる	shinitaeru
過ぎ行く	すぎゆく	sugiyuku
得がたい	えがたい	egatai
寄れる	よれる	yoreru
寄りつく	よりつく	yoritsuku
すり減らす	すりへらす	suriherasu
接ぎ	はぎ|つぎ	hagi|tsugi
圧す	おす|あっす|へす|ぺす	osu|assu|hesu|pesu
口移し	くちうつし	kuchiutsushi
総立ち	そうだち	soudachi
備に	つぶさに	tsubusani
殺ぐ	そぐ	sogu
長年の夢	ながねんのゆめ	naganennnoyume
肥る	ふとる|ぶとる	futoru|butoru
見損なう	みそこなう	misokonau
逆なで	さかなで	sakanade
面構え	つらがまえ	tsuragamae
取り混ぜる	とりまぜる	torimazeru
気構え	きがまえ	kigamae
やむを得る	やむをえる	yamuwoeru
生殺し	なまごろし	namagoroshi
在す	まします|います	mashimasu|imasu
編める	あめる	ameru
告げ口	つげぐち	tsugeguchi
貸し手	かして	kashite
際す	さいす	saisu
暴れ出す	あばれだす	abaredasu
燃え移る	もえうつる	moeutsuru
燃えさかる	もえさかる	moesakaru
根絶やし	ねだやし	nedayashi
高利貸し	こうりがし|こうりかし	kourigashi|kourikashi
留め置く	とめおく	tomeoku
現代っ子	げんだいっこ	genndaikko
寄付き	よりつき	yoritsuki
気圧される	けおされる	keosareru
思い過ごす	おもいすごす	omoisugosu
殺気立つ	さっきだつ	sakkidatsu
えん罪	えんざい	ennzai
移り気	うつりぎ	utsurigi
角張る	かくばる|かどばる	kakubaru|kadobaru
布く	しく	shiku
喜ばす	よろこばす	yorokobasu
問い質す	といただす	toitadasu
張り子	はりこ	hariko
下の句	しものく	shimonoku
左寄り	ひだりより	hidariyori
土寄せ	つちよせ	tsuchiyose
お祖父さん	おじいさん	ojiisann
字余り	じあまり	jiamari
税引き	ぜいびき	zeibiki
逆立つ	さかだつ	sakadatsu
条は	じょうは	jouha
門構え	もんがまえ|かどがまえ	monngamae|kadogamae
総なめ	そうなめ	souname
修める	おさめる	osameru
造れる	つくれる	tsukureru
書き損じ	かきそんじ	kakisonnji
局留め	きょくどめ	kyokudome
夢うつつ	ゆめうつつ	yumeutsutsu
理解し合う	りかいしあう	rikaishiau
圧する	あっする	assuru
飼い殺し	かいごろし	kaigoroshi
耕うん	こううん	kouunn
にじり寄る	にじりよる	nijiriyoru
寄せつける	よせつける	yosetsukeru
編み目	あみめ	amime
絵解き	えとき	etoki
道場破り	どうじょうやぶり	doujouyaburi
積み増し	つみまし	tsumimashi
価する	あたいする	ataisuru
張り付ける	はりつける	haritsukeru
平織り	ひらおり	hiraori
ひな型	ひながた	hinagata
書き留める	かきとめる|かきとどめる	kakitomeru|kakitodomeru
燃え広がる	もえひろがる	moehirogaru
口寄せ	くちよせ	kuchiyose
素知らぬ	そしらぬ	soshiranu
うどん粉	うどんこ	udonnko
貸し切る	かしきる	kashikiru
導き出せる	みちびきだせる	michibikidaseru
とび職	とびしょく	tobishoku
報ずる	ほうずる	houzuru
毒消し	どくけし|どっけし	dokukeshi|dokkeshi
見果てぬ夢	みはてぬゆめ	mihatenuyume
減ずる	げんずる	gennzuru
断ずる	だんずる	dannzuru
犯せる	おかせる	okaseru
序で	ついで	tsuide
張りつける	はりつける	haritsukeru
情ない	なさけない	nasakenai
独り歩き	ひとりあるき	hitoriaruki
練り製品	ねりせいひん	neriseihinn
示し合わせる	しめしあわせる	shimeshiawaseru
行き過ぎる	いきすぎる|ゆきすぎる	ikisugiru|yukisugiru
燃す	もす|もやす	mosu|moyasu
領する	りょうする	ryousuru
備付ける	そなえつける	sonaetsukeru
心得る	こころえる|こころうる	kokoroeru|kokorouru
綿入れ	わたいれ	wataire
子飼い	こがい	kogai
防じん	ぼうじん	boujinn
焼き増し	やきまし	yakimashi
永らえる	ながらえる	nagaraeru
断れる	ことわれる	kotowareru
寄こす	よこす	yokosu
お祖母さん	おばあさん	obaasann
制は	せいは	seiha
お得意さん	おとくいさん	otokuisann
かみ殺す	かみころす	kamikorosu
移り香	うつりが	utsuriga
燃え立つ	もえたつ	moetatsu
独り者	ひとりもの	hitorimono
ひき殺す	ひきころす	hikikorosu
上の句	かみのく	kaminoku
ふっ素	ふっそ	fusso
厚ぼったい	あつぼったい	atsubottai
殺し文句	ころしもんく	koroshimonnku
費す	ついやす	tsuiyasu
型くずれ	かたくずれ	katakuzure
差支え	さしつかえ	sashitsukae
仮り	かり	kari
歴然と	れきぜんと	rekizennto
ご破算	ごはさん	gohasann
興味しんしん	きょうみしんしん	kyoumishinnshinn
取り得	とりどく|とりえ	toridoku|torie
飼い慣らす	かいならす	kainarasu
罪作り	つみつくり	tsumitsukuri
型付け	かたつけ	katatsuke
余り物	あまりもの	amarimono
造りあげる	つくりあげる	tsukuriageru
張りきる	はりきる	harikiru
製する	せいする	seisuru
車寄せ	くるまよせ	kurumayose
右寄せ	みぎよせ	migiyose
造りだす	つくりだす	tsukuridasu
桜もち	さくらもち	sakuramochi
目張り	めばり	mebari
移れる	うつれる	utsureru
情け深い	なさけぶかい	nasakebukai
接ぐ	つぐ|はぐ	tsugu|hagu
迷わす	まよわす	mayowasu
雑然と	ざつぜんと	zatsuzennto
名寄せ	なよせ	nayose
左寄せ	ひだりよせ	hidariyose
張りぼて	はりぼて	haribote
暴き出す	あばきだす	abakidasu
雪囲い	ゆきがこい	yukigakoi
田舎っぺ	いなかっぺ	inakappe
燃えつく	もえつく	moetsuku
おしどり夫婦	おしどりふうふ	oshidorifuufu
だ液	だえき	daeki
型どる	かたどる	katadoru
過つ	あやまつ|よぎつ	ayamatsu|yogitsu
復する	ふくする	fukusuru
賞する	しょうする	shousuru
引っ張れる	ひっぱれる	hippareru
囲める	かこめる	kakomeru
精しい	くわしい	kuwashii
引っ提げる	ひっさげる	hissageru
比する	ひする	hisuru
逆さまつげ	さかさまつげ	sakasamatsuge
なぶり殺し	なぶりごろし|なぶりころし	naburigoroshi|naburikoroshi
真っ逆さま	まっさかさま	massakasama
断てる	たてる	tateru
費やせる	ついやせる	tsuiyaseru
往ける	ゆける	yukeru
未必の故意	みひつのこい	mihitsunokoi
減す	へす	hesu
お構いなく	おかまいなく	okamainaku
似たりよったり	にたりよったり	nitariyottari
二の句	にのく	ninoku
寄り目	よりめ	yorime
益する	えきする	ekisuru
増せる	ませる|ふやせる	maseru|fuyaseru
質流れ	しちながれ	shichinagare
備えつける	そなえつける	sonaetsukeru
対応付ける	たいおうづける	taioudukeru
かたくり粉	かたくりこ	katakuriko
精出す	せいだす	seidasu
やり過ごせる	やりすごせる	yarisugoseru
買い支え	かいささえ	kaisasae
暴ける	あばける	abakeru
留る	とまる|とどまる|どまる	tomaru|todomaru|domaru
減らず口	へらずぐち	herazuguchi
現せる	あらわせる	arawaseru
思い余る	おもいあまる	omoiamaru
黄な粉	きなこ	kinako
り災	りさい	risai
と殺	とさつ	tosatsu
総ざらい	そうざらい	souzarai
備え付ける	そなえつける	sonaetsukeru
えびす講	えびすこう	ebisukou
編み機	あみき	amiki
定義付ける	ていぎづける	teigidukeru
貸し金	かしきん	kashikinn
はく製	はくせい	hakusei
独りごつ	ひとりごつ	hitorigotsu
賞じゅつ金	しょうじゅつきん	shoujutsukinn
織れる	おれる	oreru
じり貧	じりひん	jirihinn
織りまぜる	おりまぜる	orimazeru
飼い葉	かいば	kaiba
解かす	とかす	tokasu
効きめ	ききめ	kikime
打ち殺す	うちころす	uchikorosu
均す	ならす	narasu
術無い	じつない|じゅつない	jitsunai|jutsunai
太り過ぎ	ふとりすぎ	futorisugi
歩留り	ぶどまり	budomari
型通り	かたどおり	katadoori
独り子	ひとりご	hitorigo
能くする	よくする	yokusuru
判じる	はんじる	hannjiru
順序よく	じゅんじょよく	junnjoyoku
保ち合う	たもちあう	tamochiau
型どおり	かたどおり	katadoori
条件付ける	じょうけんづける	joukenndukeru
所在無い	しょざいない	shozainai
書院造り	しょいんづくり	shoinndukuri
心許無い	こころもとない	kokoromotonai
迷い子	まよいご|まいご	mayoigo|maigo
先祖返り	せんぞがえり	sennzogaeri
耕せる	たがやせる	tagayaseru
ほお張る	ほおばる	hoobaru
態と	わざと	wazato
出任せ	でまかせ	demakase
寄せ場	よせば	yoseba
寄る辺	よるべ	yorube
居住まい	いずまい	izumai
絶てる	たてる	tateru
すり混ぜる	すりまぜる	surimazeru
破れかぶれ	やぶれかぶれ	yaburekabure
情深い	なさけぶかい	nasakebukai
見破れる	みやぶれる	miyabureru
張り合える	はりあえる	hariaeru
行過ぎる	いきすぎる|ゆきすぎる	ikisugiru|yukisugiru
仕損じる	しそんじる	shisonnjiru
総毛立つ	そうけだつ	soukedatsu
世迷い言	よまいごと	yomaigoto
質入れ	しちいれ	shichiire
往き来	ゆきき|いきき	yukiki|ikiki
水張り	みずばり	mizubari
逆らえる	さからえる	sakaraeru
建て増し	たてまし	tatemashi
理解し合える	りかいしあえる	rikaishiaeru
血統書付き	けっとうしょつき	kettoushotsuki
態とらしい	わざとらしい	wazatorashii
解き放す	ときはなす	tokihanasu
略する	りゃくする	ryakusuru
お眼鏡	おめがね	omegane
弁ずる	べんずる	bennzuru
判官びいき	はんがんびいき	hanngannbiiki
毒毒しい	どくどくしい	dokudokushii
解け合う	とけあう|とけおう	tokeau|tokeou
人寄せ	ひとよせ	hitoyose
往ぬ	いぬ	inu
寄り合う	よりあう|よりおう	yoriau|yoriou
罪ぶかい	つみぶかい	tsumibukai
水責め	みずぜめ	mizuzeme
採りあげる	とりあげる	toriageru
逆と	ぎゃくと|げきと	gyakuto|gekito
かさ張る	かさばる	kasabaru
ごね得	ごねどく	gonedoku
毒どくしい	どくどくしい	dokudokushii
夢語り	ゆめがたり	yumegatari
弁じる	べんじる	bennjiru
張出し	はりだし	haridashi
くず粉	くずこ	kuzuko
口減らし	くちべらし	kuchiberashi
貯える	たくわえる	takuwaeru
山留め	やまどめ	yamadome
素ばやい	すばやい	subayai
独り旅	ひとりたび	hitoritabi
素通し	すどおし	sudooshi
提灯持ち	ちょうちんもち	tyouchinnmochi
女殺し	おんなごろし	onnnagoroshi
義理立て	ぎりだて	giridate
態とがましい	わざとがましい	wazatogamashii
報せる	しらせる	shiraseru
似合しい	にあわしい	niawashii
居たたまらない	いたたまらない	itatamaranai
謝する	しゃする	shasuru
授かりもの	さずかりもの	sazukarimono
殺りく	さつりく	satsuriku
鉱さい	こうさい	kousai
こんにゃく粉	こんにゃくこ	konnnyakuko
死に損ない	しにぞこない|しにそこない	shinizokonai|shinisokonai
似気無い	にげない	nigenai
似あわしい	にあわしい	niawashii
興ずる	きょうずる	kyouzuru
救い出せる	すくいだせる	sukuidaseru
現ずる	げんずる	gennzuru
寄せ木	よせぎ	yosegi
貸切る	かしきる	kashikiru
余りもの	あまりもの	amarimono
似かよう	にかよう	nikayou
常世の国	とこよのくに	tokoyonokuni
逆ざや	ぎゃくざや	gyakuzaya
左近の桜	さこんのさくら	sakonnnosakura
こらえ性	こらえしょう	koraeshou
引け際	ひけぎわ	hikegiwa
生き仏	いきぼとけ	ikibotoke
混じりけ	まじりけ	majirike
停る	とまる|どまる	tomaru|domaru
下張り	したばり	shitabari
断ち切れる	たちきれる	tachikireru
燃えつきる	もえつきる	moetsukiru
手解き	てほどき	tehodoki
織りあげる	おりあげる	oriageru
じん性	じんせい	jinnsei
ほう酸	ほうさん	housann
きゅう舎	きゅうしゃ	kyuusha
勢いづける	いきおいづける	ikioidukeru
貸し主	かしぬし	kashinushi
謝れる	あやまれる	ayamareru
張付ける	はりつける	haritsukeru
寄付く	よりつく	yoritsuku
織り目	おりめ	orime
組織立つ	そしきだつ	soshikidatsu
肥し	こやし	koyashi
肥立ち	ひだち	hidachi
護れる	まもれる	mamoreru
季寄せ	きよせ	kiyose
見栄張り	みえっぱり|みえばり	mieppari|miebari
しゃ断	しゃだん	shadann
織りこむ	おりこむ	orikomu