探す	さがす	sagasu
地域	ちいき	chiiki
確認	かくにん	kakuninn
一覧	いちらん	ichirann
子供	こども	kodomo
映画	えいが	eiga
提供	ていきょう	teikyou
頂く	いただく	itadaku
呼ぶ	よぶ	yobu
簡単	かんたん	kanntann
存在	そんざい	sonnzai
欲しい	ほしい	hoshii
住宅	じゅうたく	juutaku
賃貸	ちんたい	chinntai
経済	けいざい	keizai
専門	せんもん	sennmonn
忘れる	わすれる	wasureru
株式会社	かぶしきがいしゃ	kabushikigaisha
対策	たいさく	taisaku
ご覧	ごらん	gorann
届け	とどけ	todoke
担当	たんとう	tanntou
障害	しょうがい	shougai
検討	けんとう	kenntou
展開	てんかい	tennkai
認める	したためる|みとめる	shitatameru|mitomeru
難しい	むずかしい|むつかしい	muzukashii|mutsukashii
処理	しょり	shori
異なる	ことなる	kotonaru
自己	じこ	jiko
降る	くだる|ふる|ぶる|おりる	kudaru|furu|buru|oriru
誕生	たんじょう	tannjou
以降	いこう	ikou
著作	ちょさく	tyosaku
雑誌	ざっし	zasshi
若い	わかい|しい|わかやい	wakai|shii|wakayai
拡大	かくだい	kakudai
困る	こまる	komaru
保存	ほぞん	hozonn
暮らし	くらし|ぐらし	kurashi|gurashi
展示	てんじ	tennji
価値	かち	kachi
映像	えいぞう	eizou
負担	ふたん	futann
優しい	やさしい	yasashii
改善	かいぜん	kaizenn
素敵	すてき	suteki
厳しい	いかめしい|きびしい	ikameshii|kibishii
届く	とどく	todoku
講座	こうざ	kouza
郵便	ゆうびん	yuubinn
危険	きけん	kikenn
専用	せんよう	sennyou
演奏	えんそう	ennsou
政策	せいさく	seisaku
除く	のぞく	nozoku
済む	すむ	sumu
推進	すいしん	suishinn
痛い	いたい	itai
訪問	ほうもん	houmonn
方針	ほうしん	houshinn
看護	かんご	kanngo
認識	にんしき	ninnshiki
優勝	ゆうしょう	yuushou
警察	けいさつ	keisatsu
将来	しょうらい	shourai
訪れる	おとずれる	otozureru
規模	きぼ	kibo
装置	そうち	souchi
批判	ひはん	hihann
自宅	じたく	jitaku
沿う	そう	sou
議論	ぎろん	gironn
就職	しゅうしょく	shuushoku
政権	せいけん	seikenn
発展	はってん	hattenn
お腹	おなか	onaka
捨てる	すてる	suteru
勤務	きんむ	kinnmu
並ぶ	ならぶ	narabu
疑問	ぎもん	gimonn
段階	だんかい	dannkai
激しい	はげしい	hageshii
改革	かいかく	kaikaku
納得	なっとく	nattoku
値段	ねだん	nedann
操作	そうさ	sousa
認定	にんてい	ninntei
異常	いじょう	ijou
痛み	いたみ	itami
至る	いたる	itaru
処分	しょぶん	shobunn
頂ける	いただける	itadakeru
株式	かぶしき	kabushiki
申し訳	もうしわけ	moushiwake
著者	ちょしゃ	tyosha
役割	やくわり	yakuwari
感染	かんせん	kannsenn
権利	けんり	kennri
候補	こうほ	kouho
補助	ほじょ	hojo
収録	しゅうろく	shuuroku
死亡	しぼう	shibou
模様	もよう	moyou
座る	すわる	suwaru
承認	しょうにん	shouninn
秘密	ひみつ	himitsu
容疑	ようぎ	yougi
背景	はいけい	haikei
姿勢	しせい	shisei
否定	ひてい	hitei
証券	しょうけん	shoukenn
巻く	まく	maku
従来	じゅうらい	juurai
優れる	すぐれる	sugureru
手段	しゅだん	shudann
危機	きき	kiki
裁判	さいばん	saibann
視点	してん	shitenn
天皇	てんのう|すめらみこと	tennnou|sumeramikoto
装備	そうび	soubi
困難	こんなん	konnnann
我が家	わがや	wagaya
無視	むし	mushi
優先	ゆうせん	yuusenn
翌日	よくじつ	yokujitsu
看板	かんばん	kannbann
理論	りろん	rironn
収入	しゅうにゅう	shuunyuu
収集	しゅうしゅう	shuushuu
解除	かいじょ	kaijo
展望	てんぼう	tennbou
資源	しげん	shigenn
憲法	けんぽう	kennpou
宣言	せんげん	senngenn
貴方	あなた|きほう	anata|kihou
若者	わかもの	wakamono
閉じる	とじる	tojiru
単純	たんじゅん	tannjunn
階段	かいだん	kaidann
割引	わりびき|わりびけ	waribiki|waribike
通勤	つうきん	tsuukinn
宣伝	せんでん	senndenn
回収	かいしゅう	kaishuu
若干	じゃっかん|そこばく	jakkann|sokobaku
退職	たいしょく	taishoku
背中	せなか	senaka
何処	いずこ|どこ	izuko|doko
帰宅	きたく	kitaku
発揮	はっき	hakki
窓口	まどぐち	madoguchi
保障	ほしょう	hoshou
遺産	いさん	isann
我が	わが	waga
暖かい	あたたかい	atatakai
論文	ろんぶん	ronnbunn
筋肉	きんにく	kinnniku
亡くなる	なくなる	nakunaru
立派	りっぱ	rippa
供給	きょうきゅう	kyoukyuu
沿線	えんせん	ennsenn
反映	はんえい	hannei
並べる	ならべる	naraberu
収納	しゅうのう	shuunou
人権	じんけん	jinnkenn
重視	じゅうし	juushi
領域	りょういき	ryouiki
呼吸	こきゅう	kokyuu
数値	すうち	suuchi
吸収	きゅうしゅう	kyuushuu
時刻	じこく	jikoku
視線	しせん	shisenn
従業	じゅうぎょう	juugyou
内閣	ないかく	naikaku
歌詞	かし	kashi
決済	けっさい	kessai
吸う	すう	suu
結論	けつろん	ketsuronn
盛り上がる	もりあがる	moriagaru
ご存知	ごぞんじ	gozonnji
宅配	たくはい	takuhai
割合	わりあい	wariai
衣装	いしょう	ishou
革命	かくめい	kakumei
女優	じょゆう	joyuu
有難う	ありがとう|ありがたう	arigatou|arigatau
演劇	えんげき	enngeki
難い	かたい|がたい|むずかしい|にくい|にきい	katai|gatai|muzukashii|nikui|nikii
並び	ならび	narabi
株価	かぶか	kabuka
電源	でんげん	denngenn
認証	にんしょう	ninnshou
遺伝子	いでんし	idennshi
口座	こうざ	kouza
温暖	おんだん	onndann
俳優	はいゆう	haiyuu
承る	うけたまわる	uketamawaru
心臓	しんぞう	shinnzou
疑い	うたがい	utagai
対処	たいしょ	taisho
創業	そうぎょう	sougyou
混乱	こんらん	konnrann
洗う	あらう|あろう	arau|arou
指揮	しき	shiki
並びに	ならびに	narabini
興奮	こうふん	koufunn
探せる	さがせる	sagaseru
引退	いんたい|ひきのけ	inntai|hikinoke
認知	にんち	ninnchi
盛る	もる|さかる	moru|sakaru
株主	かぶぬし	kabunushi
裁判所	さいばんしょ|さいばんじょ	saibannsho|saibannjo
厳選	げんせん	gennsenn
分割	ぶんかつ	bunnkatsu
担う	になう|にのう	ninau|ninou
声優	せいゆう	seiyuu
訪ねる	たずねる	tazuneru
臨時	りんじ	rinnji
権力	けんりょく	kennryoku
散策	さんさく	sannsaku
就任	しゅうにん	shuuninn
冷蔵庫	れいぞうこ	reizouko
従う	したがう|したごう	shitagau|shitagou
幼児	ようじ|おさなご	youji|osanago
割れる	われる	wareru
収益	しゅうえき	shuueki
若しくは	もしくは|もしくわ	moshikuha|moshikuwa
家賃	やちん	yachinn
区域	くいき	kuiki
誤解	ごかい	gokai
若手	わかて	wakate
誤り	あやまり	ayamari
拝見	はいけん	haikenn
年収	ねんしゅう	nennshuu
同盟	どうめい	doumei
牛乳	ぎゅうにゅう	gyuunyuu
加盟	かめい	kamei
閉店	へいてん	heitenn
上映	じょうえい	jouei
危ない	あぶない	abunai
除去	じょきょ	jokyo
映る	うつる	utsuru
選手権	せんしゅけん	sennshukenn
一層	いっそう	issou
創る	つくる|づくる	tsukuru|dukuru
将軍	しょうぐん	shougunn
台詞	せりふ|だいし|ぜりふ	serifu|daishi|zerifu
疑う	うたがう|うたごう	utagau|utagou
系統	けいとう	keitou
暮らす	くらす	kurasu
開幕	かいまく	kaimaku
署名	しょめい	shomei
誠に	まことに	makotoni
政党	せいとう	seitou
意欲	いよく	iyoku
砂糖	さとう|ざとう	satou|zatou
郷土	きょうど	kyoudo
私立	しりつ|わたくしりつ	shiritsu|watakushiritsu
装着	そうちゃく	soutyaku
賃金	ちんぎん|ちんきん	chinnginn|chinnkinn
並み	なみ	nami
反射	はんしゃ	hannsha
割り	わり	wari
簡易	かんい	kanni
拡張	かくちょう	kakutyou
補正	ほせい	hosei
深刻	しんこく	shinnkoku
警備	けいび	keibi
届出	とどけいで|とどけで	todokeide|todokede
従事	じゅうじ	juuji
密着	みっちゃく	mittyaku
返済	へんさい	hennsai
出勤	しゅっきん	shukkinn
連盟	れんめい	rennmei
故障	こしょう	koshou
済ませる	すませる	sumaseru
反論	はんろん	hannronn
呼びかける	よびかける	yobikakeru
干す	ほす|ぼす	hosu|bosu
中傷	ちゅうしょう	tyuushou
故郷	こきょう|ふるさと	kokyou|furusato
探る	さぐる|さがせる	saguru|sagaseru
包装	ほうそう	housou
預かる	あずかる	azukaru
幼い	おさない|いとけない	osanai|itokenai
推定	すいてい	suitei
策定	さくてい	sakutei
頭痛	ずつう	zutsuu
諸国	しょこく	shokoku
権限	けんげん	kenngenn
染め	そめ|ぞめ|しめ	some|zome|shime
紅茶	こうちゃ	koutya
片手	かたて	katate
言い訳	いいわけ	iiwake
背後	はいご|うしろ	haigo|ushiro
体操	たいそう	taisou
非難	ひなん	hinann
県警	けんけい	kennkei
背負う	しょう|せおう	shou|seou
勤め	つとめ|づとめ	tsutome|dutome
推移	すいい|おしうつ	suii|oshiutsu
著しい	いちじるしい	ichijirushii
処置	しょち	shochi
承知	しょうち	shouchi
放映	ほうえい	houei
聖書	せいしょ	seisho
収める	おさめる	osameru
評論	ひょうろん	hyouronn
補給	ほきゅう	hokyuu
盛り上がり	もりあがり	moriagari
体系	たいけい	taikei
視野	しや	shiya
服装	ふくそう	fukusou
模型	もけい	mokei
割る	わる|われる	waru|wareru
預金	よきん	yokinn
在宅	ざいたく	zaitaku
派手	はで	hade
食欲	しょくよく	shokuyoku
著書	ちょしょ	tyosho
系列	けいれつ	keiretsu
刻む	きざむ	kizamu
感激	かんげき	kanngeki
盛ん	さかん|もん	sakann|monn
推測	すいそく	suisoku
収容	しゅうよう	shuuyou
有り難い	ありがたい	arigatai
俳句	はいく	haiku
縮小	しゅくしょう	shukushou
注射	ちゅうしゃ	tyuusha
納期	のうき	nouki
供養	くよう	kuyou
蒸す	ふかす|むす	fukasu|musu
買収	ばいしゅう	baishuu
片付け	かたづけ	kataduke
安値	やすね	yasune
武将	ぶしょう	bushou
視察	しさつ	shisatsu
一人暮らし	ひとりぐらし	hitorigurashi
展覧	てんらん	tennrann
郵送	ゆうそう	yuusou
秘書	ひしょ	hisho
広域	こういき	kouiki
警告	けいこく	keikoku
尊重	そんちょう	sonntyou
公認	こうにん	kouninn
視界	しかい	shikai
討論	とうろん	touronn
内装	ないそう	naisou
納豆	なっとう	nattou
盛り上げる	もりあげる	moriageru
補足	ほそく	hosoku
傷つける	きずつける	kizutsukeru
救済	きゅうさい	kyuusai
劇団	げきだん	gekidann
放射線	ほうしゃせん	houshasenn
大衆	たいしゅう|だいしゅ	taishuu|daishu
郵政	ゆうせい	yuusei
視覚	しかく	shikaku
遺族	いぞく	izoku
財源	ざいげん	zaigenn
私的	してき	shiteki
臨む	のぞむ	nozomu
圧縮	あっしゅく	asshuku
創設	そうせつ	sousetsu
収まる	おさまる	osamaru
裏切る	うらぎる	uragiru
座席	ざせき	zaseki
金銭	きんせん	kinnsenn
武装	ぶそう	busou
世論	せろん|よろん|せいろん	seronn|yoronn|seironn
補強	ほきょう	hokyou
総裁	そうさい	sousai
指針	ししん|ゆびばり	shishinn|yubibari
誤る	あやまる	ayamaru
支障	ししょう	shishou
悲劇	ひげき	higeki
就業	しゅうぎょう	shuugyou
取り除く	とりのぞく	torinozoku
公衆	こうしゅう	koushuu
納める	おさめる	osameru
洗い	あらい|すすい	arai|susui
宝石	ほうせき	houseki
発射	はっしゃ	hassha
処方	しょほう	shohou
納税	のうぜい	nouzei
探検	たんけん	tannkenn
担保	たんぽ	tannpo
創立	そうりつ	souritsu
延期	えんき	ennki
納付	のうふ	noufu
認可	にんか	ninnka
従って	したがって	shitagatte
短縮	たんしゅく	tannshuku
共済	きょうさい	kyousai
生存	せいぞん	seizonn
急激	きゅうげき	kyuugeki
出展	しゅってん	shuttenn
伝承	でんしょう	dennshou
実装	じっそう	jissou
座り	すわり|ずわり	suwari|zuwari
裏側	うらがわ	uragawa
日誌	にっし	nisshi
質疑	しつぎ	shitsugi
翌年	よくとし|よくねん	yokutoshi|yokunenn
幕末	ばくまつ	bakumatsu
高値	たかね	takane
閉める	しめる	shimeru
進展	しんてん	shinntenn
運賃	うんちん	unnchinn
神秘	しんぴ	shinnpi
作詞	さくし	sakushi
染まる	そまる	somaru
存続	そんぞく	sonnzoku
貧困	ひんこん	hinnkonn
異動	いどう	idou
専門医	せんもんい	sennmonni
熟成	じゅくせい	jukusei
精密	せいみつ	seimitsu
県庁	けんちょう	kenntyou
降りる	おりる	oriru
苦痛	くつう	kutsuu
乱れ	みだれ|みだれれ	midare|midarere
起源	きげん	kigenn
視力	しりょく	shiryoku
損傷	そんしょう	sonnshou
収支	しゅうし	shuushi
地裁	ちさい	chisai
推理	すいり	suiri
遺体	いたい	itai
警察官	けいさつかん	keisatsukann
担任	たんにん	tannninn
存じ	ぞんじ	zonnji
骨折	こっせつ|ほねお	kossetsu|honeo
改装	かいそう	kaisou
傷つく	きずつく	kizutsuku
全域	ぜんいき	zenniki
通訳	つうやく	tsuuyaku
小規模	しょうきぼ	shoukibo
批評	ひひょう	hihyou
預け	あづけ|あずけ	aduke|azuke
欲望	よくぼう	yokubou
遺伝	いでん	idenn
難易	なんい	nanni
野党	やとう	yatou
密度	みつど	mitsudo
便秘	べんぴ	bennpi
ご存じ	ごぞんじ	gozonnji
警官	けいかん	keikann
補修	ほしゅう	hoshuu
装う	よそう|よそおう	yosou|yosoou
沿岸	えんがん	enngann
寸前	すんぜん	sunnzenn
盛りだくさん	もりだくさん	moridakusann
部署	ぶしょ	busho
著名	ちょめい	tyomei
就く	つく|づく	tsuku|duku
洗面	せんめん	sennmenn
売れ筋	うれすじ	uresuji
負傷	ふしょう	fushou
秘める	ひめる	himeru
異議	いぎ	igi
皇室	こうしつ	koushitsu
内蔵	ないぞう|うちくら	naizou|uchikura
退院	たいいん	taiinn
兄貴	あにき	aniki
裁判官	さいばんかん	saibannkann
警報	けいほう	keihou
臓器	ぞうき	zouki
領収	りょうしゅう	ryoushuu
同窓会	どうそうかい	dousoukai
宅地	たくち	takuchi
遺言	ゆいごん|いげん|いごん	yuigonn|igenn|igonn
賃料	ちんりょう	chinnryou
高層	こうそう	kousou
枚数	まいすう	maisuu
一律	いちりつ	ichiritsu
内臓	ないぞう	naizou
陛下	へいか	heika
名詞	めいし	meishi
難民	なんみん	nannminn
寸法	すんぽう	sunnpou
納入	のうにゅう	nounyuu
放射	ほうしゃ	housha
蒸気	じょうき	jouki
民衆	みんしゅう	minnshuu
除外	じょがい	jogai
暮れ	くれ|ぐれ	kure|gure
異様	いよう	iyou
本尊	ほんぞん	honnzonn
値上げ	ねあげ	neage
貴様	きさま	kisama
流域	りゅういき	ryuuiki
値下げ	ねさげ	nesage
無難	ぶなん	bunann
音源	おんげん	onngenn
納品	のうひん	nouhinn
紅白	こうはく	kouhaku
後退	こうたい	koutai
今晩	こんばん	konnbann
過激	かげき	kageki
皇太子	こうたいし	koutaishi
馬券	ばけん	bakenn
朗読	ろうどく	roudoku
銭湯	せんとう	senntou
首脳	しゅのう	shunou
洗練	せんれん	sennrenn
暖か	あたたか|あったか	atataka|attaka
分担	ぶんたん	bunntann
論じる	ろんじる	ronnjiru
胃腸	いちょう	ityou
我ら	われら	warera
町並み	まちなみ	machinami
忘年会	ぼうねんかい	bounennkai
自律	じりつ	jiritsu
差異	さい	sai
毛穴	けあな	keana
転勤	てんきん	tennkinn
密か	ひそか|みそか	hisoka|misoka
創出	そうしゅつ	soushutsu
呼び出し	よびだし	yobidashi
貯蔵	ちょぞう	tyozou
女将	おかみ|じょしょう	okami|joshou
操る	あやつる	ayatsuru
頂点	ちょうてん	tyoutenn
優位	ゆうい	yuui
垂れ	たれ|しだれ|だれ	tare|shidare|dare
国宝	こくほう	kokuhou
理系	りけい	rikei
変革	へんかく	hennkaku
討つ	うつ	utsu
照射	しょうしゃ	shousha
拡散	かくさん	kakusann
宝くじ	たからくじ	takarakuji
整骨	せいこつ	seikotsu
産卵	さんらん	sannrann
存分	ぞんぶん	zonnbunn
大腸	だいちょう	daityou
階層	かいそう	kaisou
危うい	あやうい	ayaui
呼べる	よべる	yoberu
垂直	すいちょく	suityoku
論議	ろんぎ	ronngi
論争	ろんそう	ronnsou
痛む	いたむ	itamu
染色	せんしょく	sennshoku
翌朝	よくあさ|よくちょう	yokuasa|yokutyou
諸君	しょくん	shokunn
宝物	たからもの|ほうもつ	takaramono|houmotsu
傷害	しょうがい	shougai
立候補	りっこうほ	rikkouho
退治	たいじ	taiji
創刊	そうかん	soukann
欲求	よっきゅう	yokkyuu
補う	おぎなう|おぎのう	oginau|oginou
昨晩	さくばん	sakubann
貴女	きじょ|あなた	kijo|anata
洗顔	せんがん	senngann
主権	しゅけん	shukenn
成熟	せいじゅく	seijuku
幼虫	ようちゅう	youtyuu
磁気	じき	jiki
制裁	せいさい	seisai
観覧	かんらん	kannrann
特異	とくい	tokui
豆乳	とうにゅう	tounyuu
金券	きんけん	kinnkenn
容姿	ようし	youshi
所蔵	しょぞう	shozou
独裁	どくさい	dokusai
優待	ゆうたい	yuutai
洗脳	せんのう	sennnou
操縦	そうじゅう	soujuu
取り巻く	とりまく	torimaku
庁舎	ちょうしゃ	tyousha
異性	いせい	isei
字幕	じまく	jimaku
お宝	おたから	otakara
専念	せんねん	sennnenn
相棒	あいぼう	aibou
吸引	きゅういん	kyuuinn
共存	きょうそん|きょうぞん	kyousonn|kyouzonn
星座	せいざ	seiza
乳がん	にゅうがん	nyuugann
個展	こてん	kotenn
降ろす	おろす	orosu
幼少	ようしょう	youshou
就労	しゅうろう	shuurou
退会	たいかい	taikai
痛感	つうかん	tsuukann
専業	せんぎょう	senngyou
言論	げんろん	gennronn
論点	ろんてん	ronntenn
現存	げんそん|げんぞん	gennsonn|gennzonn
劇的	げきてき	gekiteki
特権	とっけん	tokkenn
情報処理	じょうほうしょり	jouhoushori
値する	あたいする	ataisuru
夕暮れ	ゆうぐれ	yuugure
至り	いたり	itari
奏でる	かなでる	kanaderu
訳す	やくす	yakusu
皇后	こうごう	kougou
映す	うつす	utsusu
閉まる	しまる	shimaru
退場	たいじょう	taijou
日系	にっけい	nikkei
乱暴	らんぼう	rannbou
暮らせる	くらせる	kuraseru
敗退	はいたい	haitai
利権	りけん	rikenn
骨格	こっかく	kokkaku
灰色	はいいろ	haiiro
補完	ほかん	hokann
土砂	どしゃ	dosha
盛大	せいだい	seidai
非常勤	ひじょうきん	hijoukinn
容認	ようにん	youninn
従前	じゅうぜん	juuzenn
裏面	りめん|うらめん	rimenn|uramenn
海域	かいいき	kaiiki
痛める	いためる|やめる	itameru|yameru
断層	だんそう	dannsou
血糖	けっとう	kettou
奏者	そうしゃ	sousha
専務	せんむ	sennmu
電磁	でんじ	dennji
乳幼児	にゅうようじ	nyuuyouji
届け出	とどけで|とどけいで	todokede|todokeide
除ける	のける|のぞける|よける	nokeru|nozokeru|yokeru
供述	きょうじゅつ	kyoujutsu
敬意	けいい	keii
頭脳	ずのう	zunou
開閉	かいへい	kaihei
激減	げきげん	gekigenn
根源	こんげん	konngenn
母乳	ぼにゅう	bonyuu
探訪	たんぼう	tannbou
並行	へいこう	heikou
方策	ほうさく	housaku
専有	せんゆう	sennyuu
源流	げんりゅう	gennryuu
値引き	ねびき	nebiki
延ばす	のばす	nobasu
省庁	しょうちょう	shoutyou
党首	とうしゅ	toushu
片道	かたみち	katamichi
語源	ごげん	gogenn
探査	たんさ	tannsa
段差	だんさ	dannsa
格段	かくだん	kakudann
密接	みっせつ	missetsu
探求	たんきゅう|さがしもとめ	tannkyuu|sagashimotome
収縮	しゅうしゅく	shuushuku
新党	しんとう	shinntou
果樹	かじゅ	kaju
賃借	ちんしゃく|ちんがり	chinnshaku|chinngari
無論	むろん	muronn
辞退	じたい	jitai
誠意	せいい	seii
背筋	せすじ|はいきん	sesuji|haikinn
腹部	ふくぶ	fukubu
自我	じが	jiga
接骨	せっこつ	sekkotsu
来訪	らいほう	raihou
映し出す	うつしだす	utsushidasu
神聖	しんせい	shinnsei
傷み	いたみ	itami
新株	しんかぶ	shinnkabu
内訳	うちわけ	uchiwake
文系	ぶんけい	bunnkei
裏切り	うらぎり	uragiri
延べ	のべ	nobe
蒸し暑い	むしあつい|むしあちい	mushiatsui|mushiachii
夜勤	やきん	yakinn
無敵	むてき	muteki
就学	しゅうがく	shuugaku
機密	きみつ	kimitsu
若年	じゃくねん	jakunenn
晩年	ばんねん	bannnenn
洗車	せんしゃ	sennsha
勤労	きんろう	kinnrou
動詞	どうし	doushi
電磁波	でんじは	dennjiha
熟練	じゅくれん	jukurenn
一段と	いちだんと	ichidannto
家系	かけい	kakei
復刻	ふっこく	fukkoku
一筋	ひとすじ	hitosuji
厳重	げんじゅう	gennjuu
税務署	ぜいむしょ	zeimusho
深層	しんそう	shinnsou
有権者	ゆうけんしゃ	yuukennsha
切除	せつじょ	setsujo
創建	そうけん	soukenn
穀物	こくもつ	kokumotsu
外装	がいそう	gaisou
手洗い	てあらい	tearai
異例	いれい	irei
若返る	わかがえる	wakagaeru
使い捨て	つかいすて	tsukaisute
一刻	いっこく	ikkoku
割り切る	わりきる	warikiru
簡潔	かんけつ	kannketsu
必至	ひっし	hisshi
腹筋	はらすじ|ふっきん	harasuji|fukkinn
分権	ぶんけん	bunnkenn
至福	しふく	shifuku
吸着	きゅうちゃく	kyuutyaku
女装	じょそう	josou
割り当て	わりあて	wariate
敵対	てきたい	tekitai
圧巻	あっかん	akkann
本誌	ほんし	honnshi
見捨てる	みすてる	misuteru
専属	せんぞく	sennzoku
刻み	きざみ	kizami
染み	しみ|じみ|そみ	shimi|jimi|somi
降臨	こうりん	kourinn
有難い	ありがたい	arigatai
担ぐ	かつぐ	katsugu
梅干	うめぼし	umeboshi
反乱	はんらん	hannrann
専任	せんにん	sennninn
毎晩	まいばん	maibann
宝庫	ほうこ	houko
拝む	おがむ	ogamu
鉄鋼	てっこう	tekkou
生誕	せいたん	seitann
済ます	すます	sumasu
筋力	きんりょく	kinnryoku
温泉郷	おんせんきょう	onnsennkyou
防除	ぼうじょ	boujo
片づける	かたづける	katadukeru
直射	ちょくしゃ	tyokusha
満腹	まんぷく	mannpuku
値上がり	ねあがり	neagari
呼び出す	よびだす	yobidasu
外傷	がいしょう	gaishou
車窓	しゃそう	shasou
特派	とくは	tokuha
下降	かこう	kakou
聖なる	せいなる	seinaru
亡き	なき	naki
難関	なんかん	nannkann
亡くす	なくす	nakusu
歌劇	かげき	kageki
授乳	じゅにゅう	junyuu
退く	しりぞく|どく|のく|びく|ひく	shirizoku|doku|noku|biku|hiku
座談	ざだん	zadann
行き届く	いきとどく|ゆきとどく	ikitodoku|yukitodoku
空腹	くうふく	kuufuku
縦走	じゅうそう	juusou
閉ざす	とざす	tozasu
厳格	げんかく	gennkaku
鉄骨	てっこつ	tekkotsu
乳児	にゅうじ	nyuuji
難点	なんてん	nanntenn
蒸留	じょうりゅう	jouryuu
観劇	かんげき	kanngeki
官庁	かんちょう	kanntyou
異国	いこく	ikoku
格納	かくのう	kakunou
磁石	じしゃく	jishaku
別冊	べっさつ	bessatsu
至高	しこう	shikou
閣議	かくぎ	kakugi
賛否	さんぴ	sannpi
切り捨て	きりすて	kirisute
激戦	げきせん	gekisenn
座長	ざちょう	zatyou
仏閣	ぶっかく	bukkaku
宗派	しゅうは	shuuha
熟語	じゅくご	jukugo
否める	いなめる	inameru
干物	ひもの|ほしもの	himono|hoshimono
推す	おす|すいす	osu|suisu
水系	すいけい	suikei
腹痛	はらいた|ふくつう	haraita|fukutsuu
伝染	でんせん	dennsenn
常勤	じょうきん	joukinn
善意	ぜんい	zenni
風潮	ふうちょう	fuutyou
操業	そうぎょう	sougyou
障子	しょうじ	shouji
片側	かたがわ	katagawa
お供	おとも	otomo
降下	こうか	kouka
正論	せいろん	seironn
重傷	じゅうしょう|おもで	juushou|omode
派生	はせい	hasei
断片	だんぺん	dannpenn
脳裏	のうり	nouri
書簡	しょかん	shokann
敬遠	けいえん	keienn
潮流	ちょうりゅう	tyouryuu
宣告	せんこく	sennkoku
同署	どうしょ	dousho
洗い流す	あらいながす	arainagasu
財務諸表	ざいむしょひょう	zaimushohyou
胸元	むなもと	munamoto
可視	かし	kashi
除雪	じょせつ	josetsu
蔵書	ぞうしょ	zousho
砂利	じゃり	jari
大盛り	おおもり	oomori
貴金属	ききんぞく	kikinnzoku
皇族	こうぞく	kouzoku
敬老	けいろう	keirou
全巻	ぜんかん	zennkann
背番号	せばんごう	sebanngou
石段	いしだん	ishidann
上層	じょうそう	jousou
秘伝	ひでん	hidenn
飛び降りる	とびおりる	tobioriru
暮し	くらし|ぐらし	kurashi|gurashi
呼び名	よびな	yobina
異論	いろん	ironn
供する	きょうする	kyousuru
延び	のび	nobi
値打ち	ねうち	neuchi
誤字	ごじ	goji
居宅	きょたく	kyotaku
変異	へんい	henni
敬語	けいご	keigo
盛り合わせ	もりあわせ	moriawase
紅い	あかい	akai
官公庁	かんこうちょう	kannkoutyou
一段落	いちだんらく|ひとだんらく	ichidannraku|hitodannraku
消防署	しょうぼうしょ	shoubousho
異変	いへん	ihenn
異物	いぶつ|こともの	ibutsu|kotomono
届ける	とどける	todokeru
独創	どくそう	dokusou
会派	かいは	kaiha
背面	はいめん	haimenn
担い手	にないて	ninaite
黒糖	こくとう	kokutou
共著	きょうちょ	kyoutyo
忠告	ちゅうこく	tyuukoku
射程	しゃてい	shatei
座標	ざひょう	zahyou
洗える	あらえる	araeru
難病	なんびょう	nannbyou
退社	たいしゃ	taisha
尊厳	そんげん	sonngenn
天皇陛下	てんのうへいか	tennnouheika
生き延びる	いきのびる	ikinobiru
遺構	いこう	ikou
卵巣	らんそう	rannsou
和装	わそう	wasou
尊い	たっとい|とうとい	tattoi|toutoi
遊覧	ゆうらん	yuurann
優勢	ゆうせい	yuusei
可否	かひ	kahi
高裁	こうさい	kousai
刻印	こくいん	kokuinn
勤める	つとめる	tsutomeru
乱入	らんにゅう	rannnyuu
段取り	だんどり	danndori
蒸発	じょうはつ	jouhatsu
割安	わりやす	wariyasu
厳禁	げんきん	gennkinn
完熟	かんじゅく	kannjuku
呼ばわり	よばわり	yobawari
縮む	ちぢむ	chidimu
協奏曲	きょうそうきょく	kyousoukyoku
散乱	さんらん	sannrann
収束	しゅうそく	shuusoku
難解	なんかい	nannkai
裏付け	うらづけ	uraduke
退去	たいきょ	taikyo
王座	おうざ	ouza
模試	もし	moshi
残存	ざんそん|ざんぞん	zannsonn|zannzonn
税収	ぜいしゅう	zeishuu
座布団	ざぶとん	zabutonn
簡素	かんそ	kannso
喜劇	きげき	kigeki
探り	さぐり	saguri
従軍	じゅうぐん	juugunn
一段	いちだん|いったん	ichidann|ittann
暖める	あたためる	atatameru
一寸	いっすん|ちょっと	issunn|tyotto
亡命	ぼうめい	boumei
裏話	うらばなし	urabanashi
閣下	かっか|こうか	kakka|kouka
脳みそ	のうみそ	noumiso
土俵	どひょう	dohyou
鉄筋	てっきん	tekkinn
小銭	こぜに	kozeni
土下座	どげざ	dogeza
降水	こうすい	kousui
納車	のうしゃ	nousha
激化	げきか|げっか	gekika|gekka
沿革	えんかく	ennkaku
閉会	へいかい	heikai
社宅	しゃたく	shataku
除草	じょそう	josou
落とし穴	おとしあな	otoshiana
預言	よげん	yogenn
私服	しふく	shifuku
高専	こうせん	kousenn
干支	えと|かんし	eto|kannshi
代名詞	だいめいし	daimeishi
降格	こうかく	koukaku
火傷	かしょう|やけど	kashou|yakedo
新装	しんそう	shinnsou
裏表	うらおもて	uraomote
裁く	さばく	sabaku
梅干し	うめぼし	umeboshi
貴社	きしゃ	kisha
府警	ふけい	fukei
脳卒中	のうそっちゅう	nousottyuu
至上	しじょう	shijou
連呼	れんこ	rennko
裁量	さいりょう	sairyou
雑穀	ざっこく	zakkoku
討議	とうぎ	tougi
立ち並ぶ	たちならぶ	tachinarabu
党員	とういん	touinn
映り	うつり	utsuri
巻末	かんまつ	kannmatsu
密集	みっしゅう	misshuu
破片	はへん	hahenn
波乱	はらん	harann
段落	だんらく	dannraku
映え	はえ|ばえ	hae|bae
脳神経	のうしんけい	noushinnkei
軽視	けいし	keishi
裏腹	うらはら	urahara
道筋	みちすじ	michisuji
改憲	かいけん	kaikenn
乱す	みだす	midasu
並列	へいれつ	heiretsu
垂らす	たらす	tarasu
縦断	じゅうだん	juudann
所存	しょぞん	shozonn
絶頂	ぜっちょう	zettyou
出納	すいとう	suitou
縮める	ちぢめる	chidimeru
放射能	ほうしゃのう	houshanou
届け先	とどけさき	todokesaki
結納	ゆいのう	yuinou
度胸	どきょう	dokyou
水域	すいいき	suiiki
幼女	ようじょ	youjo
苦難	くなん	kunann
激動	げきどう	gekidou
異色	いしょく	ishoku
秘境	ひきょう	hikyou
洗礼	せんれい	sennrei
遺物	いぶつ	ibutsu
首筋	くびすじ	kubisuji
博覧	はくらん	hakurann
編著	へんちょ	henntyo
宇宙船	うちゅうせん	utyuusenn
巻頭	かんとう	kanntou
映える	はえる|ばえる	haeru|baeru
思う存分	おもうぞんぶん	omouzonnbunn
電脳	でんのう	dennnou
全盛期	ぜんせいき	zennseiki
規律	きりつ	kiritsu
将校	しょうこう	shoukou
至極	しごく	shigoku
重奏	じゅうそう	juusou
遺品	いひん	ihinn
降り注ぐ	ふりそそぐ	furisosogu
欠片	かけら|けっぺん	kakera|keppenn
密教	みっきょう	mikkyou
臨場	りんじょう	rinnjou
遺骨	いこつ	ikotsu
退任	たいにん	taininn
樹立	じゅりつ|こだち	juritsu|kodachi
退散	たいさん	taisann
探し出す	さがしだす	sagashidasu
創始	そうし	soushi
中腹	ちゅうふく|なかはら	tyuufuku|nakahara
終値	おわりね	owarine
射殺	しゃさつ	shasatsu
水洗い	みずあらい	mizuarai
登頂	とうちょう|とちょう	toutyou|totyou
石灰	いしばい|せっかい	ishibai|sekkai
論外	ろんがい	ronngai
老若男女	ろうにゃくなんにょ	rounyakunannnyo
最盛	さいせい	saisei
中退	ちゅうたい	tyuutai
朝晩	あさばん	asabann
胸部	きょうぶ	kyoubu
否認	ひにん	hininn
正座	せいざ	seiza
善い	よい|ぜんい|いい	yoi|zenni|ii
乳製品	にゅうせいひん	nyuuseihinn
極秘	ごくひ	gokuhi
推察	すいさつ	suisatsu
幼なじみ	おさななじみ	osananajimi
肺がん	はいがん	haigann
居座る	いすわる	isuwaru
地層	ちそう	chisou
夕刻	ゆうこく	yuukoku
激痛	げきつう	gekitsuu
熟す	じゅくす|こなす	jukusu|konasu
教皇	きょうこう	kyoukou
恩返し	おんがえし	onngaeshi
磁場	じば|じじょう	jiba|jijou
背骨	せぼね	sebone
至近	しきん	shikinn
署長	しょちょう	shotyou
済まない	すまない	sumanai
傷口	きずぐち	kizuguchi
裏手	うらて	urate
推計	すいけい	suikei
下層	かそう	kasou
警部	けいぶ	keibu
密室	みっしつ	misshitsu
訳者	やくしゃ	yakusha
割く	さく	saku
絵巻	えまき	emaki
割高	わりだか	waridaka
異質	いしつ	ishitsu
傷む	いたむ	itamu
染料	せんりょう	sennryou
窓際	まどぎわ	madogiwa
温存	おんぞん	onnzonn
忘れ物	わすれもの	wasuremono
深呼吸	しんこきゅう	shinnkokyuu
翌月	よくげつ	yokugetsu
恩師	おんし	onnshi
降り出す	ふりだす	furidasu
弁済	べんさい	bennsai
聖母	せいぼ	seibo
疑似	ぎじ	giji
退ける	しりぞける|どける|のける|ひける	shirizokeru|dokeru|nokeru|hikeru
表層	ひょうそう	hyousou
気密	きみつ	kimitsu
拝観	はいかん	haikann
裏返し	うらがえし	uragaeshi
退学	たいがく	taigaku
災難	さいなん	sainann
秘話	ひわ	hiwa
至急	しきゅう	shikyuu
光源	こうげん	kougenn
沿道	えんどう	enndou
死傷	ししょう	shishou
水蒸気	すいじょうき	suijouki
朗報	ろうほう	rouhou
密閉	みっぺい	mippei
降雨	こうう	kouu
党内	とうない	tounai
合奏	がっそう	gassou
流派	りゅうは	ryuuha
お済み	おすみ	osumi
地方裁判所	ちほうさいばんしょ	chihousaibannsho
切腹	せっぷく	seppuku
内覧	ないらん	nairann
帯域	たいいき	taiiki
両論	りょうろん	ryouronn
吸入	きゅうにゅう	kyuunyuu
純情	じゅんじょう	junnjou
台座	だいざ	daiza
後ろ姿	うしろすがた	ushirosugata
系図	けいず	keizu
経済学部	けいざいがくぶ	keizaigakubu
脳死	のうし	noushi
巻き上げる	まきあげる	makiageru
乱立	らんりつ	rannritsu
殺傷	さっしょう	sasshou
片足	かたあし	kataashi
下巻	げかん	gekann
男優	だんゆう	dannyuu
正絹	しょうけん	shoukenn
遺す	のこす	nokosu
私生活	しせいかつ	shiseikatsu
善悪	ぜんあく	zennaku
ひび割れ	ひびわれ	hibiware
月収	げっしゅう	gesshuu
砂防	さぼう	sabou
探知	たんち	tannchi
射す	さす|ざす	sasu|zasu
縮尺	しゅくしゃく	shukushaku
降板	こうばん	koubann
預ける	あづける|あずける	adukeru|azukeru
乗降	じょうこう	joukou
私学	しがく	shigaku
株券	かぶけん	kabukenn
疑わしい	うたがわしい	utagawashii
君臨	くんりん	kunnrinn
海沿い	うみぞい	umizoi
巻き起こす	まきおこす	makiokosu
鋼板	こうはん	kouhann
仮装	かそう	kasou
晩秋	ばんしゅう	bannshuu
支庁	しちょう	shityou
天守閣	てんしゅかく	tennshukaku
探究	たんきゅう	tannkyuu
納まる	おさまる	osamaru
染める	そめる|しめる	someru|shimeru
お供え	おそなえ	osonae
片思い	かたおもい	kataomoi
創り出す	つくりだす	tsukuridasu
物欲	ぶつよく	butsuyoku
裏金	うらがね	uragane
歯並び	はならび	hanarabi
画策	かくさく	kakusaku
割愛	かつあい	katsuai
弁論	べんろん	bennronn
遺書	いしょ	isho
陽射し	ひざし	hizashi
近視	きんし	kinnshi
否決	ひけつ	hiketsu
厳守	げんしゅ	gennshu
処す	しょす	shosu
飲み干す	のみほす	nomihosu
見届ける	みとどける	mitodokeru
鋼鉄	こうてつ	koutetsu
派兵	はへい	hahei
灰皿	はいざら	haizara
臨界	りんかい	rinnkai
山系	さんけい	sannkei
異名	いみょう|いめい	imyou|imei
痛快	つうかい	tsuukai
卒論	そつろん	sotsuronn
退団	たいだん	taidann
純度	じゅんど	junndo
割当	わりあて	wariate
吸水	きゅうすい	kyuusui
創意	そうい	soui
お呼び	および	oyobi
権益	けんえき	kenneki
盛り付ける	もりつける	moritsukeru
体裁	ていさい	teisai
純白	じゅんぱく	junnpaku
賃貸借	ちんたいしゃく	chinntaishaku
別段	べつだん	betsudann
版権	はんけん	hannkenn
尺八	しゃくはち	shakuhachi
乱用	らんよう	rannyou
直視	ちょくし	tyokushi
就航	しゅうこう	shuukou
裁き	さばき	sabaki
国策	こくさく	kokusaku
合衆国	がっしゅうこく	gasshuukoku
危害	きがい	kigai
縦横	じゅうおう|たてよこ	juuou|tateyoko
強敵	きょうてき|ごうてき	kyouteki|gouteki
衆生	しゅじょう	shujou
吸い取る	すいとる	suitoru
備忘録	びぼうろく	bibouroku
我が身	わがみ	wagami
片付く	かたづく	kataduku
注視	ちゅうし	tyuushi
我家	わがや	wagaya
幕開け	まくあけ	makuake
誤認	ごにん	goninn
磁性	じせい	jisei
垂れ流し	たれながし	tarenagashi
客層	きゃくそう	kyakusou
傷病	しょうびょう	shoubyou
親密	しんみつ	shinnmitsu
片付ける	かたづける	katadukeru
腹立つ	はらだつ	haradatsu
穴子	あなご	anago
専ら	もっぱら	moppara
降雪	こうせつ	kousetsu
綿密	めんみつ	mennmitsu
善良	ぜんりょう	zennryou
純資産	じゅんしさん	junnshisann
従兄弟	いとこ|じゅうけいてい	itoko|juukeitei
供用	きょうよう	kyouyou
持論	じろん	jironn
積層	せきそう	sekisou
黒幕	くろまく	kuromaku
天敵	てんてき	tennteki
悪党	あくとう	akutou
秘宝	ひほう	hihou
納骨	のうこつ	noukotsu
激変	げきへん	gekihenn
上値	うわね	uwane
値動き	ねうごき	neugoki
聖域	せいいき	seiiki
装束	しょうぞく|そうぞく	shouzoku|souzoku
和訳	わやく	wayaku
閉館	へいかん	heikann
皮革	ひかく	hikaku
簡略	かんりゃく	kannryaku
痛風	つうふう	tsuufuu
連射	れんしゃ	rennsha
裁定	さいてい	saitei
純愛	じゅんあい	junnai
無痛	むつう	mutsuu
下腹	かふく|したはら	kafuku|shitahara
補欠	ほけつ	hoketsu
熟知	じゅくち	jukuchi
優等生	ゆうとうせい	yuutousei
書誌	しょし	shoshi
後姿	うしろすがた	ushirosugata
太陽系	たいようけい	taiyoukei
勤続	きんぞく	kinnzoku
目視	もくし	mokushi
形容詞	けいようし	keiyoushi
異形	いぎょう|いけい	igyou|ikei
拝借	はいしゃく	haishaku
親孝行	おやこうこう	oyakoukou
宣戦	せんせん	sennsenn
私見	しけん	shikenn
呼び捨て	よびすて	yobisute
名著	めいちょ	meityo
従属	じゅうぞく	juuzoku
値下がり	ねさがり	nesagari
広葉樹	こうようじゅ	kouyouju
欲張り	よくばり	yokubari
一派	いっぱ	ippa
糖度	とうど	toudo
鋼材	こうざい	kouzai
専修	せんしゅう	sennshuu
裁断	さいだん	saidann
皇女	おうじょ|みこ|こうじょ|ひめみこ	oujo|miko|koujo|himemiko
除名	じょめい	jomei
勤勉	きんべん	kinnbenn
糖分	とうぶん	toubunn
聖火	せいか	seika
論調	ろんちょう	ronntyou
増収	ぞうしゅう	zoushuu
操り	あやつり	ayatsuri
真っ盛り	まっさかり	massakari
揮発	きはつ	kihatsu
補習	ほしゅう	hoshuu
服従	ふくじゅう	fukujuu
忘れ去る	わすれさる	wasuresaru
疑念	ぎねん	ginenn
人並み	ひとなみ	hitonami
磁器	じき	jiki
未納	みのう	minou
視認	しにん	shininn
決裁	けっさい	kessai
収量	しゅうりょう	shuuryou
純金	じゅんきん	junnkinn
拡がる	ひろがる	hirogaru
論説	ろんせつ|ろんぜつ	ronnsetsu|ronnzetsu
右脳	うのう	unou
加担	かたん	katann
追従	ついしょう|ついじゅう	tsuishou|tsuijuu
中段	ちゅうだん	tyuudann
英訳	えいやく	eiyaku
山並み	やまなみ	yamanami
専科	せんか	sennka
降り続く	ふりつづく	furitsuduku
仲裁	ちゅうさい	tyuusai
便座	べんざ	bennza
俳人	はいじん	haijinn
胃がん	いがん	igann
私大	しだい	shidai
看病	かんびょう	kannbyou
左派	さは	saha
腹立たしい	はらだたしい	haradatashii
半熟	はんじゅく	hannjuku
小論文	しょうろんぶん	shouronnbunn
呼び寄せる	よびよせる	yobiyoseru
延びる	のびる	nobiru
呼応	こおう	koou
私事	しじ|わたくしごと	shiji|watakushigoto
難航	なんこう	nannkou
諸説	しょせつ	shosetsu
難題	なんだい	nanndai
巻物	まきもの	makimono
策略	さくりゃく	sakuryaku
乳酸	にゅうさん	nyuusann
暖冬	だんとう	danntou
推論	すいろん	suironn
存する	そんする	sonnsuru
推し進める	おしすすめる	oshisusumeru
公私	こうし	koushi
口紅	くちべに	kuchibeni
暖まる	あたたまる	atatamaru
針金	はりがね	harigane
裏方	うらかた	urakata
帰郷	ききょう	kikyou
収拾	しゅうしゅう	shuushuu
敬う	うやまう|うやもう	uyamau|uyamou
至って	いたって	itatte
卵黄	らんおう	rannou
奏す	そうす	sousu
減退	げんたい	genntai
心肺	しんぱい	shinnpai
難問	なんもん	nannmonn
低層	ていそう	teisou
券売	けんばい	kennbai
将軍家	しょうぐんけ	shougunnke
卵焼き	たまごやき	tamagoyaki
不純物	ふじゅんぶつ	fujunnbutsu
供え	そなえ	sonae
親権	しんけん	shinnkenn
簡便	かんべん	kannbenn
発券	はっけん	hakkenn
紅色	こうしょく|べにいろ	koushoku|beniiro
装丁	そうてい	soutei
食器洗い	しょっきあらい	shokkiarai
宣教師	せんきょうし	sennkyoushi
固有名詞	こゆうめいし	koyuumeishi
投げ捨てる	なげすてる	nagesuteru
私物	しぶつ	shibutsu
私設	しせつ	shisetsu
少将	しょうしょう	shoushou
乱れる	みだれる	midareru
密約	みつやく	mitsuyaku
変装	へんそう	hennsou
秘蔵	ひぞう|ひぞ	hizou|hizo
直腸	ちょくちょう	tyokutyou
片面	かためん	katamenn
山盛り	やまもり	yamamori
欲する	ほっする	hossuru
腹の中	はらのうち	haranouchi
屋根裏	やねうら	yaneura
高密度	こうみつど	koumitsudo
熱処理	ねつしょり	netsushori
拡げる	ひろげる	hirogeru
論破	ろんぱ	ronnpa
至難	しなん	shinann
縮まる	ちぢまる	chidimaru
増補	ぞうほ	zouho
訪日	ほうにち	hounichi
目論む	もくろむ	mokuromu
心筋	しんきん	shinnkinn
割増	わりまし	warimashi
感傷	かんしょう	kannshou
背ける	そむける	somukeru
街宣	がいせん	gaisenn
腹黒い	はらぐろい	haraguroi
仁王	におう	niou
傷める	いためる	itameru
署員	しょいん	shoinn
舌打ち	したうち	shitauchi
奮う	ふるう	furuu
難なく	なんなく	nannnaku
窓辺	まどべ	madobe
特段	とくだん	tokudann
従順	じゅうじゅん	juujunn
雨降り	あめふり	amefuri
糖類	とうるい	tourui
暮れる	くれる	kureru
後片付け	あとかたづけ	atokataduke
装具	そうぐ	sougu
自腹	じばら	jibara
戦乱	せんらん	sennrann
音域	おんいき	onniki
定刻	ていこく	teikoku
熟年	じゅくねん	jukunenn
警護	けいご	keigo
毒舌	どくぜつ	dokuzetsu
吸い上げる	すいあげる	suiageru
一座	いちざ	ichiza
射出	しゃしゅつ	shashutsu
密輸	みつゆ	mitsuyu
減収	げんしゅう	gennshuu
土砂降り	どしゃぶり	doshaburi
聖戦	せいせん	seisenn
水洗	すいせん	suisenn
下値	したね	shitane
持株	もちかぶ	mochikabu
お預け	おあづけ	oaduke
背もたれ	せもたれ	semotare
直系	ちょっけい	tyokkei
乳液	にゅうえき	nyuueki
難所	なんしょ	nannsho
受難	じゅなん	junann
観衆	かんしゅう	kannshuu
延長線	えんちょうせん	enntyousenn
完済	かんさい	kannsai
野暮	やぼ	yabo
自尊心	じそんしん	jisonnshinn
口論	こうろん	kouronn
専売	せんばい	sennbai
臨機応変	りんきおうへん	rinnkiouhenn
鋼管	こうかん	koukann
目処	めど	medo
奮戦	ふんせん	funnsenn
著い	しるい|つい	shirui|tsui
閉じこもる	とじこもる	tojikomoru
降順	こうじゅん	koujunn
諸氏	しょし	shoshi
てんこ盛り	てんこもり	tennkomori
家宅	かたく	kataku
激務	げきむ	gekimu
鉱泉	こうせん	kousenn
都庁	とちょう	totyou
拝読	はいどく	haidoku
本筋	ほんすじ	honnsuji
全盛	ぜんせい	zennsei
異に	ことに	kotoni
皇位	こうい	koui
持ち株	もちかぶ	mochikabu
巻き返す	まきかえす	makikaesu
日勤	にっきん	nikkinn
敵国	てきこく|てっこく	tekikoku|tekkoku
割れ目	われめ	wareme
小刻み	こきざみ	kokizami
脳波	のうは	nouha
就農	しゅうのう	shuunou
宣教	せんきょう	sennkyou
春巻き	はるまき	harumaki
論評	ろんぴょう	ronnpyou
骨太	ほねぶと	honebuto
傷付ける	きずつける	kizutsukeru
裏打ち	うらうち	urauchi
習熟	しゅうじゅく	shuujuku
土蔵	どぞう	dozou
復権	ふっけん	fukkenn
誤用	ごよう	goyou
安否	あんぴ	annpi
群衆	ぐんしゅう	gunnshuu
合否	ごうひ	gouhi
聖職	せいしょく	seishoku
歯痛	しつう|はいた	shitsuu|haita
樹皮	じゅひ	juhi
敵意	てきい	tekii
手探り	てさぐり	tesaguri
市域	しいき	shiiki
再訪	さいほう	saihou
従者	じゅうしゃ	juusha
大層	たいそう	taisou
片目	かため	katame
悲痛	ひつう	hitsuu
裏庭	うらにわ	uraniwa
調律	ちょうりつ	tyouritsu
針葉樹	しんようじゅ	shinnyouju
呼び止める	よびとめる	yobitomeru
激増	げきぞう	gekizou
論ずる	ろんずる	ronnzuru
目論見	もくろみ	mokuromi
処する	しょする	shosuru
小腸	しょうちょう	shoutyou
裁決	さいけつ	saiketsu
横断幕	おうだんまく	oudannmaku
恩給	おんきゅう	onnkyuu
吸気	きゅうき	kyuuki
吸い物	すいもの	suimono
拝める	おがめる	ogameru
異種	いしゅ	ishu
血筋	ちすじ	chisuji
直訳	ちょくやく	tyokuyaku
敬礼	けいれい	keirei
洗い場	あらいば	araiba
取り巻き	とりまき	torimaki
誌面	しめん	shimenn
大納言	だいなごん	dainagonn
未亡人	みぼうじん	miboujinn
裏付ける	うらづける	uradukeru
同窓	どうそう	dousou
穴あけ	あなあけ	anaake
誤算	ごさん	gosann
誌上	しじょう	shijou
返納	へんのう	hennnou
動乱	どうらん	dourann
大脳	だいのう	dainou
射手	いて|しゃしゅ|いで	ite|shashu|ide
助詞	じょし	joshi
腸管	ちょうかん	tyoukann
呼び起こす	よびおこす	yobiokosu
建ち並ぶ	たちならぶ	tachinarabu
初段	しょだん	shodann
回覧	かいらん	kairann
退化	たいか	taika
裏目	うらめ	urame
預入	あずけいれ|よにゅう	azukeire|yonyuu
表敬	ひょうけい	hyoukei
総論	そうろん	souronn
骨子	こっし	kosshi
退出	たいしゅつ	taishutsu
裏切り者	うらぎりもの	uragirimono
工賃	こうちん	kouchinn
翌週	よくしゅう	yokushuu
名将	めいしょう	meishou
腹ごしらえ	はらごしらえ	haragoshirae
物干し	ものほし	monohoshi
ブドウ糖	ぶどうとう	budoutou
財宝	ざいほう	zaihou
上皇	じょうこう	joukou
ポイ捨て	ぽいすて	poisute
夏至	げし	geshi
幼年	ようねん	younenn
背く	そむく	somuku
前段	ぜんだん	zenndann
用心棒	ようじんぼう	youjinnbou
前奏	ぜんそう	zennsou
著作権	ちょさくけん	tyosakukenn
誕生日	たんじょうび	tannjoubi
障害者	しょうがいしゃ	shougaisha
看護師	かんごし	kanngoshi
私達	わたしたち	watashitachi
専門店	せんもんてん	sennmonntenn
担当者	たんとうしゃ	tanntousha
一枚	いちまい	ichimai
専門家	せんもんか	sennmonnka
容疑者	ようぎしゃ	yougisha
従業員	じゅうぎょういん	juugyouinn
温暖化	おんだんか	onndannka
郵便局	ゆうびんきょく	yuubinnkyoku
大規模	だいきぼ	daikibo
子供達	こどもたち	kodomotachi
経済的	けいざいてき	keizaiteki
私自身	わたしじしん	watashijishinn
激安	げきやす	gekiyasu
補助金	ほじょきん	hojokinn
価値観	かちかん	kachikann
航空券	こうくうけん	koukuukenn
展覧会	てんらんかい	tennrannkai
脳内	のうない	nounai
展示会	てんじかい	tennjikai
映画館	えいがかん	eigakann
存在感	そんざいかん	sonnzaikann
検討中	けんとうちゅう	kenntoutyuu
危険性	きけんせい	kikennsei
候補者	こうほしゃ	kouhosha
演奏会	えんそうかい	ennsoukai
著作物	ちょさくぶつ	tyosakubutsu
時刻表	じこくひょう	jikokuhyou
難易度	なんいど	nannido
経済学	けいざいがく	keizaigaku
純米	じゅんまい	junnmai
宅配便	たくはいびん	takuhaibinn
評論家	ひょうろんか	hyouronnka
住宅街	じゅうたくがい	juutakugai
警察署	けいさつしょ	keisatsusho
住宅地	じゅうたくち	juutakuchi
映画化	えいがか	eigaka
領収書	りょうしゅうしょ	ryoushuusho
専門的	せんもんてき	sennmonnteki
勤務地	きんむち	kinnmuchi
情報誌	じょうほうし	jouhoushi
看護婦	かんごふ	kanngofu
裁判員	さいばんいん	saibanninn
論理的	ろんりてき	ronnriteki
時代劇	じだいげき	jidaigeki
筋肉痛	きんにくつう	kinnnikutsuu
権者	ごんじゃ	gonnja
映画祭	えいがさい	eigasai
展示場	てんじじょう	tennjijou
将来的	しょうらいてき	shouraiteki
所有権	しょゆうけん	shoyuukenn
翌営業日	よくえいぎょうび	yokueigyoubi
生態系	せいたいけい	seitaikei
写真展	しゃしんてん	shashinntenn
危機感	ききかん	kikikann
一覧表	いちらんひょう	ichirannhyou
退職金	たいしょくきん	taishokukinn
内視	ないし	naishi
内視鏡	ないしきょう	naishikyou
経験値	けいけんち	keikennchi
呼吸器	こきゅうき	kokyuuki
指揮者	しきしゃ	shikisha
神経痛	しんけいつう	shinnkeitsuu
週刊誌	しゅうかんし	shuukannshi
加盟店	かめいてん	kameitenn
障害児	しょうがいじ	shougaiji
外資系	がいしけい	gaishikei
従量制	じゅうりょうせい	juuryousei
最優先	さいゆうせん	saiyuusenn
参政権	さんせいけん	sannseikenn
従事者	じゅうじしゃ	juujisha
何枚	なんまい	nannmai
理論的	りろんてき	rironnteki
準優勝	じゅんゆうしょう	junnyuushou
乗車券	じょうしゃけん	joushakenn
裏技	うらわざ	urawaza
訪問者	ほうもんしゃ	houmonnsha
特派員	とくはいん	tokuhainn
宗教的	しゅうきょうてき	shuukyouteki
神秘的	しんぴてき	shinnpiteki
接骨院	せっこついん	sekkotsuinn
予約権	よやくけん	yoyakukenn
財産権	ざいさんけん	zaisannkenn
座談会	ざだんかい	zadannkai
衆院選	しゅういんせん	shuuinnsenn
警備員	けいびいん	keibiinn
否定的	ひていてき	hiteiteki
作品展	さくひんてん	sakuhinntenn
勤務先	きんむさき	kinnmusaki
再認識	さいにんしき	saininnshiki
再就職	さいしゅうしょく	saishuushoku
負担金	ふたんきん	futannkinn
温泉街	おんせんがい	onnsenngai
論者	ろんしゃ	ronnsha
対処法	たいしょほう	taishohou
放射性	ほうしゃせい	houshasei
高収入	こうしゅうにゅう	koushuunyuu
批判的	ひはんてき	hihannteki
指揮官	しきかん	shikikann
小冊子	しょうさっし	shousasshi
商品券	しょうひんけん	shouhinnkenn
専門職	せんもんしょく	sennmonnshoku
腸内	ちょうない	tyounai
方法論	ほうほうろん	houhouronn
泉質	せんしつ	sennshitsu
郵便物	ゆうびんぶつ	yuubinnbutsu
劇中	げきちゅう	gekityuu
宝箱	たからばこ	takarabako
創業者	そうぎょうしゃ	sougyousha
操作性	そうさせい	sousasei
裁判長	さいばんちょう	saibanntyou
情報源	じょうほうげん	jouhougenn
収容所	しゅうようじょ	shuuyoujo
展示室	てんじしつ	tennjishitsu
反対派	はんたいは	hanntaiha
重要視	じゅうようし	juuyoushi
宅建	たっけん	takkenn
血糖値	けっとうち	kettouchi
洗面所	せんめんじょ	sennmennjo
整理券	せいりけん	seirikenn
危険物	きけんぶつ	kikennbutsu
権力者	けんりょくしゃ	kennryokusha
豊胸	ほうきょう	houkyou
純利益	じゅんりえき	junnrieki
優先的	ゆうせんてき	yuusennteki
専門性	せんもんせい	sennmonnsei
博覧会	はくらんかい	hakurannkai
法律上	ほうりつじょう	houritsujou
少数派	しょうすうは	shousuuha
諸外国	しょがいこく	shogaikoku
開幕戦	かいまくせん	kaimakusenn
時系列	じけいれつ	jikeiretsu
最盛期	さいせいき	saiseiki
平均値	へいきんち	heikinnchi
金銭的	きんせんてき	kinnsennteki
秘湯	ひとう	hitou
臨場感	りんじょうかん	rinnjoukann
感染者	かんせんしゃ	kannsennsha
特別展	とくべつてん	tokubetsutenn
就職先	しゅうしょくさき	shuushokusaki
納税者	のうぜいしゃ	nouzeisha
足裏	あしうら	ashiura
諸事情	しょじじょう	shojijou
再検討	さいけんとう	saikenntou
天皇制	てんのうせい	tennnousei
純米酒	じゅんまいしゅ	junnmaishu
正統派	せいとうは	seitouha
染色体	せんしょくたい	sennshokutai
主導権	しゅどうけん	shudoukenn
段階的	だんかいてき	dannkaiteki
選挙権	せんきょけん	sennkyokenn
低脳	ていのう	teinou
優勝者	ゆうしょうしゃ	yuushousha
議決権	ぎけつけん	giketsukenn
心臓病	しんぞうびょう	shinnzoubyou
基準値	きじゅんち	kijunnchi
意欲的	いよくてき	iyokuteki
死亡率	しぼうりつ	shibouritsu
将来性	しょうらいせい	shouraisei
可視化	かしか	kashika
対応策	たいおうさく	taiousaku
処分場	しょぶんじょう	shobunnjou
観覧車	かんらんしゃ	kannrannsha
演奏家	えんそうか	ennsouka
革新的	かくしんてき	kakushinnteki
一巻	いっかん	ikkann
大聖堂	だいせいどう	daiseidou
独創的	どくそうてき	dokusouteki
問題視	もんだいし	monndaishi
晩飯	ばんめし	bannmeshi
討論会	とうろんかい	touronnkai
月刊誌	げっかんし	gekkannshi
創造性	そうぞうせい	souzousei
従業者	じゅうぎょうしゃ	juugyousha
創造的	そうぞうてき	souzouteki
視覚的	しかくてき	shikakuteki
体系的	たいけいてき	taikeiteki
勤労者	きんろうしゃ	kinnrousha
届出書	とどけでしょ	todokedesho
実力派	じつりょくは	jitsuryokuha
糖質	とうしつ	toushitsu
映像化	えいぞうか	eizouka
加盟国	かめいこく	kameikoku
遊覧船	ゆうらんせん	yuurannsenn
反射的	はんしゃてき	hannshateki
未確認	みかくにん	mikakuninn
探査機	たんさき	tannsaki
伝染病	でんせんびょう	dennsennbyou
優位性	ゆういせい	yuuisei
創始者	そうししゃ	soushisha
進化論	しんかろん	shinnkaronn
定期券	ていきけん	teikikenn
生演奏	なまえんそう	namaennsou
預言者	よげんしゃ	yogennsha
経済力	けいざいりょく	keizairyoku
深刻化	しんこくか	shinnkokuka
洗面台	せんめんだい	sennmenndai
危険度	きけんど	kikenndo
生理痛	せいりつう	seiritsuu
人形劇	にんぎょうげき	ninngyougeki
危機的	ききてき	kikiteki
物産展	ぶっさんてん	bussanntenn
著作者	ちょさくしゃ	tyosakusha
街路樹	がいろじゅ	gairoju
再処理	さいしょり	saishori
退職後	たいしょくご	taishokugo
特許権	とっきょけん	tokkyokenn
看護士	かんごし	kanngoshi
雨模様	あめもよう	amemoyou
神経系	しんけいけい	shinnkeikei
借地権	しゃくちけん	shakuchikenn
来訪者	らいほうしゃ	raihousha
負傷者	ふしょうしゃ	fushousha
総裁選	そうさいせん	sousaisenn
退職者	たいしょくしゃ	taishokusha
独裁者	どくさいしゃ	dokusaisha
四重奏	しじゅうそう	shijuusou
誕生会	たんじょうかい	tannjoukai
創造力	そうぞうりょく	souzouryoku
貴重品	きちょうひん	kityouhinn
縮毛	ちぢれげ|しゅくもう	chidirege|shukumou
券売機	けんばいき	kennbaiki
多数派	たすうは	tasuuha
訪問着	ほうもんぎ	houmonngi
演奏者	えんそうしゃ	ennsousha
過激派	かげきは	kagekiha
広報誌	こうほうし	kouhoushi
保存料	ほぞんりょう	hozonnryou
勤務医	きんむい	kinnmui
異次元	いじげん	ijigenn
展開中	てんかいちゅう	tennkaityuu
革命的	かくめいてき	kakumeiteki
経済性	けいざいせい	keizaisei
担当相	たんとうしょう	tanntoushou
参拝者	さんぱいしゃ	sannpaisha
経済界	けいざいかい	keizaikai
拡張子	かくちょうし	kakutyoushi
死亡者	しぼうしゃ	shibousha
背景色	はいけいしょく	haikeishoku
簡素化	かんそか	kannsoka
一党	いっとう	ittou
負担額	ふたんがく	futanngaku
幼児期	ようじき	youjiki
回数券	かいすうけん	kaisuukenn
自衛権	じえいけん	jieikenn
批評家	ひひょうか	hihyouka
担当医	たんとうい	tanntoui
律法	りっぽう	rippou
水資源	みずしげん	mizushigenn
深層水	しんそうすい	shinnsousui
降水量	こうすいりょう	kousuiryou
保守派	ほしゅは	hoshuha
展示物	てんじぶつ	tennjibutsu
町域	ちょういき	tyouiki
同盟国	どうめいこく	doumeikoku
商標権	しょうひょうけん	shouhyoukenn
技術系	ぎじゅつけい	gijutsukei