紹介	しょうかい	shoukai
詳細	しょうさい	shousai
投稿	とうこう	toukou
変更	へんこう	hennkou
販売	はんばい	hannbai
応援	おうえん	ouenn
記載	きさい	kisai
連絡	れんらく	rennraku
更新	こうしん	koushinn
影響	えいきょう	eikyou
皆様	みなさま	minasama
店舗	てんぽ	tennpo
状況	じょうきょう	joukyou
指摘	してき	shiteki
記憶	きおく	kioku
活躍	かつやく	katsuyaku
宿泊	しゅくはく	shukuhaku
比較	ひかく	hikaku
項目	こうもく	koumoku
是非	ぜひ	zehi
特徴	とくちょう	tokutyou
迷惑	めいわく	meiwaku
環境	かんきょう	kannkyou
普通	ふつう	futsuu
支援	しえん	shienn
結婚	けっこん	kekkonn
到着	とうちゃく	toutyaku
転載	てんさい	tennsai
維持	いじ	iji
派遣	はけん	hakenn
依頼	いらい	irai
攻撃	こうげき	kougeki
医療	いりょう	iryou
趣味	しゅみ	shumi
獲得	かくとく	kakutoku
考慮	こうりょ	kouryo
治療	ちりょう	chiryou
違反	いはん	ihann
彼女	かのじょ	kanojo
通販	つうはん	tsuuhann
敷金	しききん	shikikinn
税込	ぜいこみ	zeikomi
舞台	ぶたい	butai
被害	ひがい	higai
行為	こうい	koui
売却	ばいきゃく	baikyaku
相互	そうご|あいたがい	sougo|aitagai
傾向	けいこう	keikou
沢山	だくさん|たくさん	dakusann|takusann
破壊	はかい	hakai
信頼	しんらい	shinnrai
配慮	はいりょ	hairyo
新鮮	しんせん	shinnsenn
大幅	おおはば	oohaba
事項	じこう	jikou
継続	けいぞく	keizoku
面倒	めんどう|めんど	menndou|menndo
介護	かいご	kaigo
距離	きょり	kyori
言及	げんきゅう	gennkyuu
継承	けいしょう	keishou
恋愛	れんあい	rennai
普及	ふきゅう	fukyuu
範囲	はんい	hanni
添付	てんぷ	tennpu
近隣	きんりん	kinnrinn
我慢	がまん	gamann
連載	れんさい	rennsai
年齢	ねんれい	nennrei
前項	ぜんこう	zennkou
象徴	しょうちょう	shoutyou
申込	もうしこみ|もうしこめ	moushikomi|moushikome
真剣	しんけん	shinnkenn
刺激	しげき	shigeki
別途	べっと	betto
拠点	きょてん	kyotenn
侵害	しんがい	shinngai
圧倒	あっとう	attou
歓迎	かんげい	kanngei
乾燥	かんそう	kannsou
解釈	かいしゃく	kaishaku
回避	かいひ	kaihi
寄与	きよ	kiyo
蓄積	ちくせき	chikuseki
多彩	たさい	tasai
名称	めいしょう	meishou
突入	とつにゅう	totsunyuu
微妙	びみょう	bimyou
瞬間	しゅんかん	shunnkann
自慢	じまん	jimann
関与	かんよ	kannyo
突然	とつぜん	totsuzenn
現況	げんきょう	gennkyou
普段	ふだん	fudann
離島	りとう	ritou
趣旨	しゅし	shushi
途中	とちゅう	totyuu
用途	ようと	youto
依存	いぞん|いそん	izonn|isonn
目撃	もくげき	mokugeki
満載	まんさい	mannsai
振込	ふりこみ	furikomi
同項	どうこう	doukou
駆使	くし	kushi
閉鎖	へいさ	heisa
隣接	りんせつ	rinnsetsu
付与	ふよ	fuyo
地震	じしん	jishinn
到達	とうたつ	toutatsu
浸透	しんとう	shinntou
基盤	きばん	kibann
対抗	たいこう	taikou
経緯	いきさつ|けいい|たてぬき	ikisatsu|keii|tatenuki
知恵	ちえ|ぢえ	chie|die
執筆	しっぴつ	shippitsu
遠慮	えんりょ	ennryo
先輩	せんぱい	sennpai
恐縮	きょうしゅく	kyoushuku
極端	きょくたん	kyokutann
突破	とっぱ|つきやぶ	toppa|tsukiyabu
侵入	しんにゅう	shinnnyuu
漫画	まんが	mannga
支払	しはらい|しはらえ	shiharai|shiharae
駆除	くじょ	kujo
給与	きゅうよ	kyuuyo
未婚	みこん	mikonn
汚染	おせん	osenn
起訴	きそ	kiso
授与	じゅよ	juyo
根拠	こんきょ	konnkyo
監視	かんし	kannshi
発掘	はっくつ	hakkutsu
制御	せいぎょ	seigyo
浮上	ふじょう	fujou
空欄	くうらん	kuurann
市販	しはん	shihann
拍手	はくしゅ	hakushu
名誉	めいよ	meiyo
離婚	りこん	rikonn
爆発	ばくはつ	bakuhatsu
歳月	さいげつ	saigetsu
拍車	はくしゃ	hakusha
占領	せんりょう	sennryou
凡例	はんれい	hannrei
抵抗	ていこう	teikou
信仰	しんこう	shinnkou
敏感	びんかん	binnkann
闘病	とうびょう	toubyou
触発	しょくはつ	shokuhatsu
不況	ふきょう	fukyou
半端	はんぱ	hannpa
接触	せっしょく	sesshoku
寝具	しんぐ	shinngu
分離	ぶんり	bunnri
搬送	はんそう	hannsou
相違	そうい	soui
警戒	けいかい	keikai
脱毛	だつもう	datsumou
殺到	さっとう	sattou
優秀	ゆうしゅう	yuushuu
玄関	げんかん	gennkann
威力	いりょく	iryoku
寄贈	きぞう	kizou
迫力	はくりょく	hakuryoku
慎重	しんちょう	shinntyou
圧迫	あっぱく	appaku
恋人	こいびと	koibito
追及	ついきゅう	tsuikyuu
尽力	じんりょく	jinnryoku
引越	ひっこし|ひっこせ	hikkoshi|hikkose
矛盾	むじゅん	mujunn
投与	とうよ	touyo
今更	いまさら	imasara
途方	とほう	tohou
腰痛	ようつう	youtsuu
露出	ろしゅつ	roshutsu
鮮明	せんめい	sennmei
皆無	かいむ	kaimu
端数	はすう	hasuu
執行	しっこう|とりおこなえ	shikkou|toriokonae
雄大	ゆうだい	yuudai
含有	がんゆう	gannyuu
史跡	しせき	shiseki
輩出	はいしゅつ	haishutsu
鑑賞	かんしょう	kannshou
罰金	ばっきん	bakkinn
声援	せいえん	seienn
禁煙	きんえん	kinnenn
奇妙	きみょう	kimyou
抗議	こうぎ	kougi
徴収	ちょうしゅう	tyoushuu
絶妙	ぜつみょう	zetsumyou
需要	じゅよう	juyou
総称	そうしょう	soushou
沈黙	ちんもく	chinnmoku
外壁	がいへき|そとかべ	gaiheki|sotokabe
舗装	ほそう	hosou
返却	へんきゃく	hennkyaku
搬入	はんにゅう	hannnyuu
愛称	あいしょう	aishou
違法	いほう	ihou
彼氏	かれし	kareshi
爆笑	ばくしょう	bakushou
帽子	ぼうし	boushi
尋常	じんじょう	jinnjou
恩恵	おんけい	onnkei
取扱	とりあつかい|とりあつかえ	toriatsukai|toriatsukae
箇所	かしょ	kasho
改称	かいしょう	kaishou
全般	ぜんぱん	zennpann
抵触	ていしょく	teishoku
面影	おもかげ	omokage
獣医	じゅうい	juui
振興	しんこう	shinnkou
準拠	じゅんきょ	junnkyo
倒産	とうさん	tousann
祈願	きがん	kigann
猛毒	もうどく	moudoku
到来	とうらい	tourai
端的	たんてき	tannteki
趣向	しゅこう	shukou
襲撃	しゅうげき	shuugeki
証拠	しょうこ	shouko
大粒	おおつぶ	ootsubu
独占	どくせん	dokusenn
奇跡	きせき	kiseki
浮気	うわき	uwaki
暴露	ばくろ|ばれ	bakuro|bare
昼寝	ひるね	hirune
承継	しょうけい	shoukei
避難	ひなん	hinann
却下	きゃっか	kyakka
躍起	やっき	yakki
直撃	ちょくげき	tyokugeki
諸般	しょはん	shohann
図鑑	ずかん	zukann
本稿	ほんこう	honnkou
大抵	たいてい	taitei
合致	がっち	gacchi
恐怖	きょうふ	kyoufu
冒頭	ぼうとう	boutou
恒例	こうれい	kourei
印鑑	いんかん	innkann
援助	えんじょ	ennjo
描写	びょうしゃ	byousha
健闘	けんとう	kenntou
匹敵	ひってき	hitteki
物販	ぶっぱん	buppann
添加	てんか	tennka
遺跡	いせき	iseki
送迎	そうげい	sougei
何歳	なんさい	nannsai
釈然	しゃくぜん	shakuzenn
贈答	ぞうとう	zoutou
捕獲	ほかく	hokaku
御覧	ごらん	gorann
原爆	げんばく	gennbaku
税抜	ぜいぬき	zeinuki
発端	ほったん	hottann
御社	おんしゃ	onnsha
足跡	あしあと|そくせき	ashiato|sokuseki
占拠	せんきょ	sennkyo
圏内	けんない	kennnai
開拓	かいたく	kaitaku
噴出	ふんしゅつ	funnshutsu
固執	こしつ|こしゅう	koshitsu|koshuu
敷地	しきち	shikichi
踏襲	とうしゅう	toushuu
攻略	こうりゃく	kouryaku
困惑	こんわく	konnwaku
名刺	めいし	meishi
戦闘	せんとう	senntou
外為	がいため	gaitame
抜群	ばつぐん	batsugunn
強烈	きょうれつ	kyouretsu
茶髪	ちゃぱつ	tyapatsu
隣町	となりまち	tonarimachi
為替	かわせ|がわせ	kawase|gawase
微動	びどう	bidou
機微	きび	kibi
内払	うちばらい	uchibarai
脱出	だっしゅつ	dasshutsu
監査	かんさ	kannsa
祈念	きねん	kinenn
釈放	しゃくほう	shakuhou
依拠	いきょ	ikyo
下欄	からん	karann
格闘	かくとう	kakutou
漫才	まんざい	mannzai
初恋	はつこい	hatsukoi
脚光	きゃっこう	kyakkou
生殖	せいしょく	seishoku
繁殖	はんしょく	hannshoku
握手	あくしゅ	akushu
奴隷	どれい	dorei
上欄	じょうらん	jourann
即日	そくじつ	sokujitsu
称号	しょうごう	shougou
悲惨	ひさん	hisann
闘争	とうそう	tousou
舌鼓	したつづみ	shitatsudumi
巨人	きょじん	kyojinn
勧告	かんこく	kannkoku
珍重	ちんちょう	chinntyou
端末	たんまつ	tannmatsu
摘発	てきはつ	tekihatsu
丈夫	じょうぶ|ますらお|じょうふ	joubu|masurao|joufu
抱負	ほうふ	houfu
露店	ろてん	rotenn
震源	しんげん	shinngenn
専攻	せんこう	sennkou
薄毛	うすげ	usuge
増殖	ぞうしょく	zoushoku
巡回	じゅんかい	junnkai
涙目	なみだめ	namidame
婚活	こんかつ	konnkatsu
煙草	たばこ	tabako
自称	じしょう	jishou
実況	じっきょう	jikkyou
歳暮	せいぼ|さいぼ	seibo|saibo
奮闘	ふんとう	funntou
監禁	かんきん	kannkinn
原稿	げんこう	gennkou
新婚	しんこん	shinnkonn
脂肪	しぼう	shibou
鑑定	かんてい	kanntei
被告	ひこく	hikoku
形跡	けいせき	keiseki
盛況	せいきょう	seikyou
感嘆	かんたん	kanntann
猛暑	もうしょ	mousho
突進	とっしん|つきすすめ	tosshinn|tsukisusume
打撃	だげき	dageki
増幅	ぞうふく	zoufuku
高齢	こうれい	kourei
偉大	いだい	idai
侵略	しんりゃく	shinnryaku
座敷	ざしき	zashiki
無縁	むえん	muenn
白髪	しらが|はくはつ	shiraga|hakuhatsu
追跡	ついせき	tsuiseki
髪型	かみがた	kamigata
汚損	おそん	osonn
大汗	おおあせ|たいかん	ooase|taikann
端午	たんご	tanngo
静寂	しじま|せいじゃく	shijima|seijaku
次項	じこう	jikou
呼称	こしょう	koshou
寄稿	きこう	kikou
仮称	かしょう	kashou
壁紙	かべがみ	kabegami
装飾	そうしょく	soushoku
選抜	せんばつ|よりぬけ	sennbatsu|yorinuke
遅延	ちえん	chienn
押収	おうしゅう	oushuu
逃走	とうそう	tousou
皮膚	ひふ	hifu
濃厚	のうこう	noukou
希薄	きはく	kihaku
投影	とうえい	touei
突出	とっしゅつ|つきで	tosshutsu|tsukide
執着	しゅうじゃく|しゅうちゃく	shuujaku|shuutyaku
驚異	きょうい	kyoui
歓声	かんせい	kannsei
搬出	はんしゅつ	hannshutsu
中堅	ちゅうけん	tyuukenn
乾杯	かんぱい	kannpai
劣化	れっか	rekka
繁栄	はんえい	hannei
略称	りゃくしょう	ryakushou
脱却	だっきゃく	dakkyaku
停泊	ていはく	teihaku
中継	ちゅうけい|なかつぎ	tyuukei|nakatsugi
提訴	ていそ	teiso
折込	おりこみ|おりこめ	orikomi|orikome
左端	ひだりはし|さたん	hidarihashi|satann
暗黙	あんもく	annmoku
芝居	しばい	shibai
運搬	うんぱん	unnpann
本剤	ほんざい	honnzai
堅調	けんちょう	kenntyou
理屈	りくつ	rikutsu
芝生	しばふ	shibafu
苦慮	くりょ	kuryo
優雅	ゆうが	yuuga
信越	しんえつ	shinnetsu
仰天	ぎょうてん	gyoutenn
冒険	ぼうけん	boukenn
出稿	しゅっこう	shukkou
歓喜	かんき|かんぎ	kannki|kanngi
豪語	ごうご	gougo
交互	こうご	kougo
苦悩	くのう	kunou
仲介	ちゅうかい	tyuukai
敷設	ふせつ	fusetsu
瞬時	しゅんじ	shunnji
被災	ひさい	hisai
誇示	こじ	koji
監修	かんしゅう	kannshuu
豆腐	とうふ|どうふ	toufu|doufu
規範	きはん	kihann
侵攻	しんこう	shinnkou
透明	とうめい	toumei
忙殺	ぼうさつ	bousatsu
熱狂	ねっきょう	nekkyou
人柄	ひとがら	hitogara
更地	さらち	sarachi
左欄	さらん	sarann
通称	つうしょう	tsuushou
反撃	はんげき	hanngeki
太鼓	たいこ|だいこ	taiko|daiko
繁盛	はんじょう	hannjou
介入	かいにゅう	kainyuu
猛烈	もうれつ	mouretsu
魚介	ぎょかい	gyokai
激怒	げきど	gekido
侵食	しんしょく	shinnshoku
征服	せいふく	seifuku
猛威	もうい	moui
縁起	えんぎ	enngi
即時	そくじ	sokuji
完膚	かんぷ	kannpu
鉛筆	えんぴつ	ennpitsu
養殖	ようしょく	youshoku
多忙	たぼう	tabou
本拠	ほんきょ	honnkyo
本腰	ほんごし	honngoshi
老舗	しにせ|ろうほ	shinise|rouho
撃破	げきは	gekiha
奥様	おくさま	okusama
御礼	おれい|おんれい	orei|onnrei
追突	ついとつ	tsuitotsu
訴状	そじょう	sojou
微笑	びしょう	bishou
帰途	きと	kito
間髪	かんぱつ	kannpatsu
所為	しょい|せい	shoi|sei
堅持	けんじ	kennji
本項	ほんこう	honnkou
寝息	ねいき	neiki
脚本	きゃくほん	kyakuhonn
息吹	いぶき	ibuki
感触	かんしょく	kannshoku
傷跡	きずあと	kizuato
脱線	だっせん	dassenn
思惑	おもわく|しわく	omowaku|shiwaku
貸与	たいよ	taiyo
奇祭	きさい	kisai
執事	しつじ	shitsuji
退屈	たいくつ	taikutsu
騒然	そうぜん	souzenn
釈明	しゃくめい	shakumei
収載	しゅうさい	shuusai
是正	ぜせい	zesei
先端	せんたん	senntann
温床	おんしょう	onnshou
薬剤	やくざい	yakuzai
青紫	あおむらさき	aomurasaki
惨殺	ざんさつ	zannsatsu
傾倒	けいとう	keitou
彼岸	ひがん	higann
波紋	はもん	hamonn
唐突	とうとつ	toutotsu
末尾	まつび	matsubi
逆襲	ぎゃくしゅう	gyakushuu
脱字	だつじ	datsuji
寝言	ねごと	negoto
終盤	しゅうばん	shuubann
介在	かいざい	kaizai
渡来	とらい	torai
髪質	かみしつ	kamishitsu
召集	しょうしゅう	shoushuu
過敏	かびん	kabinn
刺身	さしみ	sashimi
斜面	しゃめん	shamenn
湖沼	こしょう	koshou
濃縮	のうしゅく	noushuku
贈与	ぞうよ	zouyo
処罰	しょばつ	shobatsu
振替	ふりかえ	furikae
兼務	けんむ	kennmu
突撃	とつげき	totsugeki
浮遊	ふゆう	fuyuu
身柄	みがら	migara
奥深	おくふか|おくぶか	okufuka|okubuka
右欄	うらん	urann
押印	おういん	ouinn
主訴	しゅそ	shuso
彼方	かなた|あちら|あなた	kanata|achira|anata
収監	しゅうかん	shuukann
加齢	かれい	karei
兼任	けんにん	kennninn
痛烈	つうれつ	tsuuretsu
激突	げきとつ	gekitotsu
甘味	あまみ|かんみ	amami|kannmi
肩身	かたみ	katami
防御	ぼうぎょ	bougyo
迫害	はくがい	hakugai
陰口	かげぐち	kageguchi
髪量	かみりょう	kamiryou
渡航	とこう	tokou
着床	ちゃくしょう	tyakushou
後輩	こうはい	kouhai
電撃	でんげき	denngeki
黙認	もくにん	mokuninn
数奇	さっき|すうき|すき	sakki|suuki|suki
遅刻	ちこく	chikoku
鼓動	こどう	kodou
荒波	あらなみ	aranami
儀式	ぎしき	gishiki
床下	ゆかした	yukashita
是認	ぜにん	zeninn
右翼	うよく	uyoku
紋章	もんしょう	monnshou
暗躍	あんやく	annyaku
紫色	むらさきいろ	murasakiiro
先陣	せんじん	sennjinn
占有	せんゆう	sennyuu
荒野	あらの|こうや	arano|kouya
復縁	ふくえん	fukuenn
振動	しんどう	shinndou
沈殿	ちんでん	chinndenn
異彩	いさい	isai
赤壁	せきへき	sekiheki
威信	いしん	ishinn
傍点	ぼうてん	boutenn
後継	こうけい|あとつぎ	koukei|atotsugi
等幅	とうはば	touhaba
鮮度	せんど	senndo
傾斜	けいしゃ	keisha
敷居	しきい	shikii
調剤	ちょうざい	tyouzai
南端	なんたん	nanntann
押切	おしき	oshiki
撃沈	げきちん	gekichinn
建替	たてかえ	tatekae
立脚	りっきゃく	rikkyaku
震度	しんど	shinndo
屋敷	やしき	yashiki
余暇	よか	yoka
跡地	あとち	atochi
旨味	うまみ	umami
山陰	やまかげ|さんいん	yamakage|sanninn
巨万	きょまん	kyomann
採掘	さいくつ	saikutsu
偉業	いぎょう	igyou
皮脂	ひし	hishi
鉄腕	てつわん	tetsuwann
不詳	ふしょう	fushou
倒壊	とうかい	toukai
光沢	こうたく	koutaku
骨盤	こつばん	kotsubann
盗難	とうなん	tounann
主旨	しゅし	shushi
落雷	らくらい	rakurai
弾圧	だんあつ	dannatsu
殿堂	でんどう	denndou
包含	ほうがん	hougann
海鮮	かいせん	kaisenn
撃退	げきたい	gekitai
波及	はきゅう	hakyuu
狭間	はざま	hazama
吐露	とろ	toro
振出	ふりだし	furidashi
縁日	えんにち	ennnichi
途端	とたん	totann
漁獲	ぎょかく	gyokaku
与党	よとう	yotou
後援	こうえん	kouenn
要旨	ようし	youshi
起床	きしょう	kishou
追撃	ついげき	tsuigeki
疑惑	ぎわく	giwaku
飛躍	ひやく	hiyaku
不慮	ふりょ	furyo
扇子	せんす	sennsu
爆破	ばくは	bakuha
絶叫	ぜっきょう	zekkyou
物陰	ものかげ	monokage
即位	そくい	sokui
御用	ごよう	goyou
右端	みぎはし|みぎはじ|うたん	migihashi|migihaji|utann
罰則	ばっそく	bassoku
不眠	ふみん	fuminn
平凡	へいぼん	heibonn
称賛	しょうさん	shousann
離脱	りだつ	ridatsu
桜桃	おうとう|さくらんぼう|ゆすらうめ|さくらんぼ	outou|sakurannbou|yusuraume|sakurannbo
元彼	もとかれ	motokare
耐熱	たいねつ	tainetsu
反響	はんきょう	hannkyou
人影	ひとかげ	hitokage
騒音	そうおん	souonn
即行	そっこう	sokkou
野郎	やろう	yarou
軽微	けいび	keibi
脱税	だつぜい	datsuzei
右隣	みぎどなり	migidonari
浸食	しんしょく	shinnshoku
即答	そくとう	sokutou
捕食	ほしょく	hoshoku
惑星	わくせい	wakusei
誤爆	ごばく	gobaku
御宿	おやど	oyado
全幅	ぜんはば|ぜんぷく	zennhaba|zennpuku
繁茂	はんも	hannmo
婚約	こんやく	konnyaku
休暇	きゅうか	kyuuka
花環	はなわ	hanawa
畳数	じょうすう	jousuu
脱帽	だつぼう	datsubou
彩色	さいしき|さいしょく	saishiki|saishoku
脱皮	だっぴ	dappi
中盤	ちゅうばん	tyuubann
旧跡	きゅうせき	kyuuseki
攻防	こうぼう	koubou
恋心	こいごころ	koigokoro
権威	けんい	kenni
爆弾	ばくだん	bakudann
跡形	あとかた	atokata
早寝	はやね	hayane
神妙	しんみょう	shinnmyou
英雄	えいゆう	eiyuu
寝顔	ねがお	negao
療養	りょうよう	ryouyou
鼓舞	こぶ	kobu
手狭	てぜま	tezema
貯蓄	ちょちく	tyochiku
逃亡	とうぼう	toubou
難儀	なんぎ	nanngi
巨大	きょだい	kyodai
登載	とうさい	tousai
腐心	ふしん	fushinn
汚名	おめい	omei
遠征	えんせい	ennsei
告訴	こくそ	kokuso
北端	ほくたん	hokutann
右腕	うわん|みぎうで	uwann|migiude
城壁	じょうへき	jouheki
眠気	ねむけ	nemuke
隠居	いんきょ	innkyo
煮干	にぼし	niboshi
越冬	えっとう	ettou
風俗	ふうぞく	fuuzoku
民謡	みんよう	minnyou
会釈	えしゃく	eshaku
本舗	ほんぽ	honnpo
東端	とうたん	toutann
事柄	ことがら	kotogara
連泊	れんぱく	rennpaku
我輩	わがはい	wagahai
賞与	しょうよ	shouyo
丹精	たんせい	tannsei
汚物	おぶつ	obutsu
快眠	かいみん	kaiminn
西端	せいたん	seitann
屈服	くっぷく	kuppuku
供与	きょうよ	kyouyo
耐震	たいしん	taishinn
因縁	いんねん	innnenn
模範	もはん	mohann
鉄砲	てっぽう|でっぽう	teppou|deppou
忘却	ぼうきゃく	boukyaku
		
及び	および	oyobi
違う	ちがう|たがう|ちごう|たごう	chigau|tagau|chigou|tagou
含む	ふくむ|ぐむ	fukumu|gumu
詳しい	くわしい	kuwashii
皆さん	みなさん	minasann
違い	ちがい|たがい	chigai|tagai
描く	えがく|かく|がく	egaku|kaku|gaku
致す	いたす	itasu
与える	あたえる	ataeru
押す	おす	osu
間違い	まちがい	machigai
迎える	むかえる	mukaeru
疲れ	つかれ|づかれ|つかれれ	tsukare|dukare|tsukarere
彼ら	かれら	karera
含める	ふくめる	fukumeru
離れる	はなれる|ばなれる	hanareru|banareru
書き込み	かきこみ	kakikomi
勧める	すすめる	susumeru
支払い	しはらい	shiharai
遅い	おそい	osoi
怖い	こわい	kowai
払う	はらう|ばらう|ぱらう|はろう|ばろう|ぱろう	harau|barau|parau|harou|barou|parou
繰り返す	くりかえす	kurikaesu
申し込み	もうしこみ	moushikomi
更に	さらに	sarani
悩み	なやみ	nayami
取り扱い	とりあつかい	toriatsukai
驚く	おどろく	odoroku
抜ける	ぬける	nukeru
忙しい	いそがしい|せわしい	isogashii|sewashii
引越し	ひっこし	hikkoshi
渡る	わたる	wataru
隠す	かくす	kakusu
甘い	あまい|うまい	amai|umai
咲く	さく|ざく	saku|zaku
越える	こえる|ごえる	koeru|goeru
珍しい	めずらしい	mezurashii
扱い	あつかい|こい|しごい	atsukai|koi|shigoi
悩む	なやむ	nayamu
避ける	さける|よける	sakeru|yokeru
間違う	まちがう|まちごう	machigau|machigou
遅れ	おくれ	okure
抱く	いだく|だく	idaku|daku
お互い	おたがい	otagai
扱う	あつかう|あつこう	atsukau|atsukou
載る	のる	noru
怒る	いかる|おこる	ikaru|okoru
書き込む	かきこむ	kakikomu
薄い	うすい|うしい	usui|ushii
恥ずかしい	はずかしい	hazukashii
逃げ	にげ	nige
触れ	ふれ|さわれ|ぶれ	fure|saware|bure
抜く	ぬく	nuku
狭い	せまい	semai
替える	かえる|がえる	kaeru|gaeru
吹く	ふく|ぶく	fuku|buku
込み	こみ|ごみ	komi|gomi
眠る	ねむる|ねる|ねぶる	nemuru|neru|neburu
汚れ	けがれ|よごれ|けがれれ	kegare|yogore|kegarere
驚き	おどろき|きょうき	odoroki|kyouki
寂しい	さびしい|さみしい	sabishii|samishii
頼る	たよる	tayoru
巡る	めぐる	meguru
振る	ふる|ぶる	furu|buru
お菓子	おかし	okashi
迫る	せまる|せる	semaru|seru
載せる	のせる	noseru
幅広い	はばひろい	habahiroi
贈る	おくる	okuru
倒す	たおす	taosu
間違える	まちがえる	machigaeru
振り	ふり|ぶり|ぷり	furi|buri|puri
占い	うらない	uranai
取扱い	とりあつかい	toriatsukai
込める	こめる|ごめる	komeru|gomeru
振り返る	ふりかえる	furikaeru
お疲れ様	おつかれさま	otsukaresama
怒り	いかり|おこり	ikari|okori
寝る	ねる|しずまる|ぬる	neru|shizumaru|nuru
倒れる	たおれる|だおれる	taoreru|daoreru
壊れる	こわれる	kowareru
越す	こす	kosu
訴え	うったえ	uttae
輝く	かがやく	kagayaku
込む	こむ|ごむ	komu|gomu
濃い	こい	koi
踊り	おどり	odori
飾る	かざる	kazaru
踊る	おどる	odoru
踏む	ふむ|ぶむ	fumu|bumu
抱え	かかえ	kakae
襲う	おそう	osou
恐れ	おそれ|おそれれ	osore|osorere
荒らす	あらす	arasu
抜き	ぬき	nuki
弾く	はじく|ひく|びく	hajiku|hiku|biku
渡し	わたし	watashi
頼む	たのむ	tanomu
叫ぶ	さけぶ	sakebu
絡む	からむ	karamu
恐ろしい	おそろしい	osoroshii
隠れ	かくれ|こもれ|かくれれ|がくれ	kakure|komore|kakurere|gakure
及ぶ	およぶ	oyobu
伺い	うかがい	ukagai
占める	しめる|じめる	shimeru|jimeru
攻め	せめ|ぜめ	seme|zeme
柔らかい	やわらかい	yawarakai
耐え	たえ	tae
誇る	ほこる	hokoru
恵まれる	めぐまれる	megumareru
吐く	はく|つく	haku|tsuku
申込む	もうしこむ	moushikomu
黙る	だまる	damaru
添える	そえる|ぞえる	soeru|zoeru
浮かぶ	うかぶ	ukabu
狩り	かり|がり	kari|gari
飾り	かざり	kazari
支払う	しはらう|しはろう	shiharau|shiharou
握る	にぎる	nigiru
奥さん	おくさん	okusann
触る	さわる|ふる	sawaru|furu
尽くす	つくす	tsukusu
掘る	ほる	horu
壊す	こわす	kowasu
祈る	いのる	inoru
お越し	おこし	okoshi
取り扱う	とりあつかう|とりあつこう	toriatsukau|toriatsukou
咲き	さき|ざき	saki|zaki
突っ込む	つっこむ	tsukkomu
祈り	いのり	inori
詰め	つめ|づめ	tsume|dume
尋ねる	たずねる	tazuneru
御座い	ござい	gozai
荒れる	あれる	areru
踏まえる	ふまえる	fumaeru
響く	ひびく	hibiku
及ぼす	およぼす	oyobosu
響き	ひびき	hibiki
巻き込む	まきこむ	makikomu
泊まる	とまる	tomaru
汚い	きたない|ぎたない	kitanai|gitanai
渡す	わたす	watasu
被る	かぶる|こうむる|かむる	kaburu|koumuru|kamuru
切り替え	きりかえ	kirikae
鮮やか	あざやか	azayaka
撃つ	うつ|ぶつ	utsu|butsu
誇り	ほこり|ぼこり	hokori|bokori
詰まる	つまる|づまる	tsumaru|dumaru
皆さま	みなさま	minasama
騒ぐ	さわぐ	sawagu
お盆	おぼん	obonn
引っ越し	ひっこし	hikkoshi
旨い	うまい	umai
眠い	ねむい|ねみい	nemui|nemii
触れる	ふれる|ぶれる|さわれる	fureru|bureru|sawareru
贈り物	おくりもの	okurimono
舞う	まう|もう	mau|mou
召し上がる	めしあがる	meshiagaru
逃げる	にげる	nigeru
脱ぐ	ぬぐ	nugu
浮かべる	うかべる	ukaberu
頼り	たより|だより	tayori|dayori
伺う	うかがう|うかごう	ukagau|ukagou
輝き	かがやき	kagayaki
曇る	くもる	kumoru
称す	しょうす	shousu
腐る	くさる	kusaru
沈む	しずむ	shizumu
押さえ	おさえ	osae
乗り越える	のりこえる	norikoeru
眠り	ねむり|ねぶり	nemuri|neburi
兼ねる	かねる	kaneru
鋭い	するどい|すすどい|とい	surudoi|susudoi|toi
恐らく	おそらく	osoraku
離す	はなす	hanasu
奴ら	やつら	yatsura
浮く	うく	uku
微笑む	ほほえむ|ほおえむ	hohoemu|hooemu
繰り広げる	くりひろげる	kurihirogeru
含み	ふくみ|ぶくみ|ぐみ	fukumi|bukumi|gumi
叫び	さけび	sakebi
斜め	ななめ	naname
敷く	しく	shiku
持ち込む	もちこむ	mochikomu
乗り込む	のりこむ	norikomu
受け継ぐ	うけつぐ	uketsugu
柔らか	やわらか	yawaraka
着替え	きがえ|きかえ	kigae|kikae
見込み	みこみ	mikomi
狂う	くるう	kuruu
互いに	たがいに	tagaini
逃す	にがす|のがす	nigasu|nogasu
駆ける	かける|がける	kakeru|gakeru
髪の毛	かみのけ	kaminoke
騒ぎ	さわぎ	sawagi
飛び込む	とびこむ	tobikomu
お祈り	おいのり	oinori
溶け	とけ|どけ	toke|doke
見逃し	みのがし	minogashi
捕まる	つかまる|づかまる	tsukamaru|dukamaru
刺す	さす	sasu
見舞い	みまい	mimai
闘い	たたかい	tatakai
幾つ	いくつ	ikutsu
お陰	おかげ	okage
枯れる	かれる|がれる	kareru|gareru
震え	ふるえ	furue
偉い	えらい	erai
落ち込む	おちこむ	ochikomu
劣る	おとる	otoru
入れ替え	いれかえ	irekae
訴える	うったえる	uttaeru
頼み	たのみ|だのみ	tanomi|danomi
恵み	めぐみ	megumi
刺し	さし|ざし	sashi|zashi
乾く	かわく	kawaku
捕まえる	つかまえる|づかまえる|とらまえる	tsukamaeru|dukamaeru|toramaeru
お迎え	おむかえ	omukae
傾ける	かたぶける|かたむける	katabukeru|katamukeru
甘え	あまえ|あめえ|うめえ	amae|amee|umee
闘う	たたかう|たたこう	tatakau|tatakou
彩る	いろどる	irodoru
申し込む	もうしこむ	moushikomu
取り込む	とりこむ	torikomu
継ぐ	つぐ	tsugu
振込む	ふりこむ	furikomu
突き	つき|とっき|つつき|づき|ずき	tsuki|tokki|tsutsuki|duki|zuki
抱きしめる	だきしめる	dakishimeru
握り	にぎり	nigiri
引き継ぐ	ひきつぐ	hikitsugu
入り込む	いりこむ|はいりこむ	irikomu|hairikomu
追い込む	おいこむ	oikomu
打ち込む	うちこむ|ぶちこむ	uchikomu|buchikomu
お疲れさま	おつかれさま	otsukaresama
駆けつける	かけつける	kaketsukeru
押し付ける	おしつける	oshitsukeru
泊まり	とまり|どまり	tomari|domari
小遣い	こづかい	kodukai
お尋ね	おたずね	otazune
甘み	あまみ|うまみ	amami|umami
振り回す	ふりまわす	furimawasu
盗る	とる|ぬすめる|どる	toru|nusumeru|doru
仕込み	しこみ|じこみ	shikomi|jikomi
突っ込み	つっこみ	tsukkomi
肩こり	かたこり	katakori
遅れる	おくれる	okureru
盗む	ぬすむ	nusumu
突く	つく|つつく|づく	tsuku|tsutsuku|duku
見込む	みこむ	mikomu
描ける	えがける|かける	egakeru|kakeru
替わる	かわる	kawaru
抱える	かかえる	kakaeru
持ち込み	もちこみ	mochikomi
淡い	あわい	awai
咲かせる	さかせる	sakaseru
振り向く	ふりむく	furimuku
恐い	こわい	kowai
介す	かいす	kaisu
恋しい	こいしい	koishii
即ち	すなわち	sunawachi
思い込む	おもいこむ	omoikomu
出迎え	でむかえ	demukae
組み込む	くみこむ	kumikomu
疲れる	つかれる|づかれる	tsukareru|dukareru
浸る	ひたる|びたる	hitaru|bitaru
逃れ	のがれ|にげれ	nogare|nigere
隠れ家	かくれが	kakurega
税込み	ぜいこみ	zeikomi
荒い	あらい	arai
溶かす	とかす	tokasu
澄む	すむ|ずむ	sumu|zumu
尽き	つき	tsuki
堅い	かたい|がたい	katai|gatai
見渡す	みわたす	miwatasu
吸い込む	すいこむ	suikomu
大騒ぎ	おおさわぎ	oosawagi
刈る	かる|がる	karu|garu
仰る	おっしゃる|おおせる	ossharu|ooseru
逃げ出す	にげだす	nigedasu
久し振り	ひさしぶり	hisashiburi
引き込む	ひきこむ	hikikomu
抱っこ	だっこ	dakko
旨み	うまみ	umami
煮込み	にこみ	nikomi
捕らえる	とらえる	toraeru
浸かる	つかる	tsukaru
倒せる	たおせる	taoseru
盛り込む	もりこむ	morikomu
互い	たがい	tagai
仰ぐ	あおぐ	aogu
お隣	おとなり	otonari
怒鳴る	どなる	donaru
抜け出す	ぬけだす	nukedasu
彩り	いろどり	irodori
振るう	ふるう	furuu
傍ら	かたわら	katawara
吐き出す	はきだす|ほきだす	hakidasu|hokidasu
日替わり	ひがわり	higawari
途切れる	とぎれる	togireru
過払い	かばらい	kabarai
悩ます	なやます	nayamasu
仕込む	しこむ	shikomu
絡める	からめる	karameru
傾く	かたぶく|かたむく	katabuku|katamuku
戸惑う	とまどう	tomadou
浮かび上がる	うかびあがる	ukabiagaru
手抜き	てぬき	tenuki
振り込み	ふりこみ	furikomi
踏み込む	ふみこむ	fumikomu
嘆く	なげく	nageku
思い込み	おもいこみ	omoikomi
差し込む	さしこむ	sashikomu
誉める	ほめる	homeru
思い浮かべる	おもいうかべる	omoiukaberu
踏み出す	ふみだす	fumidasu
鈍い	にぶい|のろい|にびい	nibui|noroi|nibii
追い詰める	おいつめる	oitsumeru
幾ら	いくら	ikura
お忙しい	おいそがしい	oisogashii
見抜く	みぬく	minuku
書込み	かきこみ	kakikomi
遠慮ない	えんりょない	ennryonai
包み込む	つつみこむ|くるみこむ	tsutsumikomu|kurumikomu
捕る	とる|どる	toru|doru
薄れる	うすれる	usureru
すれ違う	すれちがう|すれちごう	surechigau|surechigou
隣る	となる	tonaru
読み込み	よみこみ	yomikomi
閉じ込める	とじこめる	tojikomeru
遣い	つかい|づかい	tsukai|dukai
遣る	やる	yaru
吹っ飛ぶ	ふっとぶ	futtobu
吐き気	はきけ	hakike
浮き	うき|うわき	uki|uwaki
召す	めす	mesu
驚かす	おどろかす	odorokasu
為す	なす	nasu
薄暗い	うすぐらい|うすくらい	usugurai|usukurai
面倒くさい	めんどうくさい	menndoukusai
煮込む	にこむ	nikomu
逃がす	にがす|のがす	nigasu|nogasu
透ける	すける	sukeru
耐える	たえる	taeru
奥深い	おくふかい|おくぶかい	okufukai|okubukai
跳ぶ	とぶ	tobu
恋する	こいする	koisuru
怖がる	こわがる	kowagaru
見舞う	みまう|みもう	mimau|mimou
吹き飛ばす	ふきとばす	fukitobasu
泊り	とまり|どまり	tomari|domari
攻める	せめる	semeru
余儀ない	よぎない	yoginai
詰め込む	つめこむ	tsumekomu
刺さる	ささる	sasaru
占い師	うらないし	uranaishi
見逃す	みのがす	minogasu
押し寄せる	おしよせる	oshiyoseru
憶える	おぼえる	oboeru
依然として	いぜんとして	izenntoshite
前払い	まえばらい	maebarai
跳ね	はね|ばね	hane|bane
引渡し	ひきわたし	hikiwatashi
震える	ふるえる	furueru
恐る	おそれる|おそる	osoreru|osoru
暇つぶし	ひまつぶし	himatsubushi
振る舞い	ふるまい|ぶるまい	furumai|burumai
坊さん	ぼうさん	bousann
薄める	うすめる	usumeru
泊まれる	とまれる	tomareru
寝かせる	ねかせる	nekaseru
戸惑い	とまどい	tomadoi
手渡し	てわたし	tewatashi
取り替える	とりかえる	torikaeru
意気込み	いきごみ	ikigomi
寄り添う	よりそう	yorisou
沈める	しずめる	shizumeru
狩る	かる	karu
見渡せる	みわたせる	miwataseru
微か	かすか	kasuka
取り込み	とりこみ	torikomi
絵描き	えかき	ekaki
沈み	しずみ	shizumi
読み込む	よみこむ	yomikomu
離せる	はなせる	hanaseru
兼ね備える	かねそなえる	kanesonaeru
後払い	あとばらい|ごばらい	atobarai|gobarai
駆け抜ける	かけぬける	kakenukeru
赤ん坊	あかんぼう|あかんぼ	akannbou|akannbo
すれ違い	すれちがい	surechigai
恐れ入る	おそれいる	osoreiru
浸す	ひたす|びたす	hitasu|bitasu
尽きる	つきる	tsukiru
切り替える	きりかえる	kirikaeru
抱きつく	だきつく	dakitsuku
摘み	つまみ|つみ	tsumami|tsumi
書き込める	かきこめる	kakikomeru
詰まり	つまり|づまり	tsumari|dumari
後押し	あとおし	atooshi
先駆け	さきがけ	sakigake
流れ込む	ながれこむ	nagarekomu
占う	うらなう|うらのう	uranau|uranou
頼もしい	たのもしい	tanomoshii
買い替え	かいかえ	kaikae
詰め合わせ	つめあわせ	tsumeawase
狂い	くるい|ぐるい	kurui|gurui
押し込む	おしこむ	oshikomu
奥行き	おくゆき	okuyuki
溶け込む	とけこむ	tokekomu
盆踊り	ぼんおどり	bonnodori
抜け毛	ぬけげ	nukege
違える	たがえる|ちがえる	tagaeru|chigaeru
生き抜く	いきぬく	ikinuku
落ち込み	おちこみ	ochikomi
気遣い	きづかい	kidukai
傾げる	かしげる|かたげる	kashigeru|katageru
飛び込み	とびこみ	tobikomi
切り替わる	きりかわる	kirikawaru
吹き出す	ふきだす	fukidasu
微笑ましい	ほほえましい	hohoemashii
戯れる	ざれる|たわむれる|じゃれる	zareru|tawamureru|jareru
称する	しょうする	shousuru
吹き込む	ふきこむ	fukikomu
嘆き	なげき	nageki
飲み込む	のみこむ	nomikomu
通り抜ける	とおりぬける	toorinukeru
放り込む	ほうりこむ	hourikomu
肩書き	かたがき	katagaki
年越し	としこし	toshikoshi
駆る	かる	karu
触り	さわり|ざわり|ふり	sawari|zawari|furi
見逃せる	みのがせる	minogaseru
入れ替わる	いれかわる	irekawaru
摘む	つまむ|つむ	tsumamu|tsumu
突きつける	つきつける	tsukitsukeru
乾かす	かわかす	kawakasu
依る	よる	yoru
振り込む	ふりこむ	furikomu
吹き抜け	ふきぬけ	fukinuke
踏み切る	ふみきる	fumikiru
押しつけ	おしつけ	oshitsuke
建て替え	たてかえ	tatekae
押さえる	おさえる	osaeru
傾き	かたむき|かたぶき	katamuki|katabuki
濁り	にごり	nigori
弾む	はずむ	hazumu
駆け寄る	かけよる	kakeyoru
乗り継ぎ	のりつぎ	noritsugi
抜かす	ぬかす	nukasu
即す	そくす	sokusu
割り込む	わりこむ	warikomu
拓く	ひらく	hiraku
恥じる	はじる	hajiru
蓄え	たくわえ	takuwae
隠せる	かくせる	kakuseru
煮る	にる	niru
曇り空	くもりぞら	kumorizora
踏ん張る	ふんばる	funnbaru
通り越す	とおりこす	toorikosu
かけ離れる	かけはなれる	kakehanareru
呼び込む	よびこむ	yobikomu
引き渡し	ひきわたし	hikiwatashi
騒がしい	さわがしい	sawagashii
掘り下げる	ほりさげる	horisageru
透き通る	すきとおる	sukitooru
恐れる	おそれる	osoreru
間抜け	まぬけ	manuke
惑わす	まどわす	madowasu
眠れる	ねむれる	nemureru
逃れる	のがれる	nogareru
濁る	にごる	nigoru
息抜き	いきぬき	ikinuki
弾ける	はじける|ひける	hajikeru|hikeru
突き進む	つきすすむ	tsukisusumu
踊り子	おどりこ	odoriko
途絶える	とだえる	todaeru
居眠り	いねむり	inemuri
咲き誇る	さきほこる	sakihokoru
見込める	みこめる	mikomeru
躍る	おどる	odoru
住み替える	すみかえる	sumikaeru
茂る	しげる	shigeru
突っ走る	つっぱしる	tsuppashiru
隠れる	かくれる	kakureru
手渡す	てわたす	tewatasu
切り抜き	きりぬき	kirinuki
繰り出す	くりだす	kuridasu
騒がせる	さわがせる	sawagaseru
鳴り響く	なりひびく	narihibiku
突き出し	つきだし	tsukidashi
瞬く	しばたく|しばたたく|またたく|まばたく	shibataku|shibatataku|matataku|mabataku
舞い上がる	まいあがる	maiagaru
盗み	ぬすみ	nusumi
組み込み	くみこみ	kumikomi
差し替え	さしかえ	sashikae
突き刺さる	つきささる	tsukisasaru
出遅れ	でおくれ|でおくれれ	deokure|deokurere
浮かれる	うかれる	ukareru
侵す	おかす	okasu
吹き替え	ふきかえ	fukikae
被せる	かぶせる	kabuseru
白髪染め	しらがぞめ	shiragazome
入れ替わり	いれかわり	irekawari
引き抜く	ひきぬく	hikinuku
素泊まり	すどまり	sudomari
弾き語り	ひきがたり	hikigatari
仰向け	あおむけ	aomuke
乾き	かわき|がわき	kawaki|gawaki
描き出す	えがきだす	egakidasu
取扱う	とりあつかう|とりあつこう	toriatsukau|toriatsukou
押し出し	おしだし	oshidashi
噴く	ふく	fuku
惨め	みじめ	mijime
踏み入る	ふみいる	fumiiru
遅ればせながら	おくればせながら	okurebasenagara
恐る恐る	おそるおそる	osoruosoru
吹き飛ぶ	ふきとぶ	fukitobu
投げ込む	なげこむ	nagekomu
稲刈り	いねかり	inekari
遅らせる	おくらせる	okuraseru
詰める	つめる|づめる	tsumeru|dumeru
繰り出し	くりだし	kuridashi
資金繰り	しきんぐり	shikinnguri
襲いかかる	おそいかかる	osoikakaru
切り込む	きりこむ	kirikomu
お座敷	おざしき	ozashiki
引き継ぎ	ひきつぎ	hikitsugi
駆け引き	かけひき	kakehiki
追い越し	おいこし	oikoshi
語り継ぐ	かたりつぐ	kataritsugu
溶ける	とける	tokeru
手遅れ	ておくれ	teokure
繰る	くる|ぐる	kuru|guru
大忙し	おおいそがし	ooisogashi
気遣う	きづかう|きずこう	kidukau|kizukou
振舞う	ふるまう|ふるもう	furumau|furumou
甘酸っぱい	あまずっぱい	amazuppai
冷え込む	ひえこむ	hiekomu
色濃い	いろこい	irokoi
追い込み	おいこみ	oikomi
汗だく	あせだく	asedaku
軒並み	のきなみ	nokinami
読み替える	よみかえる	yomikaeru
冷え込み	ひえこみ	hiekomi
考え込む	かんがえこむ	kanngaekomu
空振り	からぶり	karaburi
執り行う	とりおこなう|とりおこのう	toriokonau|toriokonou
触れ合う	ふれあう|ふれおう	fureau|fureou
着払い	ちゃくばらい	tyakubarai
腐れ	くされ|ぐされ|くたれ	kusare|gusare|kutare
切り離し	きりはなし	kirihanashi
振り切る	ふりきる	furikiru
縁結び	えんむすび	ennmusubi
勝ち越し	かちこし	kachikoshi
頼める	たのめる	tanomeru
詰合せ	つめあわせ	tsumeawase
絡み合う	からみあう|からみおう	karamiau|karamiou
素振り	そぶり|すぶり	soburi|suburi
頼れる	たよれる	tayoreru
執る	とる|どる	toru|doru
端っこ	はしっこ|はじっこ	hashikko|hajikko
下敷き	したじき	shitajiki
振り込める	ふりこめる	furikomeru
坊ちゃん	ぼっちゃん	bottyann
甘やかす	あまやかす	amayakasu
逃げ切る	にげきる	nigekiru
継ぎ	つぎ	tsugi
寝起き	ねおき	neoki
思い描く	おもいえがく	omoiegaku
輝かしい	かがやかしい	kagayakashii
目隠し	めかくし	mekakushi
引き離す	ひきはなす	hikihanasu
震わせる	ふるわせる	furuwaseru
引っ越す	ひっこす	hikkosu
意気込む	いきごむ	ikigomu
寝込む	ねこむ	nekomu
取替える	とりかえる	torikaeru
手触り	てざわり	tezawari
突き抜ける	つきぬける	tsukinukeru
目白押し	めじろおし	mejirooshi
敷き詰める	しきつめる	shikitsumeru
草刈り	くさかり	kusakari
振る舞う	ふるまう|ふるもう	furumau|furumou
叫び声	さけびごえ	sakebigoe
麗しい	うるわしい	uruwashii
称え	となえ|たたえ|かなえ	tonae|tatae|kanae
問い詰める	といつめる	toitsumeru
煮付け	につけ	nitsuke
寝返り	ねがえり	negaeri
弾み	はずみ	hazumi
追い払う	おいはらう|おいはろう	oiharau|oiharou
戒め	いましめ	imashime
振り付け	ふりつけ	furitsuke
撃てる	うてる	uteru
溶く	とく	toku
更かす	ふかす	fukasu
駆け込み	かけこみ	kakekomi
押入る	おしいる	oshiiru
涙す	なみだす	namidasu
彼女ら	かのじょら	kanojora
坊や	ぼうや	bouya
振り分け	ふりわけ	furiwake
染み込む	しみこむ	shimikomu
逃げ込む	にげこむ	nigekomu
見え隠れ	みえかくれ|みえがくれ	miekakure|miegakure
折り畳む	おりたたむ	oritatamu
食いしん坊	くいしんぼう|くいしんぼ	kuishinnbou|kuishinnbo
手描き	てがき	tegaki
送り込む	おくりこむ	okurikomu
乗り継ぐ	のりつぐ	noritsugu
薄切り	うすぎり	usugiri
咲き乱れる	さきみだれる	sakimidareru
浮き上がる	うきあがる	ukiagaru
威張る	いばる|えばる	ibaru|ebaru
心遣い	こころづかい	kokorodukai
突き放す	つきはなす	tsukihanasu
駆け込む	かけこむ	kakekomu
冷や汗	ひやあせ	hiyaase
燃え尽きる	もえつきる	moetsukiru
悩ましい	なやましい	nayamashii
割り込み	わりこみ	warikomi
眠たい	ねむたい|ねぶたい	nemutai|nebutai
鈍る	なまる|にぶる	namaru|niburu
すり抜ける	すりぬける	surinukeru
片っ端	かたっぱし	katappashi
突き刺す	つきさす	tsukisasu
時代遅れ	じだいおくれ	jidaiokure
入れ替える	いれかえる	irekaeru
恥ずかしながら	はずかしながら	hazukashinagara
到る	いたる	itaru
追い抜く	おいぬく	oinuku
盛り沢山	もりだくさん	moridakusann
押し切る	おしきる	oshikiru
仰せ	おおせ	oose
脱がす	ぬがす	nugasu
駆け出し	かけだし	kakedashi
抱き合う	だきあう|だきおう	dakiau|dakiou
鑑みる	かんがみる	kanngamiru
前倒し	まえだおし	maedaoshi
寝ぼけ	ねぼけ	neboke
切り離す	きりはなす	kirihanasu
二の腕	にのうで	ninoude
勝ち抜く	かちぬく	kachinuku
注ぎ込む	そそぎこむ|つぎこむ	sosogikomu|tsugikomu
抱え込む	かかえこむ	kakaekomu
引継ぎ	ひきつぎ	hikitsugi
誇れる	ほこれる	hokoreru
拠る	よる	yoru
煮詰める	につめる	nitsumeru
力尽きる	ちからつきる	chikaratsukiru
攻め込む	せめこむ	semekomu
滴る	したたる	shitataru
添う	そう|ぞう	sou|zou
芽吹く	めぶく	mebuku
絡まる	からまる	karamaru
未払い	みはらい	miharai
押し上げ	おしあげ	oshiage
抜け出せる	ぬけだせる	nukedaseru
受け渡し	うけわたし	ukewatashi
恐く	きょうく|こわく	kyouku|kowaku
吹ける	ふける	fukeru
模様替え	もようがえ	moyougae
踏み切り	ふみきり	fumikiri
中継ぎ	なかつぎ	nakatsugi
ひき逃げ	ひきにげ	hikinige
張り替える	はりかえる	harikaeru
気兼ね	きがね	kigane
押し倒す	おしたおす	oshitaosu
流し込む	ながしこむ	nagashikomu
お陰様	おかげさま	okagesama
持ち越し	もちこし	mochikoshi
濁す	にごす	nigosu
押しかける	おしかける	oshikakeru
生い茂る	おいしげる	oishigeru
付き添い	つきそい	tsukisoi
響かせる	ひびかせる	hibikaseru
握りしめる	にぎりしめる	nigirishimeru
掘り出し物	ほりだしもの	horidashimono
突き上げる	つきあげる	tsukiageru
お辞儀	おじぎ	ojigi
潮干狩り	しおひがり	shiohigari
張替え	はりかえ	harikae
分割払い	ぶんかつばらい	bunnkatsubarai
脱す	だっす	dassu
食い込む	くいこむ	kuikomu
触れ合い	ふれあい	fureai
吹き荒れる	ふきあれる	fukiareru
見越し	みこし	mikoshi
吹き付ける	ふきつける	fukitsukeru
先払い	さきばらい	sakibarai
替り	かわり|がわり	kawari|gawari
乗り遅れ	のりおくれ	noriokure
振り上げる	ふりあげる	furiageru
押さえつける	おさえつける	osaetsukeru
つぎ込む	つぎこむ	tsugikomu
泊める	とめる	tomeru
独り占め	ひとりじめ	hitorijime
引っ込む	ひっこむ	hikkomu
透かし	すかし	sukashi
薄っぺら	うすっぺら	usuppera
突き止める	つきとめる	tsukitomeru
衣替え	ころもがえ	koromogae
ぶち壊す	ぶちこわす	buchikowasu
浮かせる	うかせる	ukaseru
罰する	ばっする	bassuru
場違い	ばちがい	bachigai
押し出す	おしだす	oshidasu
振り払う	ふりはらう|ふりはろう	furiharau|furiharou
見詰める	みつめる	mitsumeru
掘り出し	ほりだし	horidashi
陣取る	じんどる	jinndoru
皆殺し	みなごろし	minagoroshi
却って	かえって	kaette
畳む	たたむ|だたむ	tatamu|datamu
汚す	けがす|よごす	kegasu|yogosu
詰め込み	つめこみ	tsumekomi
光り輝く	ひかりかがやく	hikarikagayaku
渡り鳥	わたりどり	wataridori
朽ちる	くちる	kuchiru
拍子抜け	ひょうしぬけ	hyoushinuke
飛び越える	とびこえる	tobikoeru
寝かす	ねかす	nekasu
掘り起こし	ほりおこし	horiokoshi
焼き芋	やきいも	yakiimo
獲る	える|とる|どる|うる	eru|toru|doru|uru
遣う	つかう|づかう|つこう	tsukau|dukau|tsukou
扱える	あつかえる	atsukaeru
折り込み	おりこみ	orikomi
寂れる	さびれる	sabireru
屈し	くっし	kusshi
足踏み	あしぶみ|あしふみ	ashibumi|ashifumi
ぶち込む	ぶちこむ	buchikomu
付け替える	つけかえる	tsukekaeru
冒す	おかす	okasu
切り抜ける	きりぬける	kirinukeru
詰め寄る	つめよる	tsumeyoru
汗ばむ	あせばむ	asebamu
更ける	ふける	fukeru
突き当たる	つきあたる	tsukiataru
渡せる	わたせる	wataseru
繰り上げる	くりあげる	kuriageru
泣き叫ぶ	なきさけぶ	nakisakebu
振りかぶる	ふりかぶる	furikaburu
抜き出す	ぬきだす	nukidasu
行き渡る	いきわたる|ゆきわたる	ikiwataru|yukiwataru
押さえ込む	おさえこむ	osaekomu
跳ね上がる	はねあがる	haneagaru
踏み台	ふみだい	fumidai
踏みにじる	ふみにじる	fuminijiru
致し方	いたしかた	itashikata
差し込み	さしこみ	sashikomi
売り込み	うりこみ	urikomi
差し押さえ	さしおさえ	sashiosae
伺える	うかがえる	ukagaeru
甘んじる	あまんじる	amannjiru
甘えん坊	あまえんぼう|あまえんぼ	amaennbou|amaennbo
堅苦しい	かたくるしい	katakurushii
駆け足	かけあし	kakeashi
替え歌	かえうた	kaeuta
駆け回る	かけまわる	kakemawaru
追い越す	おいこす	oikosu
突き落とす	つきおとす	tsukiotosu
逃げ回る	にげまわる	nigemawaru
押し花	おしばな	oshibana
お召	おめし	omeshi
噴き出す	ふきだす	fukidasu
仕舞い	しまい|じまい	shimai|jimai
甘える	あまえる	amaeru
組込み	くみこみ	kumikomi
着替える	きがえる|きかえる	kigaeru|kikaeru
連れ込む	つれこむ	tsurekomu
立ち尽くす	たちつくす	tachitsukusu
言い渡す	いいわたす	iiwatasu
澄ます	すます	sumasu
走り抜ける	はしりぬける	hashirinukeru
突き出る	つきでる	tsukideru
詰め替える	つめかえる	tsumekaeru
付き添う	つきそう	tsukisou
較べる	くらべる	kuraberu
踏みつける	ふみつける	fumitsukeru
床の間	とこのま	tokonoma
瞬き	まばたき|しばたき|しばたたき|またたき	mabataki|shibataki|shibatataki|matataki
取り込める	とりこめる	torikomeru
尽す	つくす|づくす	tsukusu|dukusu
抗う	あらがう|あらごう	aragau|aragou
振り子	ふりこ	furiko
舞い降りる	まいおりる	maioriru
行き詰まる	いきづまる|ゆきづまる|いきつまる	ikidumaru|yukidumaru|ikitsumaru
押しつぶす	おしつぶす	oshitsubusu
馬刺し	ばさし	basashi
添い寝	そいね	soine
突っ張る	つっぱる	tsupparu
煮える	にえる	nieru
決め込む	きめこむ	kimekomu
振りまく	ふりまく	furimaku
振り替え	ふりかえ	furikae
突き詰める	つきつめる	tsukitsumeru
すり替え	すりかえ	surikae
駆け付ける	かけつける	kaketsukeru
言い渡し	いいわたし	iiwatashi
寝転がる	ねころがる	nekorogaru
引き渡す	ひきわたす	hikiwatasu
奥の院	おくのいん	okunoinn
汚れる	けがれる|よごれる	kegareru|yogoreru
詰る	つまる|なじる|づまる	tsumaru|najiru|dumaru
鬼ごっこ	おにごっこ	onigokko
茂み	しげみ	shigemi
飛び跳ねる	とびはねる	tobihaneru
寝そべる	ねそべる	nesoberu
振りかざす	ふりかざす	furikazasu
脱げる	ぬげる	nugeru
仕舞う	しまう|じまう|しもう|じもう	shimau|jimau|shimou|jimou
狭める	せばめる	sebameru
浸ける	つける	tsukeru
運び込む	はこびこむ	hakobikomu
慎む	つつしむ	tsutsushimu
取り壊す	とりこわす	torikowasu
不払い	ふばらい	fubarai
涙ぐむ	なみだぐむ	namidagumu
回り込む	まわりこむ	mawarikomu
遣わす	つかわす	tsukawasu
寝転ぶ	ねころぶ	nekorobu
取り壊し	とりこわし	torikowashi
趣き	おもむき	omomuki
押し目	おしめ	oshime
刈り取る	かりとる	karitoru
秀でる	ひいでる	hiideru
橋渡し	はしわたし	hashiwatashi
着込む	きこむ	kikomu
尽く	ことごとく	kotogotoku
植え込み	うえこみ	uekomi
為る	なる|する	naru|suru
神隠し	かみがくし|かみかくし	kamigakushi|kamikakushi
一般に	いっぱんに	ippannni
落とし込む	おとしこむ	otoshikomu
引っ込める	ひっこめる	hikkomeru
尽くせる	つくせる	tsukuseru
泊る	とまる	tomaru
引き抜き	ひきぬき	hikinuki
抱き上げる	だきあげる	dakiageru
奥さま	おくさま	okusama
兼ね合い	かねあい	kaneai
座り込み	すわりこみ	suwarikomi
捕える	とらえる	toraeru
脱ぎ捨てる	ぬぎすてる	nugisuteru
突っ	つっ	tsuxtu
刺しゅう	ししゅう	shishuu
誇らしい	ほこらしい	hokorashii
手堅い	てがたい	tegatai
下っ端	したっぱ	shitappa
誇らしげ	ほこらしげ	hokorashige
切替える	きりかえる	kirikaeru
研ぎ澄ます	とぎすます	togisumasu
跳ね返す	はねかえす	hanekaesu
ぎっくり腰	ぎっくりごし	gikkurigoshi
割り振る	わりふる	warifuru
押え	おさえ	osae
渡り歩く	わたりあるく	watariaruku
売り込む	うりこむ	urikomu
踏み入れる	ふみいれる	fumiireru
見違える	みちがえる	michigaeru
跳ねる	はねる	haneru
迎え入れ	むかえいれ	mukaeire
込み上げる	こみあげる	komiageru
摘み取る	つみとる|つまみとる	tsumitoru|tsumamitoru
押しつける	おしつける	oshitsukeru
迎え撃つ	むかえうつ	mukaeutsu
逃げ場	にげば	nigeba
抜け道	ぬけみち	nukemichi
身振り	みぶり	miburi
抜き取る	ぬきとる	nukitoru
巻き添え	まきぞえ	makizoe
知れ渡る	しれわたる	shirewataru
取り押さえる	とりおさえる	toriosaeru
振り出し	ふりだし	furidashi
大詰め	おおづめ	oodume
前触れ	まえぶれ	maebure
恐らくは	おそらくは	osorakuha
歓び	よろこび	yorokobi
巡り会う	めぐりあう|めぐりおう	meguriau|meguriou
はめ込む	はめこむ	hamekomu
恥づ	はづ	hadu
遅くとも	おそくとも	osokutomo
雄叫び	おたけび	otakebi
踊れる	おどれる	odoreru
泣き寝入り	なきねいり	nakineiri
面倒い	めんどうい	menndoui
踏み込み	ふみこみ	fumikomi
使い込む	つかいこむ	tsukaikomu
寝取る	ねとる	netoru
刻み込む	きざみこむ	kizamikomu
煮詰まる	につまる	nitsumaru
積み込み	つみこみ	tsumikomi
捕らわれる	とらわれる	torawareru
夜逃げ	よにげ	yonige
持ち込める	もちこめる	mochikomeru
さつま芋	さつまいも	satsumaimo
後ろ髪	うしろがみ	ushirogami
突き飛ばす	つきとばす	tsukitobasu
御存じ	ごぞんじ	gozonnji
突き破る	つきやぶる	tsukiyaburu
枯らす	からす	karasu
見透かす	みすかす	misukasu
濃いめ	こいめ	koime
二の舞	にのまい	ninomai
荒ぶ	すさぶ|こうぶ	susabu|koubu
踏みしめる	ふみしめる	fumishimeru
坊っちゃん	ぼっちゃん	bottyann
身の丈	みのたけ	minotake
積み込む	つみこむ	tsumikomu
思い悩む	おもいなやむ	omoinayamu
張り巡らす	はりめぐらす	harimegurasu
書き添える	かきそえる	kakisoeru
織り込む	おりこむ	orikomu
踏める	ふめる	fumeru
見劣り	みおとり	miotori
支払える	しはらえる	shiharaeru
組み替え	くみかえ	kumikae
手振り	てぶり	teburi
買い占め	かいしめ	kaishime
飲み込み	のみこみ	nomikomi
煮立つ	にたつ	nitatsu
浮き出る	うきでる	ukideru
称える	たたえる|となえる	tataeru|tonaeru
信じ込む	しんじこむ	shinnjikomu
浮かす	うかす	ukasu
押し入れ	おしいれ	oshiire
逃げ道	にげみち	nigemichi
立ち込める	たちこめる	tachikomeru
首飾り	くびかざり	kubikazari
押し込み	おしこみ	oshikomi
吹っ切る	ふっきる	fukkiru
奇しくも	くしくも	kushikumo
張り詰める	はりつめる	haritsumeru
拠り所	よりどころ	yoridokoro
話し込む	はなしこむ	hanashikomu
繰返し	くりかえし	kurikaeshi
倒れ込む	たおれこむ	taorekomu
吹きかける	ふきかける	fukikakeru
抜け出る	ぬけでる	nukederu
手違い	てちがい	techigai
撃ち込む	うちこむ	uchikomu
押し込める	おしこめる	oshikomeru
飾り付ける	かざりつける	kazaritsukeru
絡みつく	からみつく	karamitsuku
寝付ける	ねつける	netsukeru
煙る	けむる|けぶる	kemuru|keburu
隣り合わせる	となりあわせる	tonariawaseru
被ばく	ひばく	hibaku
踊り場	おどりば	odoriba
寝苦しい	ねぐるしい	negurushii
怒れる	おこれる	okoreru
お節介	おせっかい	osekkai
言い逃れる	いいのがれる	iinogareru
着飾る	きかざる	kikazaru
取り払う	とりはらう|とりはろう	toriharau|toriharou
気違い	きちがい	kichigai
持ち替える	もちかえる	mochikaeru
刈り取り	かりとり	karitori
継ぎ目	つぎめ	tsugime
肩代わり	かたがわり	katagawari
小振り	こぶり	koburi
駆り立てる	かりたてる	karitateru
幾重にも	いくえにも	ikuenimo
行き詰まり	いきづまり|ゆきづまり|いきつまり	ikidumari|yukidumari|ikitsumari
縄跳び	なわとび	nawatobi
送り迎え	おくりむかえ	okurimukae
踏み出せる	ふみだせる	fumidaseru
踏み外す	ふみはずす	fumihazusu
山越え	やまごえ	yamagoe
入り浸る	いりびたる	iribitaru
うたた寝	うたたね	utatane
被さる	かぶさる	kabusaru
奥まる	おくまる	okumaru
しみ込む	しみこむ	shimikomu
輝ける	かがやける	kagayakeru
売り払う	うりはらう|うりはろう	uriharau|uriharou
抱ける	いだける|だける	idakeru|dakeru
寝過ごす	ねすごす	nesugosu
胴上げ	どうあげ	douage
段違い	だんちがい	dannchigai
荒っぽい	あらっぽい	arappoi
押しのける	おしのける	oshinokeru
払える	はらえる|ぱらえる	haraeru|paraeru
狭まる	せばまる	sebamaru
住み込み	すみこみ	sumikomi
引きずり込む	ひきずりこむ	hikizurikomu
押し入る	おしいる	oshiiru
寂しげ	さびしげ	sabishige
守り抜く	まもりぬく	mamorinuku
恥じらう	はじらう	hajirau
切り抜く	きりぬく	kirinuku
浮ぶ	うかぶ	ukabu
舌触り	したざわり	shitazawari
甘ったるい	あまったるい	amattarui
替え玉	かえだま	kaedama
くぐり抜ける	くぐりぬける	kugurinukeru
振り向ける	ふりむける	furimukeru
紅葉狩り	もみじがり	momijigari
澄み切る	すみきる	sumikiru
涙する	なみだする	namidasuru
取り柄	とりえ	torie
縁遠い	えんどおい	enndooi
上目遣い	うわめづかい	uwamedukai
お巡りさん	おまわりさん	omawarisann
含み損	ふくみそん|ふくみぞん	fukumisonn|fukumizonn
凡そ	およそ	oyoso
食い違い	くいちがい	kuichigai
掘り返す	ほりかえす	horikaesu
恥知らず	はじしらず	hajishirazu
突き出す	つきだす	tsukidasu
隠し持つ	かくしもつ	kakushimotsu
引っこ抜く	ひっこぬく	hikkonuku
晴れ渡る	はれわたる	harewataru
刈り込む	かりこむ	karikomu
素泊り	すどまり	sudomari
ずば抜ける	ずばぬける	zubanukeru
寝入る	ねいる	neiru
吹き出物	ふきでもの	fukidemono
寝返る	ねがえる	negaeru
木枯らし	こがらし	kogarashi
食い違う	くいちがう|くいちごう	kuichigau|kuichigou
払込む	はらいこむ	haraikomu
思い違い	おもいちがい	omoichigai
刷り込む	すりこむ	surikomu
聞き込む	ききこむ	kikikomu
身震い	みぶるい	miburui
取り違え	とりちがえ	torichigae
込み合う	こみあう|こみおう	komiau|komiou
突き立てる	つきたてる	tsukitateru
脂っこい	あぶらっこい|やにっこい	aburakkoi|yanikkoi
早咲き	はやざき	hayazaki
振舞い	ふるまい|ぶるまい	furumai|burumai
お飾り	おかざり	okazari
跳ね返る	はねかえる	hanekaeru
骨抜き	ほねぬき	honenuki
肉離れ	にくばなれ	nikubanare
怒り狂う	いかりくるう	ikarikuruu
吹き出る	ふきでる	fukideru
立て替える	たてかえる	tatekaeru
筋違い	すじちがい	sujichigai
突き付ける	つきつける	tsukitsukeru
鋭さ	するどさ	surudosa
騒ぎ立てる	さわぎたてる	sawagitateru
力添え	ちからぞえ	chikarazoe
ねじ込む	ねじこむ	nejikomu
差押え	さしおさえ	sashiosae
誉れ	ほまれ	homare
巡らす	めぐらす	megurasu
陣取り	じんとり|じんどり	jinntori|jinndori
押し通す	おしとおす	oshitoosu
切れ端	きれはし	kirehashi
箱詰め	はこづめ	hakodume
織り込み	おりこみ	orikomi
怒鳴りつける	どなりつける	donaritsukeru
明け渡し	あけわたし	akewatashi
引き替える	ひきかえる	hikikaeru
掘り起こす	ほりおこす	horiokosu
惑う	まどう	madou
じゃが芋	じゃがいも	jagaimo
仮名遣い	かなづかい	kanadukai
踏み倒す	ふみたおす	fumitaosu
送り込み	おくりこみ	okurikomi
跡継ぎ	あとつぎ	atotsugi
躍り出る	おどりでる	odorideru
行き詰る	いきづまる|ゆきづまる	ikidumaru|yukidumaru
押し売り	おしうり	oshiuri
枯れ葉	かれは	kareha
めり込む	めりこむ	merikomu
お陰さま	おかげさま	okagesama
寄越す	よこす	yokosu
水浸し	みずびたし	mizubitashi
陰ながら	かげながら	kagenagara
耐え難い	たえがたい	taegatai
溶け合う	とけあう|とけおう	tokeau|tokeou
桃の節句	もものせっく	momonosekku
お祭り騒ぎ	おまつりさわぎ	omatsurisawagi
踏みとどまる	ふみとどまる	fumitodomaru
枯れ木	かれき	kareki
勝ち誇る	かちほこる	kachihokoru
腕組み	うでぐみ	udegumi
押し上げる	おしあげる	oshiageru
息遣い	いきづかい	ikidukai
ごり押し	ごりおし	gorioshi
読み込める	よみこめる	yomikomeru
申し込める	もうしこめる	moushikomeru
夜更け	よふけ	yofuke
壊せる	こわせる	kowaseru
隠ぺい	いんぺい	innpei
慎み	つつしみ	tsutsushimi
頼み込む	たのみこむ	tanomikomu
手押し	ておし	teoshi
吹き返す	ふきかえす	fukikaesu
闘える	たたかえる	tatakaeru
振りかけ	ふりかけ	furikake
鳥刺し	とりさし	torisashi
抜き取り	ぬきとり	nukitori
初っ端	しょっぱな	shoppana
なぎ倒す	なぎたおす	nagitaosu
考え抜く	かんがえぬく	kanngaenuku
のぞき込む	のぞきこむ	nozokikomu
焼き払う	やきはらう|やきはろう	yakiharau|yakiharou
甘ったれる	あまったれる	amattareru
朽ち果てる	くちはてる	kuchihateru
奥ゆかしい	おくゆかしい	okuyukashii
寝かしつける	ねかしつける	nekashitsukeru
恥さらし	はじさらし	hajisarashi
食い倒れ	くいだおれ	kuidaore
持込む	もちこむ	mochikomu
吹き抜ける	ふきぬける	fukinukeru
射抜く	いぬく	inuku
遅咲き	おそざき	osozaki
切り詰める	きりつめる	kiritsumeru
入り込める	はいりこめる	hairikomeru
なだれ込む	なだれこむ	nadarekomu
抜き差し	ぬきさし	nukisashi
逃げ帰る	にげかえる	nigekaeru
端折る	はしょる|はしおる	hashoru|hashioru
繁る	しげる	shigeru
跡取り	あととり	atotori
飾りつける	かざりつける	kazaritsukeru
吹雪く	ふぶく	fubuku
荒れ果てる	あれはてる	arehateru
屈する	くっする	kussuru
囲い込み	かこいこみ	kakoikomi
荒れ狂う	あれくるう	arekuruu
出尽くす	でつくす	detsukusu
突っ込める	つっこめる	tsukkomeru
床ずれ	とこずれ	tokozure
門前払い	もんぜんばらい	monnzennbarai
負け越す	まけこす	makekosu
勝ち抜き	かちぬき	kachinuki
幾らか	いくらか	ikuraka
大振り	おおぶり	ooburi
屈む	かがむ|こごむ	kagamu|kogomu
のめり込む	のめりこむ	nomerikomu
上げ幅	あげはば	agehaba
薄まる	うすまる	usumaru
脱する	だっする	dassuru
巡り合う	めぐりあう|めぐりおう	meguriau|meguriou
吹かす	ふかす	fukasu
生え抜き	はえぬき	haenuki
お互い様	おたがいさま	otagaisama
薄汚い	うすぎたない	usugitanai
払い下げ	はらいさげ	haraisage
打ち込める	うちこめる|ぶちこめる	uchikomeru|buchikomeru
霧吹き	きりふき	kirifuki
押し返す	おしかえす	oshikaesu
居抜き	いぬき	inuki
手仕舞い	てじまい	tejimai
切り離せる	きりはなせる	kirihanaseru
狂おしい	くるおしい	kuruoshii
突っ切る	つっきる	tsukkiru
離れ離れ	はなればなれ	hanarebanare
嘆かわしい	なげかわしい	nagekawashii
人違い	ひとちがい	hitochigai
蓄える	たくわえる	takuwaeru
神頼み	かみだのみ	kamidanomi
底抜け	そこぬけ	sokonuke
駆け落ち	かけおち	kakeochi
焼け跡	やけあと	yakeato
烈しい	はげしい	hageshii
分け与える	わけあたえる	wakeataeru
吐ける	はける	hakeru
持ち越す	もちこす	mochikosu
切り倒す	きりたおす	kiritaosu
騒ぎ出す	さわぎだす	sawagidasu
詰めかける	つめかける	tsumekakeru
切羽詰る	せっぱつまる	seppatsumaru
切れ込み	きれこみ	kirekomi
仰け反る	のけぞる	nokezoru
繰上げる	くりあげる	kuriageru
世渡り	よわたり	yowatari
汚らしい	きたならしい	kitanarashii
潮吹き	しおふき	shiofuki
八重咲き	やえざき	yaezaki
肩入れ	かたいれ	kataire
丸刈り	まるがり	marugari
くり抜く	くりぬく	kurinuku
物珍しい	ものめずらしい	monomezurashii
水溶き	みずとき	mizutoki
小汚い	こぎたない	kogitanai
割り振り	わりふり	warifuri
腰抜け	こしぬけ	koshinuke
飲み込める	のみこめる	nomikomeru
詰む	つむ	tsumu
買い込み	かいこみ	kaikomi
抜き打ち	ぬきうち	nukiuchi
刺し身	さしみ	sashimi
恵む	めぐむ	megumu
床や	とこや	tokoya
振り落とす	ふりおとす	furiotosu
腰かけ	こしかけ	koshikake
恐がる	こわがる	kowagaru
当て逃げ	あてにげ	atenige
共倒れ	ともだおれ	tomodaore
薄らぐ	うすらぐ	usuragu
駆り出す	かりだす	karidasu
理屈っぽい	りくつっぽい	rikutsuppoi
敷き布団	しきぶとん	shikibutonn
隠し事	かくしごと	kakushigoto
底堅い	そこがたい	sokogatai
跳べる	とべる	toberu
響きわたる	ひびきわたる	hibikiwataru
座り込む	すわりこむ	suwarikomu
飛び抜ける	とびぬける	tobinukeru
繁い	しげい	shigei
振れる	ふれる	fureru
掘り出す	ほりだす	horidasu
煮立てる	にたてる	nitateru
叫べる	さけべる	sakeberu
陰干し	かげぼし	kageboshi
編み込む	あみこむ	amikomu
浮き沈み	うきしずみ	ukishizumi
抱き合わせる	だきあわせる	dakiawaseru
与する	くみする	kumisuru
押し流す	おしながす	oshinagasu
差し迫る	さしせまる	sashisemaru
撃ち殺す	うちころす	uchikorosu
盗み出す	ぬすみだす	nusumidasu
陰り	かげり	kageri
咲かす	さかす	sakasu
詰み	つみ	tsumi
我慢強い	がまんづよい	gamannduyoi
網焼き	あみやき	amiyaki
渡り合う	わたりあう|わたりおう	watariau|watariou
買い越す	かいこす	kaikosu
迎え入れる	むかえいれる	mukaeireru
染み抜き	しみぬき	shiminuki
肩透かし	かたすかし	katasukashi
戯れ言	ざれごと	zaregoto
麦わら帽子	むぎわらぼうし	mugiwaraboushi
突っつく	つっつく	tsuttsuku
つけ込む	つけこむ	tsukekomu
飾り物	かざりもの	kazarimono
照れ隠し	てれかくし	terekakushi
皆んな	みんな	minnna
乾す	ほす|ぼす	hosu|bosu
ずれ込む	ずれこむ	zurekomu
小躍り	こおどり	koodori
隠し子	かくしご	kakushigo
逃げ惑う	にげまどう	nigemadou
見遣る	みやる	miyaru
踏み込める	ふみこめる	fumikomeru
矢継ぎ早	やつぎばや	yatsugibaya
張り込み	はりこみ	harikomi
現実離れ	げんじつばなれ	gennjitsubanare
三途の川	さんずのかわ	sannzunokawa
猛然と	もうぜんと	mouzennto
胸騒ぎ	むなさわぎ	munasawagi
物狂い	ものぐるい	monogurui
寝静まる	ねしずまる	neshizumaru
出し抜く	だしぬく	dashinuku
土踏まず	つちふまず	tsuchifumazu
返り咲き	かえりざき|かえりさき	kaerizaki|kaerisaki
突っかかる	つっかかる	tsukkakaru
染み渡る	しみわたる	shimiwataru
与る	あずかる	azukaru
互に	かたみに	katamini
小突く	こづく	koduku
息継ぎ	いきつぎ	ikitsugi
黙り	だんまり|だまり	dannmari|damari
舞い込む	まいこむ	maikomu
震え上がる	ふるえあがる	furueagaru
出迎える	でむかえる	demukaeru
切羽詰まる	せっぱつまる	seppatsumaru
狂わす	くるわす	kuruwasu
遅まきながら	おそまきながら	osomakinagara
踏ん切り	ふんぎり	funngiri
狩り場	かりば	kariba
包み隠す	つつみかくす	tsutsumikakusu
付け込む	つけこむ	tsukekomu
恐れ多い	おそれおおい|おそれおうい	osoreooi|osoreoui
飾れる	かざれる	kazareru
しみ抜き	しみぬき	shiminuki
吹替え	ふきかえ	fukikae
押し下げる	おしさげる	oshisageru
慎ましい	つつましい	tsutsumashii
端くれ	はしくれ	hashikure
払い込み	はらいこみ	haraikomi
御の字	おんのじ	onnnoji
駆け出す	かけだす	kakedasu
盗み見	ぬすみみ	nusumimi
丸め込む	まるめこむ	marumekomu
撃ちまくる	うちまくる	uchimakuru
雄しべ	おしべ	oshibe
乗り遅れる	のりおくれる	noriokureru
継ぎ足し	つぎたし	tsugitashi
ため込む	ためこむ	tamekomu
売り渡し	うりわたし	uriwatashi
持ち逃げ	もちにげ	mochinige
打ち抜く	うちぬく|ぶちぬく	uchinuku|buchinuku
大盤振る舞い	おおばんぶるまい	oobannburumai
返り咲く	かえりざく|かえりさく	kaerizaku|kaerisaku
澄み渡る	すみわたる	sumiwataru
お門違い	おかどちがい	okadochigai
抜かる	ぬかる	nukaru
走り込み	はしりこみ	hashirikomi
吹き上げ	ふきあげ	fukiage
はめ込み	はめこみ	hamekomi
連れ添う	つれそう	tsuresou
手繰り	てぐり|たぐり|たくり	teguri|taguri|takuri
迷い込む	まよいこむ	mayoikomu
寝付く	ねつく	netsuku
入替え	いれかえ	irekae
涙ぐましい	なみだぐましい	namidagumashii
腐れ縁	くされえん	kusareenn
撃ち抜く	うちぬく	uchinuku
買い替える	かいかえる	kaikaeru
人込み	ひとごみ	hitogomi
浮き立つ	うきたつ	ukitatsu
含み益	ふくみえき	fukumieki
段飾り	だんかざり	dannkazari
お抱え	おかかえ	okakae
捕われる	とらわれる	torawareru
食い荒らす	くいあらす	kuiarasu
執念深い	しゅうねんぶかい	shuunennbukai
持ち腐れ	もちぐされ	mochigusare
明け渡す	あけわたす	akewatasu
抜きん出る	ぬきんでる	nukinnderu
吹抜け	ふきぬけ	fukinuke
寝ころぶ	ねころぶ	nekorobu
玉突き	たまつき	tamatsuki
押し黙る	おしだまる	oshidamaru
薪割り	まきわり	makiwari
繰り越し	くりこし	kurikoshi
引っ込み	ひっこみ	hikkomi
凡て	すべて	subete
ごった煮	ごったに	gottani
肩越し	かたごし	katagoshi
地響き	じひびき	jihibiki
縁切り	えんきり	ennkiri
薄気味悪い	うすきみわるい	usukimiwarui
腕立て	うでたて|うでだて	udetate|udedate
煮つける	につける	nitsukeru
一眠り	ひとねむり	hitonemuri
握りつぶす	にぎりつぶす	nigiritsubusu
世継ぎ	よつぎ	yotsugi
抜け穴	ぬけあな	nukeana
跳び箱	とびばこ	tobibako
寝違える	ねちがえる	nechigaeru
抗する	こうする	kousuru
撃ち合う	うちあう|うちおう	uchiau|uchiou
押し付けがましい	おしつけがましい	oshitsukegamashii
触れ込み	ふれこみ	furekomi
戒める	いましめる	imashimeru
屈める	かがめる|こごめる	kagameru|kogomeru
吹きすさぶ	ふきすさぶ	fukisusabu
屈す	くっす	kussu
聞き及ぶ	ききおよぶ	kikioyobu
絡み付く	からみつく	karamitsuku
浮べる	うかべる	ukaberu
触れあう	ふれあう	fureau
攻め立てる	せめたてる	semetateru
謡う	うたう|うとう	utau|utou
行き違い	いきちがい|ゆきちがい	ikichigai|yukichigai
踏んづける	ふんづける	funndukeru
渡れる	わたれる	watareru
払い込む	はらいこむ	haraikomu
飾り気	かざりけ	kazarike
引っ込み思案	ひっこみじあん	hikkomijiann
立て込む	たてこむ	tatekomu
澄みきる	すみきる	sumikiru
毛抜き	けぬき	kenuki
押し進める	おしすすめる	oshisusumeru
黙す	もだす|もくす	modasu|mokusu
召使い	めしつかい	meshitsukai
枯れ草	かれくさ	karekusa
寝泊り	ねとまり	netomari
忙しない	せわしない	sewashinai
立ち枯れ	たちがれ	tachigare
仰せつかる	おおせつかる	oosetsukaru
騒然と	そうぜんと	souzennto
汚らわしい	けがらわしい	kegarawashii
突っぱねる	つっぱねる	tsuppaneru
刺し子	さしこ	sashiko
とけ込む	とけこむ	tokekomu
人恋しい	ひとこいしい	hitokoishii
柔かい	やわらかい	yawarakai
刺し殺す	さしころす	sashikorosu
植え込む	うえこむ	uekomu
口汚い	くちぎたない	kuchigitanai
尾びれ	おびれ	obire
射し込む	さしこむ	sashikomu
込み入る	こみいる	komiiru
耐え抜く	たえぬく	taenuku
御祝い	おいわい	oiwai
騒げる	さわげる	sawageru
ねじ込み	ねじこみ	nejikomi
恐れながら	おそれながら	osorenagara
食い逃げ	くいにげ	kuinige
抜け目	ぬけめ	nukeme
打ち倒す	うちたおす	uchitaosu
張り巡らせる	はりめぐらせる	harimeguraseru
番狂わせ	ばんくるわせ	bannkuruwase
耐えがたい	たえがたい	taegatai
売り渡す	うりわたす	uriwatasu
突き合わせる	つきあわせる	tsukiawaseru
堅め	かため	katame
載っける	のっける	nokkeru
利き腕	ききうで	kikiude
買い与える	かいあたえる	kaiataeru
弾き返す	はじきかえす	hajikikaesu
繰り下げる	くりさげる	kurisageru
仰げる	あおげる	aogeru
払わす	はらわす	harawasu
不渡り	ふわたり	fuwatari
振り分ける	ふりわける	furiwakeru
寝込み	ねこみ	nekomi
押出し	おしだし	oshidashi
繰り入れ	くりいれ	kuriire
御座る	ござる	gozaru
逃げ足	にげあし	nigeashi
奥の手	おくのて	okunote
薄曇り	うすぐもり	usugumori
尽かす	つかす|づかす	tsukasu|dukasu
作り替える	つくりかえる	tsukurikaeru
詰め所	つめしょ	tsumesho
枯れ枝	かれえだ	kareeda
歩き疲れる	あるきつかれる	arukitsukareru
刺せる	させる	saseru
張り込む	はりこむ	harikomu
代替え	だいがえ	daigae
思い詰める	おもいつめる	omoitsumeru
払い出し	はらいだし	haraidashi
召しあがる	めしあがる	meshiagaru
押せる	おせる	oseru
冬枯れ	ふゆがれ	fuyugare
取り逃がす	とりにがす|とりのがす	torinigasu|torinogasu
捕れる	とれる|どれる	toreru|doreru
触れ合える	ふれあえる	fureaeru
荒れ地	あれち	arechi
透きとおる	すきとおる	sukitooru
寝泊まり	ねとまり	netomari
隠れ里	かくれざと	kakurezato
上澄み	うわずみ	uwazumi
抱き込む	だきこむ	dakikomu
介する	かいする	kaisuru
押し迫る	おしせまる	oshisemaru
薄焼き	うすやき	usuyaki
項垂れる	うなだれる	unadareru
敷きつめる	しきつめる	shikitsumeru
眠りこける	ねむりこける	nemurikokeru
俗っぽい	ぞくっぽい	zokuppoi
逃げだす	にげだす	nigedasu
寂びる	さびる	sabiru
浮き足立つ	うきあしだつ	ukiashidatsu
代替わり	だいがわり	daigawari
猛る	たける	takeru
木目込み	きめこみ	kimekomi
後継ぎ	あとつぎ	atotsugi
雌しべ	めしべ	meshibe
雲隠れ	くもがくれ	kumogakure
煙たがる	けむたがる	kemutagaru
惨い	むごい	mugoi
罰す	ばっす	bassu
てんてこ舞い	てんてこまい	tenntekomai
助け舟	たすけぶね	tasukebune
遣り取り	やりとり	yaritori
手詰まり	てづまり	tedumari
息詰まる	いきづまる	ikidumaru
たたき込む	たたきこむ	tatakikomu
雄たけび	おたけび	otakebi
手繰る	たぐる|たくる	taguru|takuru
逃げ腰	にげごし	nigegoshi
振り乱す	ふりみだす	furimidasu
殖やす	ふやす	fuyasu
継ぎ手	つぎて	tsugite
踏み絵	ふみえ	fumie
物怖じ	ものおじ	monooji
火渡り	ひわたり	hiwatari
繰り越す	くりこす	kurikosu
被り物	かぶりもの	kaburimono
お太鼓	おたいこ	otaiko
寝付き	ねつき	netsuki
引き払う	ひきはらう|ひきはろう	hikiharau|hikiharou
知恵の輪	ちえのわ	chienowa
押しやる	おしやる	oshiyaru
吹っかける	ふっかける	fukkakeru
腕利き	うできき	udekiki
差し替える	さしかえる	sashikaeru
渡し船	わたしぶね	watashibune
罰当たり	ばちあたり	bachiatari
及び腰	およびごし	oyobigoshi
荒城の月	こうじょうのつき	koujounotsuki
手が込む	てがこむ	tegakomu
扇ぐ	あおぐ	aogu
組み込める	くみこめる	kumikomeru
振りまわす	ふりまわす	furimawasu
ごろ寝	ごろね	gorone
のみ込む	のみこむ	nomikomu
見抜ける	みぬける	minukeru
利払い	りばらい	ribarai
被う	おおう|おうう	oou|ouu
黙り込む	だまりこむ	damarikomu
踏み越える	ふみこえる	fumikoeru
買占め	かいしめ	kaishime
飛び越す	とびこす	tobikosu
受渡し	うけわたし	ukewatashi
理詰め	りづめ	ridume
横倒し	よこだおし	yokodaoshi
突き当り	つきあたり	tsukiatari
背負い込む	しょいこむ|せおいこむ	shoikomu|seoikomu
子離れ	こばなれ	kobanare
継げる	つげる	tsugeru
切れ込む	きれこむ	kirekomu
元払い	もとばらい	motobarai
拓ける	ひらける	hirakeru
四季咲き	しきざき	shikizaki
中押し	ちゅうおし|なかおし	tyuuoshi|nakaoshi
買い込む	かいこむ	kaikomu
切抜き	きりぬき	kirinuki
床しい	ゆかしい	yukashii
握り飯	にぎりめし	nigirimeshi
腕試し	うでだめし	udedameshi
殿さま	とのさま	tonosama
思し召し	おぼしめし	oboshimeshi
薄ら寒い	うすらさむい|うすらさみい	usurasamui|usurasamii
含み笑い	ふくみわらい	fukumiwarai
殖える	ふえる	fueru
離ればなれ	はなればなれ	hanarebanare
空恐ろしい	そらおそろしい	soraosoroshii
慮る	おもんばかる|おもんぱかる	omonnbakaru|omonnpakaru
飛び込める	とびこめる	tobikomeru
逃せる	のがせる	nogaseru
押し合い	おしあい	oshiai
仰が	ぎょうが|あおが	gyouga|aoga
ばい煙	ばいえん	baienn
振りほどく	ふりほどく	furihodoku
攻め落とす	せめおとす	semeotosu
立ち遅れる	たちおくれる	tachiokureru
盗み聞き	ぬすみぎき|ぬすみきき	nusumigiki|nusumikiki
木枯し	こがらし	kogarashi
恋う	こう	kou
煮出し	にだし	nidashi
引き継げる	ひきつげる	hikitsugeru
惑い	まどい	madoi
馬鹿騒ぎ	ばかさわぎ	bakasawagi
木っ端	こっぱ	koppa
弾き出す	はじきだす	hajikidasu
震わす	ふるわす	furuwasu
追っ払う	おっぱらう|おっぱろう	opparau|opparou
荒む	すさむ	susamu
渡し舟	わたしぶね	watashibune
行き倒れ	いきだおれ|ゆきだおれ	ikidaore|yukidaore
逃げ延びる	にげのびる	nigenobiru
泊りがけ	とまりがけ	tomarigake
髪結い	かみゆい	kamiyui
登り詰める	のぼりつめる	noboritsumeru
建て替える	たてかえる	tatekaeru
月払い	つきばらい	tsukibarai
突ける	つける	tsukeru
跳ね返り	はねかえり	hanekaeri
乗り越す	のりこす	norikosu
寝っ転がる	ねっころがる	nekkorogaru
走り幅跳び	はしりはばとび	hashirihabatobi
煙たい	けむたい	kemutai
すり込む	すりこむ	surikomu
前屈み	まえかがみ|まえこごみ	maekagami|maekogomi
入れ込み	いれこみ|いれごみ	irekomi|iregomi
義理堅い	ぎりがたい	girigatai
芋づる	いもづる	imoduru
狭苦しい	せまくるしい	semakurushii
人形遣い	にんぎょうつかい|にんぎょうづかい	ninngyoutsukai|ninngyoudukai
木遣り	きやり	kiyari
御する	ぎょする	gyosuru
組替える	くみかえる	kumikaeru
打込む	うちこむ|ぶちこむ	uchikomu|buchikomu
引込み	ひっこみ|ひきこみ	hikkomi|hikikomi
折畳む	おりたたむ	oritatamu
手荒い	てあらい	tearai
うま煮	うまに	umani
飾り立てる	かざりたてる	kazaritateru
踏みつぶす	ふみつぶす	fumitsubusu
取り払い	とりはらい	toriharai
突込み	つっこみ	tsukkomi
抱き起こす	だきおこす	dakiokosu
末恐ろしい	すえおそろしい	sueosoroshii
浮つく	うわつく	uwatsuku
撃ち落とす	うちおとす	uchiotosu
箱入り娘	はこいりむすめ	hakoirimusume
差込み	さしこみ	sashikomi
意地汚い	いじきたない	ijikitanai
爆ぜる	はぜる	hazeru
見え透く	みえすく	miesuku
知らん振り	しらんぷり	shirannpuri
冷や奴	ひややっこ	hiyayakko
抱きとめる	だきとめる	dakitomeru
腹違い	はらちがい	harachigai
吹き矢	ふきや	fukiya
なぎ払う	なぎはらう|なぎはろう	nagiharau|nagiharou
耳飾り	みみかざり	mimikazari
吹きまくる	ふきまくる	fukimakuru
繰り延べ	くりのべ	kurinobe
入れ知恵	いれぢえ	iredie
追い込める	おいこめる	oikomeru
息吹き	いぶき	ibuki
目抜き通り	めぬきどおり	menukidoori
繰返す	くりかえす	kurikaesu
押しまくる	おしまくる	oshimakuru
幾ばく	いくばく	ikubaku
透す	とおす|すかす|どおす	toosu|sukasu|doosu
寝つける	ねつける	netsukeru
生け捕り	いけどり	ikedori
迎え火	むかえび	mukaebi
押し問答	おしもんどう	oshimonndou
尾根伝い	おねづたい	onedutai
ひと煮立ち	ひとにたち	hitonitachi
入れ違う	いれちがう|いれちごう	irechigau|irechigou
草刈り機	くさかりき	kusakariki
駆けずり回る	かけずりまわる	kakezurimawaru
押しつけがましい	おしつけがましい	oshitsukegamashii
握りこぶし	にぎりこぶし	nigirikobushi
着込み	きこみ	kikomi
引越す	ひっこす	hikkosu
粒ぞろい	つぶぞろい	tsubuzoroi
転がり込む	ころがりこむ	korogarikomu
気狂い	きちがい	kichigai
勝ち越す	かちこす	kachikosu
煮えたぎる	にえたぎる	nietagiru
尾ひれ	おひれ	ohire
謡い	うたい	utai
刈り上げ	かりあげ	kariage
盗める	ぬすめる	nusumeru
狂い咲き	くるいざき	kuruizaki
申し渡す	もうしわたす	moushiwatasu
取り扱える	とりあつかえる	toriatsukaeru
気疲れ	きづかれ	kidukare
羽振り	はぶり	haburi
占える	うらなえる	uranaeru
染め抜く	そめぬく	somenuku
表替え	おもてがえ	omotegae
汗取り	あせとり	asetori
腕まくり	うでまくり	udemakuri
ひた隠し	ひたかくし	hitakakushi
引っ越せる	ひっこせる	hikkoseru
山の端	やまのは	yamanoha
薄笑い	うすわらい	usuwarai
植込み	うえこみ	uekomi
折り込む	おりこむ	orikomu
振替える	ふりかえる	furikaeru
畑違い	はたけちがい	hatakechigai
寝覚め	ねざめ	nezame
出払う	ではらう|ではろう	deharau|deharou
刈り入れる	かりいれる	kariireru
悩みごと	なやみごと	nayamigoto
お触れ	おふれ	ofure
取り越し苦労	とりこしぐろう	torikoshigurou
越せる	こせる	koseru
煙い	けむい|けみい	kemui|kemii
隠し場所	かくしばしょ	kakushibasho
切込み	きりこみ	kirikomi
角刈り	かくがり	kakugari
値踏み	ねぶみ	nebumi
咲きそろう	さきそろう	sakisorou
吹流し	ふきながし	fukinagashi
引き菓子	ひきがし	hikigashi
ふて寝	ふてね	futene
荒くれ	あらくれ	arakure
幾たび	いくたび	ikutabi
つくだ煮	つくだに	tsukudani
へっぴり腰	へっぴりごし	heppirigoshi
端切れ	はぎれ	hagire
特徴付ける	とくちょうづける	tokutyoudukeru
陰る	かげる	kageru
扱き	しごき|こき	shigoki|koki
流れ弾	ながれだま	nagaredama
扱く	こく|しごく	koku|shigoku
組み敷く	くみしく	kumishiku
突き指	つきゆび	tsukiyubi
口溶け	くちどけ	kuchidoke
仲違い	なかたがい	nakatagai
描きだす	えがきだす	egakidasu
水攻め	みずぜめ	mizuzeme
添え物	そえもの	soemono
押さえ付ける	おさえつける	osaetsukeru
割込み	わりこみ	warikomi
跳ね除ける	はねのける	hanenokeru
読替える	よみかえる	yomikaeru
吐き出せる	はきだせる	hakidaseru
露払い	つゆはらい	tsuyuharai
貯め込む	ためこむ	tamekomu
起き抜け	おきぬけ	okinuke
積み替え	つみかえ	tsumikae
逃げ出せる	にげだせる	nigedaseru
やり込める	やりこめる	yarikomeru
吹き上げる	ふきあげる	fukiageru
お偉方	おえらがた	oeragata
恥じ入る	はじいる	hajiiru
握れる	にぎれる	nigireru
離れ業	はなれわざ	hanarewaza
お握り	おにぎり	onigiri
黙とう	もくとう	mokutou
武者震い	むしゃぶるい	mushaburui
互い違い	たがいちがい	tagaichigai
怒らす	いからす	ikarasu
はた迷惑	はためいわく	hatameiwaku
はく離	はくり	hakuri
分捕る	ぶんどる	bunndoru
砲丸投げ	ほうがんなげ	hougannnage
打ち抜き	うちぬき|ぶちぬき	uchinuki|buchinuki
胴回り	どうまわり	doumawari
煮浸し	にびたし	nibitashi
逃げまどう	にげまどう	nigemadou
切り払う	きりはらう|きりはろう	kiriharau|kiriharou
老け込む	ふけこむ	fukekomu
巡ら	じゅんら|めぐら	junnra|megura
煮もの	にもの	nimono
積込む	つみこむ	tsumikomu
住み込む	すみこむ	sumikomu
そろい踏み	そろいぶみ	soroibumi
折り詰め	おりづめ	oridume
眠らす	ねむらす	nemurasu
すし詰め	すしづめ	sushidume
売り抜け	うりぬけ	urinuke
地引き網	じびきあみ	jibikiami
押し開く	おしひらく	oshihiraku
敷ける	しける	shikeru
国替え	くにがえ	kunigae
煮えくり返る	にえくりかえる	niekurikaeru
抜てき	ばってき	batteki
すり替える	すりかえる	surikaeru
走り高跳び	はしりたかとび	hashiritakatobi
お払い箱	おはらいばこ	oharaibako
付添い	つきそい	tsukisoi
渡り合える	わたりあえる	watariaeru
月遅れ	つきおくれ	tsukiokure
脂ぎる	あぶらぎる	aburagiru
寝つく	ねつく	netsuku
押し退ける	おしのける	oshinokeru
尾てい骨	びていこつ	biteikotsu
とんとん拍子	とんとんびょうし	tonntonnbyoushi
掘り進む	ほりすすむ	horisusumu
張り倒す	はりたおす	haritaosu
押える	おさえる	osaeru
草葉の陰	くさばのかげ	kusabanokage
生き恥	いきはじ	ikihaji
吹出す	ふきだす	fukidasu
ひと粒	ひとつぶ	hitotsubu
柔ら	やわら	yawara
渡し場	わたしば	watashiba
踏み抜く	ふみぬく	fuminuku
斜め切り	ななめぎり	nanamegiri
お尋ね者	おたずねもの	otazunemono
組込む	くみこむ	kumikomu
振り替える	ふりかえる	furikaeru
いち押し	いちおし	ichioshi
吹きだす	ふきだす	fukidasu
棒高跳び	ぼうたかとび	boutakatobi
五重の塔	ごじゅうのとう	gojuunotou
浮き出す	うきだす	ukidasu
当て込む	あてこむ	atekomu
踏み付ける	ふみつける	fumitsukeru
突き進める	つきすすめる	tsukisusumeru
黙りこくる	だまりこくる	damarikokuru
すげ替える	すげかえる	sugekaeru
振付け	ふりつけ	furitsuke
抜き放つ	ぬきはなつ	nukihanatsu
隠る	こもる|かくれる|かくる	komoru|kakureru|kakuru
縁る	よる	yoru
召し上げる	めしあげる	meshiageru
引継ぐ	ひきつぐ	hikitsugu
一人占め	ひとりじめ	hitorijime
替る	かわる|かえる	kawaru|kaeru
奴さん	やっこさん	yakkosann
枝振り	えだぶり	edaburi
言い尽くす	いいつくす	iitsukusu
抜け落ちる	ぬけおちる	nukeochiru
生乾き	なまがわき	namagawaki
煮つめる	につめる	nitsumeru
徴する	ちょうする	tyousuru
引抜き	ひきぬき	hikinuki
慎ましやか	つつましやか	tsutsumashiyaka
売払う	うりはらう|うりはろう	uriharau|uriharou
吹きこぼれる	ふきこぼれる	fukikoboreru
紋付き	もんつき	monntsuki
顔触れ	かおぶれ	kaobure
強含み	つよふくみ	tsuyofukumi
詰め込める	つめこめる	tsumekomeru
荒れ野	あれの	areno
針刺し	はりさし	harisashi
荒立てる	あらだてる	aradateru
気忙しい	きぜわしい	kizewashii
抱き着く	だきつく	dakitsuku
言渡す	いいわたす	iiwatasu
乗り込める	のりこめる	norikomeru
況や	いわんや	iwannya
掘れる	ほれる	horeru
お召し物	おめしもの	omeshimono
介添え	かいぞえ	kaizoe
なで肩	なでがた	nadegata
濃い口	こいくち	koikuchi
仕込める	しこめる	shikomeru
山の芋	やまのいも	yamanoimo
上り詰める	のぼりつめる	noboritsumeru
抱きすくめる	だきすくめる	dakisukumeru
人騒がせ	ひとさわがせ	hitosawagase
御参り	おまいり	omairi
ほれ込む	ほれこむ	horekomu
物寂しい	ものさびしい	monosabishii
抜きんでる	ぬきんでる	nukinnderu
思いの丈	おもいのたけ	omoinotake
飛込み	とびこみ	tobikomi
しめ飾り	しめかざり	shimekazari
薄商い	うすあきない	usuakinai
割振り	わりふり	warifuri
払出し	はらいだし	haraidashi
剣が峰	けんがみね	kenngamine
雄雄しい	おおしい	ooshii
踏みこむ	ふみこむ	fumikomu
繰りかえし	くりかえし	kurikaeshi
底引き網	そこびきあみ	sokobikiami
取込み	とりこみ	torikomi
雅やか	みやびやか	miyabiyaka
恥しい	はずかしい	hazukashii
突き返す	つきかえす	tsukikaesu
召上がる	めしあがる	meshiagaru
贈れる	おくれる	okureru
折込み	おりこみ	orikomi
ひっ迫	ひっぱく	hippaku
透き	すき	suki
落ち着き払う	おちつきはらう	ochitsukiharau
舟遊び	ふなあそび	funaasobi
刺殺す	さしころす	sashikorosu
振り出す	ふりだす	furidasu
輝かす	かがやかす	kagayakasu
まき網	まきあみ	makiami
通し狂言	とおしきょうげん	tooshikyougenn
腕っ節	うでっぷし	udeppushi
まかり間違う	まかりまちがう	makarimachigau
貸し倒れ	かしだおれ	kashidaore
浮き草	うきくさ|うきぐさ	ukikusa|ukigusa
曇らせる	くもらせる	kumoraseru
突っこむ	つっこむ	tsukkomu
噴き上げる	ふきあげる	fukiageru
逃げ口上	にげこうじょう	nigekoujou
順繰り	じゅんぐり	junnguri
突きだす	つきだす	tsukidasu
かき込む	かきこむ	kakikomu
盆暮れ	ぼんくれ	bonnkure
振りかける	ふりかける	furikakeru
はき違える	はきちがえる	hakichigaeru
狂言回し	きょうげんまわし	kyougennmawashi
手詰め	てづめ	tedume
畳替え	たたみがえ	tatamigae
すっぱ抜く	すっぱぬく	suppanuku
浮き世	うきよ	ukiyo
咲きほこる	さきほこる	sakihokoru
売り込める	うりこめる	urikomeru
もの珍しい	ものめずらしい	monomezurashii
刺し違える	さしちがえる	sashichigaeru
後腐れ	あとくされ	atokusare
吐きだす	はきだす	hakidasu
やり繰り	やりくり	yarikuri
繰り替える	くりかえる	kurikaeru
目敏い	めざとい	mezatoi
詳らか	つまびらか	tsumabiraka
どんちゃん騒ぎ	どんちゃんさわぎ	donntyannsawagi
攻め寄せる	せめよせる	semeyoseru
敏い	さとい	satoi
巡り合い	めぐりあい	meguriai
泊まり込む	とまりこむ	tomarikomu
打ち払う	うちはらう|うちはろう	uchiharau|uchiharou
下押し	したおし	shitaoshi
尋ね人	たずねびと	tazunebito
泊り込む	とまりこむ	tomarikomu
人払い	ひとばらい	hitobarai
汚れ役	よごれやく	yogoreyaku
買い占める	かいしめる	kaishimeru
繰越す	くりこす	kurikosu
騒がす	さわがす	sawagasu
畳み込む	たたみこむ	tatamikomu
澄みわたる	すみわたる	sumiwataru
おう吐	おうと	outo
口振り	くちぶり	kuchiburi
勢い込む	いきおいこむ	ikioikomu
畳める	たためる	tatameru
読込み	よみこみ	yomikomi
ありがた迷惑	ありがためいわく	arigatameiwaku
透く	すく	suku
盗み食い	ぬすみぐい	nusumigui
取壊す	とりこわす	torikowasu
繰り出せる	くりだせる	kuridaseru
呼び込める	よびこめる	yobikomeru
摘める	つまめる|つめる	tsumameru|tsumeru
焼き豆腐	やきどうふ	yakidoufu
走り込む	はしりこむ	hashirikomu
金遣い	かねづかい	kanedukai
盛り込める	もりこめる	morikomeru
舞いあがる	まいあがる	maiagaru
幅跳び	はばとび	habatobi
吹き流し	ふきながし	fukinagashi
吹き鳴らす	ふきならす	fukinarasu
取り逃す	とりにがす	torinigasu
狂わしい	くるわしい|ぐるわしい	kuruwashii|guruwashii
刈取る	かりとる	karitoru
言い含める	いいふくめる	iifukumeru
出遅れる	でおくれる	deokureru
胴突き	どうづき	douduki
引き抜ける	ひきぬける	hikinukeru
惨たらしい	むごたらしい	mugotarashii
くい込む	くいこむ	kuikomu
食い込める	くいこめる	kuikomeru
駆けだし	かけだし	kakedashi
積替え	つみかえ	tsumikae
せっぱ詰まる	せっぱつまる	seppatsumaru
召し出す	めしだす|めしいだす	meshidasu|meshiidasu
吸込む	すいこむ	suikomu
煮え湯	にえゆ	nieyu
荒らせる	あらせる	araseru
詰めこむ	つめこむ	tsumekomu
貸倒れ	かしだおれ	kashidaore
立替える	たてかえる	tatekaeru
組み替える	くみかえる	kumikaeru
葉隠れ	はがくれ	hagakure
差し押さえる	さしおさえる	sashiosaeru
騒ぎだす	さわぎだす	sawagidasu
振出す	ふりだす	furidasu
溶けだす	とけだす	tokedasu
吹きさらし	ふきさらし	fukisarashi
受継ぐ	うけつぐ	uketsugu
迫れる	せまれる	semareru
売込む	うりこむ	urikomu
気遣わしい	きづかわしい	kidukawashii
添え木	そえぎ	soegi
あか抜ける	あかぬける	akanukeru
巡り会える	めぐりあえる	meguriaeru
押し麦	おしむぎ	oshimugi
踏み止まる	ふみとどまる|ふみとまる	fumitodomaru|fumitomaru
抜けでる	ぬけでる	nukederu
踏み分ける	ふみわける	fumiwakeru
征する	せいする	seisuru
歓ぶ	よろこぶ	yorokobu
遅らす	おくらす	okurasu
空気抜き	くうきぬき	kuukinuki
豪い	えらい	erai
荒くれ者	あらくれもの	arakuremono
怖じる	おじる	ojiru
縁起もの	えんぎもの	enngimono
盛込む	もりこむ	morikomu
突き通す	つきとおす	tsukitoosu
畳みかける	たたみかける	tatamikakeru
盗み見る	ぬすみみる	nusumimiru
振り回せる	ふりまわせる	furimawaseru
送り込める	おくりこめる	okurikomeru
透かす	すかす	sukasu
踏み鳴らす	ふみならす	fuminarasu
くいしん坊	くいしんぼう	kuishinnbou
横抱き	よこだき	yokodaki
踏切る	ふみきる	fumikiru
客扱い	きゃくあつかい	kyakuatsukai
召し上がれる	めしあがれる	meshiagareru
差替え	さしかえ	sashikae
ずれ込み	ずれこみ	zurekomi
振分け	ふりわけ	furiwake
巻き込める	まきこめる	makikomeru
露けい	つゆけい	tsuyukei
走り抜く	はしりぬく	hashirinuku
透る	とおる	tooru
甘ずっぱい	あまずっぱい	amazuppai
掘っ立て	ほったて	hottate
折り畳める	おりたためる	oritatameru
早弾き	はやびき	hayabiki
うつぶせ寝	うつぶせね	utsubusene
腐す	くさす	kusasu
もぐり込む	もぐりこむ	mogurikomu
思い遣り	おもいやり	omoiyari
隠し芸	かくしげい	kakushigei
盆おどり	ぼんおどり	bonnodori
繰入れる	くりいれる	kuriireru
押し隠す	おしかくす	oshikakusu
腰つき	こしつき	koshitsuki
寝冷え	ねびえ	nebie
うら寂しい	うらさびしい	urasabishii
恥い	やさい	yasai
被い	おおい|おうい	ooi|oui
建て込む	たてこむ	tatekomu
払下げ	はらいさげ	haraisage
打ち壊し	うちこわし|ぶちこわし	uchikowashi|buchikowashi
抱えこむ	かかえこむ	kakaekomu
繰り入れる	くりいれる	kuriireru
荒らげる	あらげる|あららげる	arageru|ararageru
払い出す	はらいだす	haraidasu
口添え	くちぞえ	kuchizoe
繁み	しげみ	shigemi
戯け	たわけ|おどけ	tawake|odoke
添え書き	そえがき	soegaki
一巡り	ひとめぐり	hitomeguri
荒す	あらす	arasu
花曇り	はなぐもり	hanagumori
勝ち越せる	かちこせる	kachikoseru
召し抱える	めしかかえる	meshikakaeru
押付ける	おしつける	oshitsukeru
踏みだす	ふみだす	fumidasu
考え違い	かんがえちがい	kanngaechigai
踏み板	ふみいた	fumiita
奥床しい	おくゆかしい	okuyukashii
摘み草	つみくさ	tsumikusa
三段跳び	さんだんとび	sanndanntobi
払しょく	ふっしょく	fusshoku
吹きだまり	ふきだまり	fukidamari
行き違う	いきちがう|ゆきちがう|いきちごう|ゆきちごう	ikichigau|yukichigau|ikichigou|yukichigou
乗込む	のりこむ	norikomu
狩り出す	かりだす	karidasu
突合せる	つきあわせる	tsukiawaseru
浮き浮き	うきうき	ukiuki
心尽くし	こころづくし	kokorodukushi
威し	おどし	odoshi
麗らか	うららか	uraraka
口幅ったい	くちはばったい	kuchihabattai
跳ね橋	はねばし	hanebashi
吹きでる	ふきでる	fukideru
傾ぐ	かしぐ	kashigu
面汚し	つらよごし	tsurayogoshi
継ぎ足す	つぎたす	tsugitasu
腰巻き	こしまき	koshimaki
仰向く	あおむく	aomuku
上がり込む	あがりこむ	agarikomu
押し詰まる	おしつまる	oshitsumaru
入れ替る	いれかわる	irekawaru
差し押える	さしおさえる	sashiosaeru
とじ込み	とじこみ	tojikomi
生き抜ける	いきぬける	ikinukeru
迎い	むかい	mukai
盗っ人	ぬすっと	nusutto
ひとり占め	ひとりじめ	hitorijime
円盤投げ	えんばんなげ	ennbannnage
引込む	ひきこむ|ひっこむ	hikikomu|hikkomu
乗り継げる	のりつげる	noritsugeru
引渡す	ひきわたす	hikiwatasu
怒鳴り込む	どなりこむ	donarikomu
押し絵	おしえ	oshie
腰ひも	こしひも	koshihimo
酒浸り	さけびたり	sakebitari
丸抱え	まるがかえ	marugakae
壊れ物	こわれもの	kowaremono
赤狩り	あかがり	akagari
召抱える	めしかかえる	meshikakaeru
吹き回し	ふきまわし	fukimawashi
けんか腰	けんかごし	kennkagoshi
肩ごし	かたごし	katagoshi
露天掘り	ろてんぼり	rotennbori
雷おこし	かみなりおこし	kaminariokoshi
見兼ねる	みかねる	mikaneru
溶かせる	とかせる	tokaseru
飾り窓	かざりまど	kazarimado
御用納め	ごようおさめ	goyouosame
峰打ち	みねうち	mineuchi
描き直し	かきなおし	kakinaoshi
見離す	みはなす	mihanasu
うす汚い	うすぎたない	usugitanai
寝ずの番	ねずのばん	nezunobann
煮含める	にふくめる	nifukumeru
引き込める	ひきこめる	hikikomeru
図抜ける	ずぬける	zunukeru
久方振り	ひさかたぶり	hisakataburi
威張れる	いばれる	ibareru
薄暗がり	うすくらがり	usukuragari
吹き寄せ	ふきよせ	fukiyose
角隠し	つのかくし	tsunokakushi
持越す	もちこす	mochikosu
朝駆け	あさがけ	asagake
撃ち方	うちかた	uchikata
触れ回る	ふれまわる	furemawaru
はつ恋	はつこい	hatsukoi
もの寂しい	ものさびしい	monosabishii
乳離れ	ちばなれ	chibanare
筆遣い	ふでづかい	fudedukai
払い除ける	はらいのける	harainokeru
繰り込む	くりこむ	kurikomu
割り込める	わりこめる	warikomeru
寝せる	ねせる|ねかせる	neseru|nekaseru
繰下げる	くりさげる	kurisageru
離れ家	はなれや	hanareya
追越す	おいこす	oikosu
巻込む	まきこむ	makikomu
一時払い	いちじばらい	ichijibarai
かい離	かいり	kairi
為さる	なさる	nasaru
煮込める	にこめる	nikomeru
言い替える	いいかえる	iikaeru
注連飾り	しめかざり	shimekazari
打抜き	うちぬき	uchinuki
他生の縁	たしょうのえん	tashounoenn
選り抜き	えりぬき|よりぬき	erinuki|yorinuki
抱きこむ	だきこむ	dakikomu
一抱え	ひとかかえ	hitokakae
繰り言	くりごと	kurigoto
抜き足	ぬきあし	nukiashi
尾頭付き	おかしらつき	okashiratsuki
跳ね返せる	はねかえせる	hanekaeseru
溶きほぐす	ときほぐす	tokihogusu
しり込み	しりごみ	shirigomi
払いもどす	はらいもどす	haraimodosu
中越え	なかこえ	nakakoe
染込む	しみこむ	shimikomu
仰せ付ける	おおせつける	oosetsukeru
お隠れ	おかくれ	okakure
垂れ込む	たれこむ	tarekomu
継ぎ接ぎ	つぎはぎ	tsugihagi
掘り起こせる	ほりおこせる	horiokoseru
脱せる	だっせる|ぬがせる	dasseru|nugaseru
吹き荒ぶ	ふきすさぶ	fukisusabu
隠れみの	かくれみの	kakuremino
普く	あまねく	amaneku
煮上がる	にあがる	niagaru
縁どる	ふちどる	fuchidoru
踏ん張れる	ふんばれる	funnbareru
打ち壊す	うちこわす|ぶちこわす	uchikowasu|buchikowasu
出し抜け	だしぬけ	dashinuke
松飾り	まつかざり	matsukazari
乗越える	のりこえる	norikoeru
生煮え	なまにえ	namanie
手抜かり	てぬかり	tenukari
覚え込む	おぼえこむ	oboekomu
突っ返す	つっかえす	tsukkaesu
形振り	なりふり	narifuri
遅ればせ	おくればせ	okurebase
住込み	すみこみ	sumikomi
煮こみ	にこみ	nikomi
使い途	つかいみち	tsukaimichi
口堅い	くちがたい	kuchigatai
一花咲かせる	ひとはなさかせる	hitohanasakaseru
食い詰める	くいつめる	kuitsumeru
取り違える	とりちがえる	torichigaeru
疲れはてる	つかれはてる	tsukarehateru
薄ぐらい	うすぐらい	usugurai
つっ込む	つっこむ	tsukkomu
渡り初め	わたりぞめ	watarizome
拝み倒す	おがみたおす	ogamitaosu
飛込む	とびこむ	tobikomu
先渡し	さきわたし	sakiwatashi
抱き留める	だきとめる	dakitomeru
川越し	かわごし	kawagoshi
吹き払う	ふきはらう|ふきはろう	fukiharau|fukiharou
薄寒い	うすらさむい|うすらさみい	usurasamui|usurasamii
弾き手	ひきて	hikite
荒荒しい	あらあらしい	araarashii
逃げ込める	にげこめる	nigekomeru
鈍する	どんする	donnsuru
飛び込み台	とびこみだい	tobikomidai
悩み抜く	なやみぬく	nayaminuku
咲き残る	さきのこる	sakinokoru
執り成し	とりなし	torinashi
渡し守	わたしもり	watashimori
吸い込める	すいこめる	suikomeru
荒れ性	あれしょう	areshou
引き渡せる	ひきわたせる	hikiwataseru
振り切れる	ふりきれる	furikireru
知り抜く	しりぬく	shirinuku
でんでん太鼓	でんでんだいこ	denndenndaiko
し烈	しれつ	shiretsu
力抜け	ちからぬけ	chikaranuke
押しきる	おしきる	oshikiru
ふさぎ込む	ふさぎこむ	fusagikomu
逃げ水	にげみず	nigemizu
肩ひじ	かたひじ	katahiji
腰折れ	こしおれ	koshiore
上敷き	うわしき|うわじき	uwashiki|uwajiki
寝殿造り	しんでんづくり	shinndenndukuri
吹き降ろす	ふきおろす	fukiorosu
追込み	おいこみ	oikomi
気恥しい	きはずかしい	kihazukashii
物狂おしい	ものぐるおしい	monoguruoshii
物堅い	ものがたい	monogatai
腐らす	くさらす	kusarasu
末頼もしい	すえたのもしい	suetanomoshii
押し分ける	おしわける	oshiwakeru
腕っぷし	うでっぷし	udeppushi
自慢たらしい	じまんたらしい	jimanntarashii
板敷き	いたじき	itajiki
寝ぐるしい	ねぐるしい	negurushii
すご腕	すごうで	sugoude
つぎ込める	つぎこめる	tsugikomeru
押付けがましい	おしつけがましい	oshitsukegamashii
濃い茶	こいちゃ	koitya
鎖す	とざす|さす	tozasu|sasu
恐れおおい	おそれおおい|おそれおうい	osoreooi|osoreoui
ひと眠り	ひとねむり	hitonemuri
せき込む	せきこむ	sekikomu
甘ちょろい	あまちょろい	amatyoroi
二の舞い	にのまい	ninomai
腰かける	こしかける	koshikakeru
薄ぐろい	うすぐろい	usuguroi
物騒がしい	ものさわがしい	monosawagashii
耐難い	たえがたい	taegatai
薄ぎたない	うすぎたない	usugitanai
攻め上る	せめのぼる	semenoboru
お薄	おうす	ousu
くら替え	くらがえ	kuragae
繰りかえす	くりかえす	kurikaesu
咲きみだれる	さきみだれる	sakimidareru
五つ紋	いつつもん	itsutsumonn
持ち越せる	もちこせる	mochikoseru
引っ繰り返す	ひっくりかえす	hikkurikaesu
もの狂おしい	ものぐるおしい	monoguruoshii
荒あらしい	あらあらしい	araarashii
染め替え	そめかえ	somekae
もの狂い	ものぐるい	monogurui
縁どおい	えんどおい	enndooi
もの恐ろしい	ものおそろしい	monoosoroshii
繰延べる	くりのべる	kurinoberu
騒騒しい	そうぞうしい	souzoushii
押込み	おしこみ	oshikomi
十露盤高い	そろばんだかい	sorobanndakai
鳴り渡る	なりわたる	nariwataru
頼み少ない	たのみすくない	tanomisukunai
頼みこむ	たのみこむ	tanomikomu
先触れ	さきぶれ	sakibure
仰仰しい	ぎょうぎょうしい	gyougyoushii
抜がたい	ぬきがたい	nukigatai
空恥しい	そらはずかしい	sorahazukashii
踏みきる	ふみきる	fumikiru
刺刺しい	とげとげしい	togetogeshii
煮えくりかえる	にえくりかえる	niekurikaeru
算盤高い	そろばんだかい	sorobanndakai
麗麗しい	れいれいしい	reireishii
もの堅い	ものがたい	monogatai
振る舞える	ふるまえる	furumaeru
刺とげしい	とげとげしい	togetogeshii
高飛び込み	たかとびこみ	takatobikomi
浮び上がる	うかびあがる	ukabiagaru
猛猛しい	たけだけしい	takedakeshii
飾りもの	かざりもの	kazarimono
振るえる	ふるえる	furueru
物恐ろしい	ものおそろしい	monoosoroshii
雄おしい	おおしい	ooshii
普い	あまねい	amanei
跡づける	あとづける	atodukeru
枯れすすき	かれすすき	karesusuki
押し負ける	おしまける	oshimakeru
夏枯れ	なつがれ	natsugare
売り抜ける	うりぬける	urinukeru
手りゅう弾	しゅりゅうだん	shuryuudann
継しい	まましい	mamashii
曇らす	くもらす	kumorasu
恐多い	おそれおおい|おそれおうい	osoreooi|osoreoui
押し葉	おしば	oshiba
切り込める	きりこめる	kirikomeru
うら恥しい	うらはずかしい	urahazukashii
薄じろい	うすじろい	usujiroi
駆け込める	かけこめる	kakekomeru
踏み石	ふみいし	fumiishi
隣合わせ	となりあわせ	tonariawase
逃げのびる	にげのびる	nigenobiru
高慢ちき	こうまんちき	koumannchiki
遣える	つかえる	tsukaeru
吐かす	ぬかす	nukasu
店仕舞い	みせじまい	misejimai
仰ぎょうしい	ぎょうぎょうしい	gyougyoushii
待ち兼ねる	まちかねる	machikaneru
吐出す	はきだす|ほきだす	hakidasu|hokidasu
猛だけしい	たけだけしい	takedakeshii
桜ん坊	さくらんぼう|さくらんぼ	sakurannbou|sakurannbo
朽ち木	くちき	kuchiki
乗り逃げ	のりにげ	norinige
離れ島	はなれじま	hanarejima
隣合う	となりあう|となりおう	tonariau|tonariou
歳の市	としのいち	toshinoichi
遣い手	つかいて	tsukaite
内払い	うちばらい	uchibarai
くされ縁	くされえん	kusareenn
騒ぞうしい	そうぞうしい	souzoushii
眠り薬	ねむりぐすり	nemurigusuri
迎え酒	むかえざけ	mukaezake
浮き足	うきあし	ukiashi
見透す	みとおす|みすかす	mitoosu|misukasu
どう猛	どうもう	doumou
繰出し	くりだし	kuridashi
繰り回す	くりまわす	kurimawasu
お巡り	おまわり	omawari
柄もの	がらもの	garamono
振り捨てる	ふりすてる	furisuteru
縁組み	えんぐみ	enngumi
寝かし付ける	ねかしつける	nekashitsukeru
先駆ける	さきがける	sakigakeru
買い被る	かいかぶる	kaikaburu
つま弾く	つまびく	tsumabiku
乾びる	からびる	karabiru
愛想尽かし	あいそづかし	aisodukashi
突っ立てる	つったてる	tsuttateru
押しだす	おしだす	oshidasu
祈とう	きとう|ぎとう	kitou|gitou
振り付け師	ふりつけし	furitsukeshi
腸詰め	ちょうづめ	tyoudume
押し切れる	おしきれる	oshikireru
お腰	おこし	okoshi
照り輝く	てりかがやく	terikagayaku
追い抜ける	おいぬける	oinukeru
掘りおこす	ほりおこす	horiokosu
流し網	ながしあみ	nagashiami
切り替る	きりかわる	kirikawaru
抜き出せる	ぬきだせる	nukidaseru
耳触り	みみざわり	mimizawari
迫り出し	せりだし	seridashi
被れる	かぶれる	kabureru
吹っ切れる	ふっきれる	fukkireru
踏込み	ふみこみ	fumikomi
きかん坊	きかんぼう	kikannbou
押し通せる	おしとおせる	oshitooseru
遣り繰り	やりくり	yarikuri
況して	まして	mashite
踏みならす	ふみならす	fuminarasu
言い触らす	いいふらす	iifurasu
鼻摘み	はなつまみ	hanatsumami
つめ跡	つめあと	tsumeato
押し出せる	おしだせる	oshidaseru
突き刺せる	つきさせる	tsukisaseru
突当る	つきあたる	tsukiataru
寝入りばな	ねいりばな	neiribana
唐がらし	とうがらし	tougarashi
散り敷く	ちりしく	chirishiku
生け捕る	いけどる	ikedoru
かけ込む	かけこむ	kakekomu
息吹く	いぶく	ibuku
投げ込める	なげこめる	nagekomeru
透き間	すきま	sukima
押寄せる	おしよせる	oshiyoseru
吹きぬけ	ふきぬけ	fukinuke
織込む	おりこむ	orikomu
乾めん	かんめん	kannmenn
柔らかみ	やわらかみ	yawarakami
飾りたてる	かざりたてる	kazaritateru
掘り出せる	ほりだせる	horidaseru
隠し立て	かくしだて|かくしたて	kakushidate|kakushitate
寄り添える	よりそえる	yorisoeru
流し込める	ながしこめる	nagashikomeru
火攻め	ひぜめ	hizeme
気抜け	きぬけ	kinuke
溶けあう	とけあう	tokeau
すべり込む	すべりこむ	suberikomu
麦踏み	むぎふみ	mugifumi
わが輩	わがはい	wagahai
宝尽くし	たからづくし	takaradukushi
抱き人形	だきにんぎょう	dakininngyou
突きつめる	つきつめる	tsukitsumeru
馬の脚	うまのあし	umanoashi
差し違える	さしちがえる	sashichigaeru
きりきり舞い	きりきりまい	kirikirimai
粒立つ	つぶだつ	tsubudatsu
慮り	おもんばかり|おもんぱかり	omonnbakari|omonnpakari
羽根突き	はねつき	hanetsuki
引き離せる	ひきはなせる	hikihanaseru
乗越す	のりこす	norikosu
繰り返せる	くりかえせる	kurikaeseru
線描き	せんがき	senngaki
落とし込める	おとしこめる	otoshikomeru
雌ねじ	めねじ	meneji
押しなべて	おしなべて	oshinabete
		