掲載	けいさい	keisai
企業	きぎょう	kigyou
施設	しせつ	shisetsu
開催	かいさい	kaisai
携帯	けいたい	keitai
実施	じっし	jisshi
選択	せんたく	senntaku
終了	しゅうりょう	shuuryou
募集	ぼしゅう	boshuu
撮影	さつえい	satsuei
契約	けいやく	keiyaku
交換	こうかん	koukann
企画	きかく	kikaku
請求	せいきゅう	seikyuu
了承	りょうしょう	ryoushou
駐車	ちゅうしゃ	tyuusha
削除	さくじょ	sakujo
福祉	ふくし	fukushi
魅力	みりょく	miryoku
申請	しんせい	shinnsei
基礎	きそ	kiso
当該	とうがい	tougai
概要	がいよう	gaiyou
書籍	しょせき|しょじゃく	shoseki|shojaku
既に	すでに	sudeni
応募	おうぼ	oubo
逮捕	たいほ	taiho
該当	がいとう	gaitou
超え	こえ|ごえ	koe|goe
施行	しこう|せぎょう|せこう|しぎょう	shikou|segyou|sekou|shigyou
審査	しんさ	shinnsa
掛け	かけ|がけ	kake|gake
閲覧	えつらん	etsurann
細胞	さいぼう	saibou
連携	れんけい	rennkei
上昇	じょうしょう	joushou
魔法	まほう	mahou
雇用	こよう	koyou
主催	しゅさい	shusai
特殊	とくしゅ	tokushu
掃除	そうじ	souji
措置	そち	sochi
漏れ	もれ	more
寿司	すし|ずし	sushi|zushi
緊張	きんちょう	kinntyou
伸び	のび	nobi
免許	めんきょ	mennkyo
緊急	きんきゅう	kinnkyuu
削減	さくげん	sakugenn
促進	そくしん	sokushinn
完了	かんりょう	kannryou
風邪	かぜ|ふうじゃ|かざ	kaze|fuuja|kaza
施工	しこう|せこう	shikou|sekou
邪魔	じゃま	jama
超える	こえる	koeru
辛い	からい|つらい|がらい|づらい	karai|tsurai|garai|durai
休憩	きゅうけい	kyuukei
伴う	ともなう|とものう	tomonau|tomonou
変換	へんかん	hennkann
視聴	しちょう	shityou
収穫	しゅうかく	shuukaku
工房	こうぼう	koubou
委託	いたく	itaku
顧客	こきゃく|こかく	kokyaku|kokaku
崩壊	ほうかい	houkai
衝撃	しょうげき	shougeki
豪華	ごうか	gouka
掲げる	かかげる	kakageru
揚げ	あげ	age
塗装	とそう	tosou
葬儀	そうぎ	sougi
勘違い	かんちがい	kannchigai
審議	しんぎ	shinngi
転換	てんかん	tennkann
抑え	おさえ	osae
翻訳	ほんやく	honnyaku
地獄	じごく	jigoku
要請	ようせい	yousei
覚悟	かくご	kakugo
偶然	ぐうぜん	guuzenn
哲学	てつがく	tetsugaku
分譲	ぶんじょう	bunnjou
滞在	たいざい	taizai
刑事	けいじ|でか	keiji|deka
訂正	ていせい	teisei
概念	がいねん	gainenn
飽き	あき	aki
悪魔	あくま	akuma
控え	ひかえ|びかえ	hikae|bikae
提携	ていけい	teikei
仕掛け	しかけ|じかけ	shikake|jikake
帝国	ていこく	teikoku
満喫	まんきつ	mannkitsu
伸ばし	のばし	nobashi
債務	さいむ	saimu
宴会	えんかい	ennkai
怪我	けが	kega
抽選	ちゅうせん	tyuusenn
後悔	こうかい	koukai
塗り	ぬり	nuri
随分	ずいぶん	zuibunn
排出	はいしゅつ	haishutsu
既存	きそん|きぞん	kisonn|kizonn
師匠	ししょう	shishou
犠牲	ぎせい	gisei
誘導	ゆうどう	yuudou
冷凍	れいとう	reitou
債権	さいけん	saikenn
抑制	よくせい	yokusei
穏やか	おだやか	odayaka
譲渡	じょうと|ゆずりわたし	jouto|yuzuriwatashi
純粋	じゅんすい	junnsui
抽出	ちゅうしゅつ	tyuushutsu
清掃	せいそう	seisou
緩和	かんわ	kannwa
乗り換え	のりかえ	norikae
幻想	げんそう	gennsou
騎士	きし	kishi
随時	ずいじ	zuiji
聴く	きく	kiku
欧米	おうべい	oubei
崩れ	くずれ|くずれれ|かむあがれ	kuzure|kuzurere|kamuagare
施策	しさく	shisaku
如何	いか|いかが|いかん|どう	ika|ikaga|ikann|dou
液晶	えきしょう	ekishou
喫煙	きつえん	kitsuenn
匿名	とくめい	tokumei
免責	めんせき	mennseki
冗談	じょうだん	joudann
死刑	しけい	shikei
糖尿	とうにょう	tounyou
揺れ	ゆれ	yure
消滅	しょうめつ	shoumetsu
撮る	とる|どる	toru|doru
怪しい	あやしい|けしい	ayashii|keshii
排除	はいじょ	haijo
摂取	せっしゅ	sesshu
遭遇	そうぐう	souguu
締結	ていけつ	teiketsu
衝突	しょうとつ	shoutotsu
一貫	いっかん	ikkann
引換	ひきかえ	hikikae
排水	はいすい	haisui
承諾	しょうだく	shoudaku
擁護	ようご	yougo
古墳	こふん	kofunn
分岐	ぶんき	bunnki
締め	しめ|じめ	shime|jime
国籍	こくせき	kokuseki
控除	こうじょ	koujo
信託	しんたく	shinntaku
将棋	しょうぎ	shougi
如く	ごとく|しく	gotoku|shiku
乙女	おとめ	otome
喫茶	きっさ	kissa
彫刻	ちょうこく	tyoukoku
魔女	まじょ	majo
廊下	ろうか	rouka
肝心	かんじん	kannjinn
審判	しんぱん	shinnpann
結晶	けっしょう	kesshou
寿命	じゅみょう	jumyou
放棄	ほうき	houki
容赦	ようしゃ	yousha
絞り	しぼり	shibori
霊園	れいえん	reienn
連邦	れんぽう	rennpou
孤独	こどく	kodoku
克服	こくふく	kokufuku
虐待	ぎゃくたい	gyakutai
解雇	かいこ	kaiko
軌道	きどう	kidou
双方	そうほう	souhou
了解	りょうかい	ryoukai
顧問	こもん	komonn
間隔	かんかく	kannkaku
華やか	はなやか	hanayaka
移籍	いせき	iseki
募金	ぼきん	bokinn
紛争	ふんそう	funnsou
施術	しじゅつ	shijutsu
酵素	こうそ	kouso
焦点	しょうてん	shoutenn
貧乏	びんぼう	binnbou
滑り	すべり|ぬめり	suberi|numeri
暫く	しばらく	shibaraku
皇帝	こうてい	koutei
抑える	おさえる	osaeru
勧誘	かんゆう	kannyuu
食卓	しょくたく	shokutaku
施し	ほどこし	hodokoshi
妨害	ぼうがい	bougai
公募	こうぼ	koubo
発酵	はっこう	hakkou
伸びる	のびる	nobiru
粘着	ねんちゃく	nenntyaku
遂に	ついに	tsuini
魔術	まじゅつ	majutsu
拘束	こうそく	kousoku
凍結	とうけつ	touketsu
郊外	こうがい	kougai
近郊	きんこう	kinnkou
改訂	かいてい	kaitei
阻止	そし	soshi
奉仕	ほうし	houshi
暖房	だんぼう	dannbou
華麗	かれい	karei
名簿	めいぼ	meibo
勘弁	かんべん	kannbenn
絞り込み	しぼりこみ	shiborikomi
魔王	まおう	maou
鍛え	きたえ	kitae
悔しい	くやしい	kuyashii
脅威	きょうい	kyoui
啓発	けいはつ	keihatsu
双子	ふたご|ふたこ	futago|futako
豚肉	ぶたにく|とんにく	butaniku|tonnniku
漂う	ただよう	tadayou
締め切り	しめきり	shimekiri
崩し	くずし	kuzushi
召喚	しょうかん	shoukann
励まし	はげまし	hagemashi
山岳	さんがく	sanngaku
掛かる	かかる|がかる	kakaru|gakaru
海賊	かいぞく	kaizoku
長寿	ちょうじゅ	tyouju
仏壇	ぶつだん	butsudann
虐殺	ぎゃくさつ	gyakusatsu
潜在	せんざい	sennzai
大胆	だいたん	daitann
不審	ふしん	fushinn
遂行	すいこう	suikou
抜粋	ばっすい	bassui
昇格	しょうかく	shoukaku
伸ばす	のばす	nobasu
開封	かいふう	kaifuu
魅了	みりょう	miryou
陶芸	とうげい	tougei
幽霊	ゆうれい	yuurei
硬化	こうか	kouka
膨大	ぼうだい	boudai
陶器	とうき	touki
女房	にょうぼう|にょうぼ	nyoubou|nyoubo
誘い	さそい|いざない|おびい	sasoi|izanai|obii
切符	きっぷ|ぎっぷ	kippu|gippu
掲示	けいじ	keiji
国債	こくさい	kokusai
採択	さいたく	saitaku
封印	ふういん	fuuinn
肝臓	かんぞう	kannzou
円滑	えんかつ	ennkatsu
免除	めんじょ	mennjo
優遇	ゆうぐう	yuuguu
葬式	そうしき	soushiki
出掛け	でかけ|でがけ	dekake|degake
可哀想	かわいそう	kawaisou
塗料	とりょう	toryou
瀬戸	せと	seto
水晶	すいしょう|ずいしょう	suishou|zuishou
修了	しゅうりょう	shuuryou
分裂	ぶんれつ	bunnretsu
絶滅	ぜつめつ	zetsumetsu
換え	かえ|がえ	kae|gae
硬い	かたい	katai
在籍	ざいせき	zaiseki
促す	うながす	unagasu
暫定	ざんてい	zanntei
誘う	いざなう|さそう|いざのう	izanau|sasou|izanou
衝動	しょうどう	shoudou
紛失	ふんしつ	funnshitsu
催し	もよおし	moyooshi
花嫁	はなよめ	hanayome
排気	はいき	haiki
騎手	きしゅ	kishu
待遇	たいぐう	taiguu
励み	はげみ	hagemi
湿度	しつど	shitsudo
娯楽	ごらく	goraku
卸売	おろしうり	oroshiuri
請負	うけおい	ukeoi
分泌	ぶんぴ|ぶんぴつ	bunnpi|bunnpitsu
揺れる	ゆれる	yureru
同伴	どうはん	douhann
掛かり	かかり|がかり	kakari|gakari
潜水	せんすい	sennsui
遵守	じゅんしゅ	junnshu
陰謀	いんぼう	innbou
酵母	こうぼ	koubo
食糧	しょくりょう	shokuryou
賢い	かしこい	kashikoi
戸籍	こせき	koseki
精霊	しょうりょう|せいれい	shouryou|seirei
架空	かくう	kakuu
北斗	ほくと	hokuto
家畜	かちく	kachiku
軌跡	きせき	kiseki
鶏肉	けいにく|とりにく	keiniku|toriniku
控えめ	ひかえめ	hikaeme
受託	じゅたく	jutaku
書房	しょぼう	shobou
削り	けずり|はつり	kezuri|hatsuri
怪獣	かいじゅう	kaijuu
藩主	はんしゅ	hannshu
酔い	よい|えい	yoi|ei
処刑	しょけい	shokei
負債	ふさい	fusai
控訴	こうそ	kouso
官房	かんぼう	kannbou
手袋	てぶくろ	tebukuro
慰安	いあん	iann
誘惑	ゆうわく	yuuwaku
魔力	まりょく	maryoku
恨み	うらみ	urami
遠隔	えんかく	ennkaku
配偶	はいぐう	haiguu
誘致	ゆうち	yuuchi
換算	かんさん	kannsann
港湾	こうわん	kouwann
掛ける	かける|がける	kakeru|gakeru
赴任	ふにん	funinn
窒素	ちっそ	chisso
奪う	うばう|うぼう	ubau|ubou
奉納	ほうのう	hounou
阻害	そがい	sogai
審美	しんび	shinnbi
敢えて	あえて	aete
動揺	どうよう	douyou
湖畔	こはん	kohann
全滅	ぜんめつ	zennmetsu
衰退	すいたい	suitai
愚か	おろか	oroka
携わる	たずさわる	tazusawaru
緩やか	ゆるやか	yuruyaka
湿気	しっけ|しけ|しっき	shikke|shike|shikki
団塊	だんかい	dannkai
脅迫	きょうはく	kyouhaku
哀れ	あわれ	aware
勘定	かんじょう	kannjou
粘土	ねばつち|ねんど|へなつち	nebatsuchi|nenndo|henatsuchi
許諾	きょだく	kyodaku
聴取	ちょうしゅ	tyoushu
卓球	たっきゅう	takkyuu
辛口	からくち	karakuchi
湿原	しつげん	shitsugenn
横綱	よこづな	yokoduna
錯覚	さっかく	sakkaku
概ね	おおむね	oomune
畜産	ちくさん	chikusann
伏せ	ふせ|ぶせ|ふくせ|ぷせ	fuse|buse|fukuse|puse
滅多	めった	metta
抽象	ちゅうしょう	tyuushou
疾病	しっぺい	shippei
巧み	たくみ|だくみ	takumi|dakumi
突如	とつじょ	totsujo
怪物	かいぶつ	kaibutsu
高架	こうか	kouka
隔離	かくり	kakuri
滑走	かっそう	kassou
覆い	おおい	ooi
特撮	とくさつ	tokusatsu
無双	むそう	musou
衰え	おとろえ	otoroe
解凍	かいとう	kaitou
試聴	しちょう	shityou
塗る	ぬる	nuru
脅し	おどし|おどかし|おびやかし	odoshi|odokashi|obiyakashi
唐辛子	とうがらし	tougarashi
浪人	ろうにん	rouninn
換気	かんき	kannki
凝縮	ぎょうしゅく	gyoushuku
販促	はんそく	hannsoku
壊滅	かいめつ	kaimetsu
伐採	ばっさい	bassai
置き換え	おきかえ	okikae
十字架	じゅうじか	juujika
激励	げきれい	gekirei
肝炎	かんえん	kannenn
火葬	かそう	kasou
聴覚	ちょうかく	tyoukaku
停滞	ていたい	teitai
修繕	しゅうぜん	shuuzenn
惜しい	おしい	oshii
冷房	れいぼう	reibou
滅亡	めつぼう	metsubou
繁華	はんか	hannka
妨げ	さまたげ	samatage
滑らか	なめらか|すべらか	nameraka|suberaka
孤立	こりつ	koritsu
丘陵	きゅうりょう	kyuuryou
炎上	えんじょう	ennjou
滞納	たいのう	tainou
全裸	ぜんら	zennra
奉行	ぶぎょう	bugyou
締切	しめきり|しめき	shimekiri|shimeki
契機	けいき	keiki
出没	しゅつぼつ	shutsubotsu
既婚	きこん	kikonn
埋める	うずめる|うめる	uzumeru|umeru
未遂	みすい	misui
花壇	かだん	kadann
請願	せいがん	seigann
潤い	うるおい	uruoi
意匠	いしょう	ishou
悟り	さとり	satori
粘膜	ねんまく	nennmaku
墜落	ついらく	tsuiraku
魔物	まもの	mamono
乏しい	とぼしい|まずしい	toboshii|mazushii
債券	さいけん	saikenn
遭難	そうなん	sounann
無謀	むぼう	mubou
超過	ちょうか	tyouka
慰め	なぐさめ	nagusame
湾岸	わんがん	wanngann
引き締め	ひきしめ	hikishime
常駐	じょうちゅう	joutyuu
彫り	ほり|えり|ぼり	hori|eri|bori
駐在	ちゅうざい	tyuuzai
傍聴	ぼうちょう	boutyou
焦り	あせり	aseri
要綱	ようこう	youkou
沈没	ちんぼつ	chinnbotsu
苗字	みょうじ	myouji
塗布	とふ	tofu
譲り	ゆずり	yuzuri
伴奏	ばんそう	bannsou
炊飯	すいはん	suihann
装甲	そうこう	soukou
貫通	かんつう	kanntsuu
捕鯨	ほげい	hogei
胎児	たいじ	taiji
福袋	ふくぶくろ	fukubukuro
放浪	ほうろう	hourou
憩い	いこい	ikoi
怪談	かいだん	kaidann
絞る	しぼる	shiboru
鍛える	きたえる	kitaeru
書き換え	かきかえ	kakikae
削る	けずる|はつる	kezuru|hatsuru
互換	ごかん	gokann
潜入	せんにゅう	sennnyuu
紛れ	まぎれ|まぐれ|まがえれ	magire|magure|magaere
簿記	ぼき	boki
破棄	はき	haki
肺炎	はいえん	haienn
粘り	ねばり	nebari
参謀	さんぼう	sannbou
覆う	おおう	oou
抑止	よくし	yokushi
心掛け	こころがけ	kokorogake
滑る	すべる|ぬめる	suberu|numeru
昇進	しょうしん	shoushinn
多岐	たき	taki
賢者	けんじゃ	kennja
崩れる	くずれる	kuzureru
施主	せしゅ	seshu
邦楽	ほうがく	hougaku
慰霊	いれい	irei
概算	がいさん	gaisann
魅惑	みわく	miwaku
縫い	ぬい	nui
巨匠	きょしょう	kyoshou
膨張	ぼうちょう	boutyou
疾走	しっそう	shissou
石碑	せきひ	sekihi
盗賊	とうぞく	touzoku
帳簿	ちょうぼ	tyoubo
降伏	こうふく|ごうぶく	koufuku|goubuku
海峡	かいきょう	kaikyou
平穏	へいおん	heionn
狩猟	しゅりょう	shuryou
誘発	ゆうはつ	yuuhatsu
喚起	かんき	kannki
諮問	しもん	shimonn
輪郭	りんかく	rinnkaku
縛り	しばり|じばり	shibari|jibari
催眠	さいみん	saiminn
刑法	けいほう	keihou
貫く	つらぬく|ぬく	tsuranuku|nuku
置換	ちかん	chikann
減免	げんめん	gennmenn
取り敢えず	とりあえず	toriaezu
随所	ずいしょ	zuisho
陳情	ちんじょう	chinnjou
討伐	とうばつ	toubatsu
慰謝	いしゃ	isha
高揚	こうよう	kouyou
怪人	かいじん	kaijinn
既出	きしゅつ	kishutsu
満了	まんりょう	mannryou
心霊	しんれい	shinnrei
換金	かんきん	kannkinn
芳香	ほうこう	houkou
封じ	ふうじ|ほうじ	fuuji|houji
無邪気	むじゃき	mujaki
掘削	くっさく	kussaku
伏線	ふくせん	fukusenn
鎮座	ちんざ	chinnza
共催	きょうさい	kyousai
騎乗	きじょう	kijou
愛顧	あいこ	aiko
引き換え	ひきかえ	hikikae
回廊	かいろう	kairou
奪取	だっしゅ	dasshu
埋葬	まいそう	maisou
霊場	れいじょう	reijou
乗換	のりかえ	norikae
悔い	くい	kui
伸縮	しんしゅく	shinnshuku
欠如	けつじょ	ketsujo
衰弱	すいじゃく	suijaku
符号	ふごう	fugou
破滅	はめつ	hametsu
水揚げ	みずあげ	mizuage
殴る	なぐる	naguru
屈辱	くつじょく	kutsujoku
湿地	しっち	shicchi
孤児	こじ|みなしご	koji|minashigo
取締	とりしまり|とりしま	torishimari|torishima
社債	しゃさい	shasai
大概	たいがい	taigai
排卵	はいらん	hairann
飽きる	あきる	akiru
埋め立て	うめたて	umetate
硬直	こうちょく	koutyoku
幼稚	ようち	youchi
盗聴	とうちょう	toutyou
争奪	そうだつ	soudatsu
葬祭	そうさい	sousai
飽和	ほうわ	houwa
同胞	どうほう|はらから	douhou|harakara
陳列	ちんれつ	chinnretsu
超人	ちょうじん	tyoujinn
恐慌	きょうこう	kyoukou
破裂	はれつ	haretsu
某所	ぼうしょ	bousho
桑田	そうでん	soudenn
鬼畜	きちく	kichiku
寿し	すし|ずし	sushi|zushi
車掌	しゃしょう	shashou
埋蔵	まいぞう	maizou
合掌	がっしょう	gasshou
滅び	ほろび	horobi
鎮痛	ちんつう	chinntsuu
同封	どうふう	doufuu
網膜	もうまく	moumaku
付随	ふずい	fuzui
超越	ちょうえつ	tyouetsu
掛け軸	かけじく	kakejiku
錯誤	さくご	sakugo
帝王	ていおう	teiou
封鎖	ふうさ	fuusa
抑圧	よくあつ	yokuatsu
南蛮	なんばん	nannbann
祭壇	さいだん	saidann
双葉	ふたば	futaba
慈悲	じひ	jihi
隆盛	りゅうせい	ryuusei
下請け	したうけ	shitauke
控える	ひかえる	hikaeru
浮き彫り	うきぼり	ukibori
没頭	ぼっとう	bottou
覆面	ふくめん	fukumenn
潜り	もぐり|くぐり	moguri|kuguri
封入	ふうにゅう	fuunyuu
魔界	まかい	makai
昇給	しょうきゅう	shoukyuu
骨髄	こつづい|こつずい	kotsudui|kotsuzui
昇る	のぼる	noboru
処遇	しょぐう	shoguu
搾取	さくしゅ|しぼりと	sakushu|shiborito
点滅	てんめつ	tennmetsu
間伐	かんばつ	kannbatsu
縫製	ほうせい	housei
隔て	へだて	hedate
緊迫	きんぱく	kinnpaku
取り締まり	とりしまり	torishimari
棄却	ききゃく	kikyaku
潜伏	せんぷく	sennpuku
託児	たくじ	takuji
浪漫	ろうまん|ろまん	roumann|romann
境遇	きょうぐう	kyouguu
揚げ物	あげもの	agemono
切削	せっさく	sessaku
勘案	かんあん	kannann
潤滑	じゅんかつ	junnkatsu
投棄	とうき|なげすて	touki|nagesute
聴ける	きける	kikeru
腰掛け	こしかけ	koshikake
潜ん	ひそん|くぐん|もぐん	hisonn|kugunn|mogunn
粗末	そまつ	somatsu
賢明	けんめい	kennmei
呼び掛け	よびかけ	yobikake
撮れる	とれる	toreru
随一	ずいいち	zuiichi
読了	どくりょう	dokuryou
添削	てんさく	tennsaku
掛け声	かけごえ	kakegoe
甲板	かんぱん|こうはん	kannpann|kouhann
残虐	ざんぎゃく	zanngyaku
薄膜	うすまく|はくまく	usumaku|hakumaku
模倣	もほう	mohou
邦画	ほうが	houga
搾り	しぼり	shibori
焦げ	こげ	koge
可哀相	かわいそう	kawaisou
膨らみ	ふくらみ	fukurami
画廊	がろう	garou
擦れ	こすれ|すれ|なすれ|ずれ	kosure|sure|nasure|zure
大吉	だいきち	daikichi
被覆	ひふく	hifuku
邪悪	じゃあく	jaaku
哀しい	かなしい	kanashii
囲炉裏	いろり	irori
憂い	うい|うれい	ui|urei
感慨	かんがい	kanngai
早苗	さなえ	sanae
御免	ごめん	gomenn
鋳造	ちゅうぞう	tyuuzou
既成	きせい	kisei
一掃	いっそう	issou
如来	にょらい	nyorai
施す	ほどこす	hodokosu
果敢	かかん	kakann
酔っ払い	よっぱらい	yopparai
崩す	くずす	kuzusu
卓上	たくじょう	takujou
漂流	ひょうりゅう	hyouryuu
略奪	りゃくだつ	ryakudatsu
延伸	えんしん	ennshinn
買い換え	かいかえ	kaikae
憎悪	ぞうお	zouo
聖霊	せいれい	seirei
難聴	なんちょう	nanntyou
審理	しんり	shinnri
霊的	れいてき	reiteki
騎馬	きば	kiba
陶磁器	とうじき	toujiki
潜む	ひそむ	hisomu
日没	にちぼつ	nichibotsu
没収	ぼっしゅう	bosshuu
辛抱	しんぼう	shinnbou
自虐	じぎゃく	jigyaku
怪奇	かいき	kaiki
随筆	ずいひつ	zuihitsu
浪費	ろうひ	rouhi
昇降	しょうこう	shoukou
口癖	くちぐせ	kuchiguse
苗木	なえぎ	naegi
概略	がいりゃく	gairyaku
埋立	うめたて	umetate
藩士	はんし	hannshi
聴衆	ちょうしゅう	tyoushuu
如し	ごとし	gotoshi
交錯	こうさく	kousaku
回顧	かいこ	kaiko
棋士	きし	kishi
完封	かんぷう	kannpuu
自炊	じすい	jisui
邦人	ほうじん	houjinn
撃墜	げきつい	gekitsui
疾風	しっぷう|はやて	shippuu|hayate
焦る	あせる|こげる	aseru|kogeru
巧妙	こうみょう	koumyou
霊感	れいかん	reikann
仕掛ける	しかける	shikakeru
超絶	ちょうぜつ	tyouzetsu
譲る	ゆずる	yuzuru
催促	さいそく|ざいそく	saisoku|zaisoku
滅茶苦茶	めちゃくちゃ	metyakutya
角膜	かくまく	kakumaku
水没	すいぼつ	suibotsu
敢行	かんこう	kannkou
卓越	たくえつ	takuetsu
悪霊	あくりょう	akuryou
桑原	くわばら	kuwabara
稚魚	ちぎょ	chigyo
駐留	ちゅうりゅう	tyuuryuu
雪崩	なだれ	nadare
紙袋	かみぶくろ|かんぶくろ	kamibukuro|kannbukuro
漂白	ひょうはく	hyouhaku
凝固	ぎょうこ|こりかたま	gyouko|korikatama
布施	ふせ|ぶせ	fuse|buse
落胆	らくたん	rakutann
概況	がいきょう	gaikyou
共謀	きょうぼう	kyoubou
締め付け	しめつけ	shimetsuke
鍛錬	たんれん	tannrenn
魔神	まじん	majinn
遭う	あう|おう	au|ou
幻覚	げんかく	gennkaku
加湿	かしつ	kashitsu
組み換え	くみかえ	kumikae
音符	おんぷ	onnpu
零細	れいさい	reisai
手掛ける	てがける	tegakeru
多湿	たしつ	tashitsu
起伏	きふく|おきふし	kifuku|okifushi
漏れる	もれる	moreru
委嘱	いしょく	ishoku
免職	めんしょく	mennshoku
陳述	ちんじゅつ	chinnjutsu
遺棄	いき	iki
老婆	ろうば	rouba
城郭	じょうかく	joukaku
歌姫	うたひめ	utahime
束縛	そくばく	sokubaku
強奪	ごうだつ	goudatsu
火炎	かえん	kaenn
追随	ついずい	tsuizui
餓鬼	がき	gaki
埋没	まいぼつ	maibotsu
硬度	こうど	koudo
遅滞	ちたい	chitai
辛味	からみ	karami
炊く	たく|だく	taku|daku
足袋	たび	tabi
漏えい	ろうえい	rouei
励む	はげむ	hagemu
塗り替え	ぬりかえ	nurikae
強硬	きょうこう	kyoukou
移譲	いじょう	ijou
電卓	でんたく	denntaku
詠唱	えいしょう	eishou
虚構	きょこう	kyokou
自滅	じめつ	jimetsu
裸足	はだし	hadashi
大綱	おおづな|たいこう	ooduna|taikou
御霊	みたま|ごりょう	mitama|goryou
昇華	しょうか	shouka
魔道	まどう	madou
揚げる	あげる	ageru
鼻炎	びえん	bienn
妨げる	さまたげる	samatageru
嘱託	しょくたく	shokutaku
昇り	のぼり	nobori
転嫁	てんか	tennka
殺伐	さつばつ	satsubatsu
掌握	しょうあく	shouaku
緩い	ゆるい|なるい|ぬるい|ゆりい|ぬりい	yurui|narui|nurui|yurii|nurii
凝視	ぎょうし	gyoushi
忌避	きひ	kihi
戦没	せんぼつ	sennbotsu
憎い	にくい|にきい	nikui|nikii
摂る	とる|どる	toru|doru
雑炊	ぞうすい	zousui
硬質	こうしつ	koushitsu
油揚げ	あぶらあげ|あぶらげ	aburaage|aburage
検閲	けんえつ	kennetsu
雨漏り	あまもり	amamori
廉価	れんか	rennka
排他	はいた	haita
不滅	ふめつ	fumetsu
覆す	くつがえす	kutsugaesu
幻影	げんえい	gennei
如月	きさらぎ	kisaragi
真髄	しんずい	shinnzui
高瀬	たかせ	takase
誤魔化し	ごまかし	gomakashi
膨らむ	ふくらむ	fukuramu
催し物	もよおしもの	moyooshimono
本籍	ほんせき	honnseki
監獄	かんごく	kanngoku
緩衝	かんしょう	kannshou
催事	さいじ	saiji
掛け合い	かけあい	kakeai
言霊	ことだま	kotodama
炊き込み	たきこみ	takikomi
鎮守	ちんじゅ	chinnju
赴く	おもむく	omomuku
催行	さいこう	saikou
冷暖房	れいだんぼう	reidannbou
霊界	れいかい	reikai
延滞	えんたい	enntai
酔う	よう|えう	you|eu
皆既	かいき	kaiki
擁立	ようりつ	youritsu
凝り	こり|こごり|しこり	kori|kogori|shikori
転覆	てんぷく	tennpuku
卑劣	ひれつ	hiretsu
野蛮	やばん	yabann
本邦	ほんぽう	honnpou
刑罰	けいばつ	keibatsu
必携	ひっけい	hikkei
取締り	とりしまり	torishimari
塩辛	しおから	shiokara
追伸	ついしん	tsuishinn
免税	めんぜい	mennzei
謀略	ぼうりゃく	bouryaku
如何なる	いかなる	ikanaru
崩落	ほうらく|くずれおち	houraku|kuzureochi
欠乏	けつぼう	ketsubou
募る	つのる	tsunoru
締めくくり	しめくくり	shimekukuri
辛子	からし|がらし	karashi|garashi
脅かす	おどかす|おびやかす	odokasu|obiyakasu
背伸び	せのび	senobi
硬式	こうしき	koushiki
胃袋	いぶくろ	ibukuro
亡霊	ぼうれい	bourei
騎兵	きへい	kihei
邪気	じゃき	jaki
潜る	くぐる|もぐる	kuguru|moguru
締める	しめる|じめる	shimeru|jimeru
魅せる	みせる	miseru
餓死	うえじに|がし	uejini|gashi
怠慢	たいまん	taimann
生憎	あいにく|あやにく	ainiku|ayaniku
虐め	いじめ|さいなめ	ijime|sainame
錠剤	じょうざい	jouzai
窒息	ちっそく	chissoku
減衰	げんすい	gennsui
鋳物	いもの	imono
封建	ほうけん	houkenn
架かる	かかる	kakaru
埋め込み	うめこみ	umekomi
辛うじて	かろうじて	karoujite
法華	ほっけ|ほけ	hokke|hoke
警鐘	けいしょう	keishou
裁縫	さいほう	saihou
硬貨	こうか	kouka
預託	よたく	yotaku
入籍	にゅうせき	nyuuseki
架橋	かきょう|かけはし	kakyou|kakehashi
雇い	やとい	yatoi
気概	きがい	kigai
夢幻	むげん|ゆめまぼろし	mugenn|yumemaboroshi
話し掛け	はなしかけ	hanashikake
誘引	ゆういん	yuuinn
続伸	ぞくしん	zokushinn
回忌	かいき	kaiki
既得	きとく	kitoku
鎮圧	ちんあつ	chinnatsu
滅ぼす	ほろぼす	horobosu
孤高	ここう	kokou
胎内	たいない	tainai
排尿	はいにょう	hainyou
綱領	こうりょう	kouryou
勇敢	ゆうかん	yuukann
技巧	ぎこう	gikou
緊密	きんみつ	kinnmitsu
女帝	にょてい|じょてい	nyotei|jotei
陳腐	ちんぷ	chinnpu
控え室	ひかえしつ	hikaeshitsu
昇順	しょうじゅん	shoujunn
漏らす	もらす	morasu
登壇	とうだん	toudann
超す	こす	kosu
棄権	きけん	kikenn
雇う	やとう	yatou
孤島	ことう	kotou
壁掛け	かべかけ	kabekake
不吉	ふきつ	fukitsu
締約	ていやく	teiyaku
畜生	ちくしょう	chikushou
主軸	しゅじく	shujiku
乗換え	のりかえ	norikae
下請	したうけ	shitauke
奉公	ほうこう|ぼうこう	houkou|boukou
譲り受け	ゆずりうけ	yuzuriuke
激辛	げきから	gekikara
死滅	しめつ	shimetsu
昇天	しょうてん	shoutenn
没落	ぼつらく	botsuraku
仕掛	しかけ|じかけ	shikake|jikake
稲穂	いなほ	inaho
尿道	にょうどう	nyoudou
霊魂	れいこん	reikonn
漂着	ひょうちゃく	hyoutyaku
摂理	せつり	setsuri
水墨	すいぼく	suiboku
随意	ずいい	zuii
排便	はいべん	haibenn
縫う	ぬう	nuu
不穏	ふおん	fuonn
帝都	ていと	teito
怪盗	かいとう	kaitou
穴埋め	あなうめ	anaume
拘置	こうち	kouchi
顧み	かえりみ	kaerimi
埋設	まいせつ	maisetsu
日雇い	ひやとい	hiyatoi
虚弱	きょじゃく	kyojaku
施肥	せひ	sehi
生粋	きっすい	kissui
皮膜	ひまく	himaku
浪士	ろうし	roushi
紛らわしい	まぎらわしい	magirawashii
概観	がいかん	gaikann
企て	くわだて	kuwadate
禁忌	きんき	kinnki
奇怪	きかい|きっかい	kikai|kikkai
布袋	ほてい|ぬのぶくろ	hotei|nunobukuro
架け橋	かけはし	kakehashi
憂慮	ゆうりょ	yuuryo
惜しむ	おしむ	oshimu
暖炉	だんろ	dannro
帝京	ていきょう	teikyou
虚無	きょむ|こむ	kyomu|komu
掛金	かけきん|かけがね	kakekinn|kakegane
掛軸	かけじく	kakejiku
急募	きゅうぼ	kyuubo
歌碑	かひ	kahi
譲歩	じょうほ	jouho
零れ	こぼれ	kobore
隆起	りゅうき	ryuuki
帆船	はんせん|ほぶね	hannsenn|hobune
早乙女	さおとめ	saotome
伸長	しんちょう	shinntyou
滑り台	すべりだい	suberidai
求刑	きゅうけい	kyuukei
霊夢	れいむ	reimu
かき揚げ	かきあげ	kakiage
受刑	じゅけい	jukei
如実	にょじつ	nyojitsu
励ます	はげます	hagemasu
炊事	すいじ	suiji
陰湿	いんしつ	innshitsu
見掛け	みかけ	mikake
滅失	めっしつ	messhitsu
偶数	ぐうすう	guusuu
英霊	えいれい	eirei
肝要	かんよう	kannyou
埋まる	うずまる|うまる	uzumaru|umaru
揚げ足	あげあし	ageashi
虚空	こくう	kokuu
聴講	ちょうこう	tyoukou
卸し	おろし	oroshi
精巧	せいこう	seikou
壇上	だんじょう	dannjou
公聴	こうちょう	koutyou
封じ込め	ふうじこめ	fuujikome
鎮静	ちんせい	chinnsei
再審	さいしん	saishinn
鍛造	たんぞう	tannzou
概説	がいせつ	gaisetsu
養鶏	ようけい	youkei
お袋	おふくろ	ofukuro
令嬢	れいじょう	reijou
滞り	とどこおり	todokoori
言い換え	いいかえ	iikae
既製	きせい	kisei
引き揚げ	ひきあげ	hikiage
託す	たくす	takusu
山賊	さんぞく	sannzoku
佳作	かさく	kasaku
凝集	ぎょうしゅう	gyoushuu
空虚	くうきょ	kuukyo
遂げる	とげる	togeru
猟奇	りょうき	ryouki
排斥	はいせき	haiseki
征伐	せいばつ	seibatsu
憎む	にくむ	nikumu
粗大	そだい	sodai
密封	みっぷう	mippuu
王冠	おうかん	oukann
織姫	おりひめ	orihime
育苗	いくびょう	ikubyou
精錬	せいれん	seirenn
胞子	ほうし	houshi
施錠	せじょう	sejou
抑留	よくりゅう	yokuryuu
既設	きせつ	kisetsu
凍る	こおる	kooru
擁する	ようする	yousuru
啓示	けいじ	keiji
吉兆	きっちょう	kittyou
山伏	やまぶし	yamabushi
多孔	たこう	takou
邪道	じゃどう	jadou
利潤	りじゅん	rijunn
美姫	びき	biki
満悦	まんえつ	mannetsu
重鎮	じゅうちん	juuchinn
種苗	しゅびょう	shubyou
湿布	しっぷ	shippu
悲哀	ひあい	hiai
実刑	じっけい	jikkei
基軸	きじく	kijiku
一概	いちがい	ichigai
手の甲	てのこう	tenokou
滅びる	ほろびる	horobiru
穂先	ほさき	hosaki
視聴覚	しちょうかく	shityoukaku
信奉	しんぽう	shinnpou
縦貫	じゅうかん	juukann
誘電	ゆうでん	yuudenn
木漏れ日	こもれび	komorebi
旗揚げ	はたあげ	hataage
粗い	あらい	arai
掲示板	けいじばん	keijibann
駐車場	ちゅうしゃじょう	tyuushajou
幼稚園	ようちえん	youchienn
取締役	とりしまりやく	torishimariyaku
募集中	ぼしゅうちゅう	boshuutyuu
魅力的	みりょくてき	miryokuteki
糖尿病	とうにょうびょう	tounyoubyou
知恵袋	ちえぶくろ	chiebukuro
喫茶店	きっさてん	kissatenn
開催中	かいさいちゅう	kaisaityuu
実施中	じっしちゅう	jisshityuu
審議会	しんぎかい	shinngikai
視聴率	しちょうりつ	shityouritsu
主催者	しゅさいしゃ	shusaisha
申請書	しんせいしょ	shinnseisho
大企業	だいきぎょう	daikigyou
視聴者	しちょうしゃ	shityousha
緊張感	きんちょうかん	kinntyoukann
契約書	けいやくしょ	keiyakusho
超音波	ちょうおんぱ	tyouonnpa
刑務所	けいむしょ	keimusho
請求書	せいきゅうしょ	seikyuusho
犠牲者	ぎせいしゃ	giseisha
配偶者	はいぐうしゃ	haiguusha
幻想的	げんそうてき	gennsouteki
文房具	ぶんぼうぐ	bunnbougu
基礎的	きそてき	kisoteki
慰安婦	いあんふ	iannfu
保湿	ほしつ	hoshitsu
繁華街	はんかがい	hannkagai
審査員	しんさいん	shinnsainn
免許証	めんきょしょう	mennkyoshou
錬金術	れんきんじゅつ	rennkinnjutsu
衝撃的	しょうげきてき	shougekiteki
債権者	さいけんしゃ	saikennsha
地鶏	じどり	jidori
契約者	けいやくしゃ	keiyakusha
閲覧者	えつらんしゃ	etsurannsha
泌尿器	ひにょうき	hinyouki
掃除機	そうじき	soujiki
福祉士	ふくしし	fukushishi
企画展	きかくてん	kikakutenn
魔術師	まじゅつし	majutsushi
皮膚炎	ひふえん	hifuenn
審査会	しんさかい	shinnsakai
債務者	さいむしゃ	saimusha
貧乏人	びんぼうにん	binnbouninn
中華街	ちゅうかがい	tyuukagai
寿司屋	すしや	sushiya
措置法	そちほう	sochihou
慰謝料	いしゃりょう	isharyou
各企業	かくきぎょう	kakukigyou
急上昇	きゅうじょうしょう	kyuujoushou
企業名	きぎょうめい	kigyoumei
豚骨	とんこつ	tonnkotsu
携帯用	けいたいよう	keitaiyou
通信簿	つうしんぼ	tsuushinnbo
超能力	ちょうのうりょく	tyounouryoku
泌尿器科	ひにょうきか	hinyoukika
滑走路	かっそうろ	kassouro
抽象的	ちゅうしょうてき	tyuushouteki
施行日	しこうひ	shikouhi
駐輪場	ちゅうりんじょう	tyuurinnjou
喫煙者	きつえんしゃ	kitsuennsha
応募者	おうぼしゃ	oubosha
原子炉	げんしろ	gennshiro
騎士団	きしだん	kishidann
取締役会	とりしまりやくかい	torishimariyakukai
抽選会	ちゅうせんかい	tyuusennkai
施行令	しこうれい	shikourei
記念碑	きねんひ	kinennhi
申請者	しんせいしゃ	shinnseisha
盗撮	とうさつ	tousatsu
分岐点	ぶんきてん	bunnkitenn
緊急時	きんきゅうじ	kinnkyuuji
香辛料	こうしんりょう	koushinnryou
炊飯器	すいはんき	suihannki
開催日	かいさいび	kaisaibi
潜在的	せんざいてき	sennzaiteki
哲学者	てつがくしゃ	tetsugakusha
冷凍庫	れいとうこ	reitouko
双眼鏡	そうがんきょう	sougannkyou
不審者	ふしんしゃ	fushinnsha
霊能	れいのう	reinou
口内炎	こうないえん	kounaienn
施設内	しせつない	shisetsunai
大虐殺	だいぎゃくさつ	daigyakusatsu
請求権	せいきゅうけん	seikyuukenn
魔人	まじん	majinn
分譲地	ぶんじょうち	bunnjouchi
横軸	よこじく	yokojiku
黒豚	くろぶた	kurobuta
争奪戦	そうだつせん	soudatsusenn
互換性	ごかんせい	gokannsei
多国籍	たこくせき	takokuseki
炎天下	えんてんか	enntennka
宴会場	えんかいじょう	ennkaijou
委託先	いたくさき	itakusaki
火葬場	かそうば	kasouba
家計簿	かけいぼ	kakeibo
床暖房	ゆかだんぼう	yukadannbou
幹細胞	かんさいぼう	kannsaibou
補聴器	ほちょうき	hotyouki
双方向	そうほうこう	souhoukou
哲学的	てつがくてき	tetsugakuteki
没後	ぼつご	botsugo
家族葬	かぞくそう	kazokusou
免震	めんしん	mennshinn
内膜	ないまく	naimaku
換気扇	かんきせん	kannkisenn
摂取量	せっしゅりょう	sesshuryou
登記簿	とうきぼ	toukibo
誘導体	ゆうどうたい	yuudoutai
戦没者	せんぼつしゃ	sennbotsusha
卸売業	おろしうりぎょう	oroshiurigyou
内分泌	ないぶんぴつ	naibunnpitsu
超高層	ちょうこうそう	tyoukousou
粘度	ねんど	nenndo
福祉法	ふくしほう	fukushihou
抑止力	よくしりょく	yokushiryoku
転換期	てんかんき	tennkannki
企業内	きぎょうない	kigyounai
託児所	たくじしょ	takujisho
摂食	せっしょく	sesshoku
紺色	こんいろ	konniro
締約国	ていやくこく	teiyakukoku
魔族	まぞく	mazoku
施行前	しこうまえ	shikoumae
開催地	かいさいち	kaisaichi
万華鏡	まんげきょう	manngekyou
重篤	じゅうとく	juutoku
企画書	きかくしょ	kikakusho
排他的	はいたてき	haitateki
企業家	きぎょうか	kigyouka
休憩室	きゅうけいしつ	kyuukeishitsu
排気量	はいきりょう	haikiryou
雇用者	こようしゃ	koyousha
一貫性	いっかんせい	ikkannsei
企業間	きぎょうかん	kigyoukann
魔導	まどう	madou
終止符	しゅうしふ	shuushifu
撮影中	さつえいちゅう	satsueityuu
加湿器	かしつき	kashitsuki
翻訳者	ほんやくしゃ	honnyakusha
霊能者	れいのうしゃ	reinousha
受刑者	じゅけいしゃ	jukeisha
地鎮祭	じちんさい	jichinnsai
既婚者	きこんしゃ	kikonnsha
超伝導	ちょうでんどう	tyoudenndou
公聴会	こうちょうかい	koutyoukai
陶芸家	とうげいか	tougeika
尿酸	にょうさん	nyousann
葬儀屋	そうぎや	sougiya